year,district_code,district_name,neighborhood_code,neighborhood_name,census_tract,total_pax,F,M
2013,1,Ciutat Vella,1,el Raval,1001,1354,580,774
2013,1,Ciutat Vella,1,el Raval,1002,1578,708,870
2013,1,Ciutat Vella,1,el Raval,1003,3369,1534,1835
2013,1,Ciutat Vella,1,el Raval,1004,2904,1257,1647
2013,1,Ciutat Vella,1,el Raval,1005,2575,1093,1482
2013,1,Ciutat Vella,1,el Raval,1006,1754,764,990
2013,1,Ciutat Vella,1,el Raval,1007,2066,804,1262
2013,1,Ciutat Vella,1,el Raval,1008,3627,1421,2206
2013,1,Ciutat Vella,1,el Raval,1009,2286,1039,1247
2013,1,Ciutat Vella,1,el Raval,1010,2451,1027,1424
2013,1,Ciutat Vella,1,el Raval,1011,3495,1473,2022
2013,1,Ciutat Vella,1,el Raval,1012,1912,927,985
2013,1,Ciutat Vella,1,el Raval,1013,1375,727,648
2013,1,Ciutat Vella,1,el Raval,1014,2068,1001,1067
2013,1,Ciutat Vella,1,el Raval,1015,2294,1135,1159
2013,1,Ciutat Vella,1,el Raval,1016,2318,1115,1203
2013,1,Ciutat Vella,1,el Raval,1017,2672,1226,1446
2013,1,Ciutat Vella,1,el Raval,1018,1574,773,801
2013,1,Ciutat Vella,1,el Raval,1019,2906,1283,1623
2013,1,Ciutat Vella,1,el Raval,1020,2069,1121,948
2013,1,Ciutat Vella,1,el Raval,1021,2124,1061,1063
2013,1,Ciutat Vella,2,el Barri Gòtic,1022,1226,634,592
2013,1,Ciutat Vella,2,el Barri Gòtic,1023,2404,1174,1230
2013,1,Ciutat Vella,2,el Barri Gòtic,1025,1284,636,648
2013,1,Ciutat Vella,2,el Barri Gòtic,1026,2116,873,1243
2013,1,Ciutat Vella,2,el Barri Gòtic,1027,1619,768,851
2013,1,Ciutat Vella,2,el Barri Gòtic,1028,1939,873,1066
2013,1,Ciutat Vella,2,el Barri Gòtic,1029,1398,681,717
2013,1,Ciutat Vella,2,el Barri Gòtic,1030,2561,1173,1388
2013,1,Ciutat Vella,2,el Barri Gòtic,1031,1729,769,960
2013,1,Ciutat Vella,3,la Barceloneta,1032,1908,917,991
2013,1,Ciutat Vella,3,la Barceloneta,1033,1149,568,581
2013,1,Ciutat Vella,3,la Barceloneta,1034,1098,547,551
2013,1,Ciutat Vella,3,la Barceloneta,1035,1341,661,680
2013,1,Ciutat Vella,3,la Barceloneta,1036,1202,628,574
2013,1,Ciutat Vella,3,la Barceloneta,1037,1404,737,667
2013,1,Ciutat Vella,3,la Barceloneta,1038,1610,743,867
2013,1,Ciutat Vella,3,la Barceloneta,1039,1369,676,693
2013,1,Ciutat Vella,3,la Barceloneta,1040,1115,560,555
2013,1,Ciutat Vella,3,la Barceloneta,1041,1501,739,762
2013,1,Ciutat Vella,3,la Barceloneta,1042,1796,951,845
2013,1,Ciutat Vella,4,"Sant Pere, Santa Caterina i la Ribera",1043,1213,574,639
2013,1,Ciutat Vella,4,"Sant Pere, Santa Caterina i la Ribera",1044,1532,794,738
2013,1,Ciutat Vella,4,"Sant Pere, Santa Caterina i la Ribera",1045,2126,1086,1040
2013,1,Ciutat Vella,4,"Sant Pere, Santa Caterina i la Ribera",1046,1748,872,876
2013,1,Ciutat Vella,4,"Sant Pere, Santa Caterina i la Ribera",1047,1853,974,879
2013,1,Ciutat Vella,4,"Sant Pere, Santa Caterina i la Ribera",1048,2289,1140,1149
2013,1,Ciutat Vella,4,"Sant Pere, Santa Caterina i la Ribera",1049,1423,742,681
2013,1,Ciutat Vella,4,"Sant Pere, Santa Caterina i la Ribera",1050,1602,780,822
2013,1,Ciutat Vella,4,"Sant Pere, Santa Caterina i la Ribera",1051,1892,933,959
2013,1,Ciutat Vella,4,"Sant Pere, Santa Caterina i la Ribera",1052,2423,1153,1270
2013,1,Ciutat Vella,4,"Sant Pere, Santa Caterina i la Ribera",1053,2031,1012,1019
2013,1,Ciutat Vella,4,"Sant Pere, Santa Caterina i la Ribera",1054,1362,686,676
2013,1,Ciutat Vella,4,"Sant Pere, Santa Caterina i la Ribera",1055,1277,687,590
2013,2,Eixample,5,el Fort Pienc,2001,1237,647,590
2013,2,Eixample,5,el Fort Pienc,2002,2207,1029,1178
2013,2,Eixample,5,el Fort Pienc,2003,1239,695,544
2013,2,Eixample,5,el Fort Pienc,2004,1501,778,723
2013,2,Eixample,5,el Fort Pienc,2005,2161,1149,1012
2013,2,Eixample,5,el Fort Pienc,2006,1612,855,757
2013,2,Eixample,5,el Fort Pienc,2007,1225,705,520
2013,2,Eixample,5,el Fort Pienc,2008,1826,999,827
2013,2,Eixample,5,el Fort Pienc,2009,1727,930,797
2013,2,Eixample,5,el Fort Pienc,2010,1198,655,543
2013,2,Eixample,5,el Fort Pienc,2011,1108,566,542
2013,2,Eixample,5,el Fort Pienc,2012,1572,817,755
2013,2,Eixample,5,el Fort Pienc,2013,1127,607,520
2013,2,Eixample,5,el Fort Pienc,2014,1338,695,643
2013,2,Eixample,5,el Fort Pienc,2015,1571,854,717
2013,2,Eixample,5,el Fort Pienc,2016,1880,1037,843
2013,2,Eixample,5,el Fort Pienc,2017,1953,1050,903
2013,2,Eixample,5,el Fort Pienc,2018,1832,986,846
2013,2,Eixample,5,el Fort Pienc,2019,1966,1058,908
2013,2,Eixample,5,el Fort Pienc,2020,1475,798,677
2013,2,Eixample,6,la Sagrada Família,2021,1481,784,697
2013,2,Eixample,6,la Sagrada Família,2022,1249,661,588
2013,2,Eixample,6,la Sagrada Família,2023,1092,566,526
2013,2,Eixample,6,la Sagrada Família,2024,1141,621,520
2013,2,Eixample,6,la Sagrada Família,2025,1190,638,552
2013,2,Eixample,6,la Sagrada Família,2026,2123,1151,972
2013,2,Eixample,6,la Sagrada Família,2027,2032,1104,928
2013,2,Eixample,6,la Sagrada Família,2028,2125,1159,966
2013,2,Eixample,6,la Sagrada Família,2029,1154,611,543
2013,2,Eixample,6,la Sagrada Família,2030,1233,659,574
2013,2,Eixample,6,la Sagrada Família,2031,1059,565,494
2013,2,Eixample,6,la Sagrada Família,2032,1246,723,523
2013,2,Eixample,6,la Sagrada Família,2033,1172,632,540
2013,2,Eixample,6,la Sagrada Família,2034,1157,652,505
2013,2,Eixample,6,la Sagrada Família,2035,1273,692,581
2013,2,Eixample,6,la Sagrada Família,2036,1233,654,579
2013,2,Eixample,6,la Sagrada Família,2037,1213,614,599
2013,2,Eixample,6,la Sagrada Família,2038,1652,871,781
2013,2,Eixample,6,la Sagrada Família,2039,1766,982,784
2013,2,Eixample,6,la Sagrada Família,2040,1634,866,768
2013,2,Eixample,6,la Sagrada Família,2041,1677,930,747
2013,2,Eixample,6,la Sagrada Família,2042,1682,881,801
2013,2,Eixample,6,la Sagrada Família,2043,1432,768,664
2013,2,Eixample,6,la Sagrada Família,2044,1245,697,548
2013,2,Eixample,6,la Sagrada Família,2045,1210,653,557
2013,2,Eixample,6,la Sagrada Família,2046,1871,1029,842
2013,2,Eixample,6,la Sagrada Família,2047,1886,1023,863
2013,2,Eixample,6,la Sagrada Família,2048,1299,712,587
2013,2,Eixample,6,la Sagrada Família,2049,2091,1145,946
2013,2,Eixample,6,la Sagrada Família,2050,1649,906,743
2013,2,Eixample,6,la Sagrada Família,2051,1987,1068,919
2013,2,Eixample,6,la Sagrada Família,2052,1808,990,818
2013,2,Eixample,6,la Sagrada Família,2053,1840,984,856
2013,2,Eixample,6,la Sagrada Família,2054,1919,1039,880
2013,2,Eixample,7,la Dreta de l'Eixample,2055,1883,1001,882
2013,2,Eixample,7,la Dreta de l'Eixample,2056,1465,831,634
2013,2,Eixample,7,la Dreta de l'Eixample,2057,1242,666,576
2013,2,Eixample,7,la Dreta de l'Eixample,2058,1381,759,622
2013,2,Eixample,7,la Dreta de l'Eixample,2059,1616,872,744
2013,2,Eixample,7,la Dreta de l'Eixample,2060,1683,918,765
2013,2,Eixample,7,la Dreta de l'Eixample,2061,1364,763,601
2013,2,Eixample,7,la Dreta de l'Eixample,2062,1595,865,730
2013,2,Eixample,7,la Dreta de l'Eixample,2063,1179,729,450
2013,2,Eixample,7,la Dreta de l'Eixample,2064,1404,741,663
2013,2,Eixample,7,la Dreta de l'Eixample,2065,1889,1028,861
2013,2,Eixample,7,la Dreta de l'Eixample,2066,1943,1038,905
2013,2,Eixample,7,la Dreta de l'Eixample,2067,1660,891,769
2013,2,Eixample,7,la Dreta de l'Eixample,2068,1697,904,793
2013,2,Eixample,7,la Dreta de l'Eixample,2069,1334,707,627
2013,2,Eixample,7,la Dreta de l'Eixample,2070,1330,752,578
2013,2,Eixample,7,la Dreta de l'Eixample,2071,1681,876,805
2013,2,Eixample,7,la Dreta de l'Eixample,2072,1180,625,555
2013,2,Eixample,7,la Dreta de l'Eixample,2073,1624,852,772
2013,2,Eixample,7,la Dreta de l'Eixample,2074,1134,580,554
2013,2,Eixample,7,la Dreta de l'Eixample,2075,1207,652,555
2013,2,Eixample,7,la Dreta de l'Eixample,2076,1661,889,772
2013,2,Eixample,7,la Dreta de l'Eixample,2077,1425,723,702
2013,2,Eixample,7,la Dreta de l'Eixample,2078,1460,822,638
2013,2,Eixample,7,la Dreta de l'Eixample,2079,1234,672,562
2013,2,Eixample,7,la Dreta de l'Eixample,2080,1429,787,642
2013,2,Eixample,7,la Dreta de l'Eixample,2081,2092,1173,919
2013,2,Eixample,7,la Dreta de l'Eixample,2082,967,547,420
2013,2,Eixample,7,la Dreta de l'Eixample,2083,1640,926,714
2013,2,Eixample,8,l'Antiga Esquerra de l'Eixample,2084,2043,1120,923
2013,2,Eixample,8,l'Antiga Esquerra de l'Eixample,2085,1449,798,651
2013,2,Eixample,8,l'Antiga Esquerra de l'Eixample,2086,1390,777,613
2013,2,Eixample,8,l'Antiga Esquerra de l'Eixample,2087,1446,790,656
2013,2,Eixample,8,l'Antiga Esquerra de l'Eixample,2088,1678,925,753
2013,2,Eixample,8,l'Antiga Esquerra de l'Eixample,2089,1889,998,891
2013,2,Eixample,8,l'Antiga Esquerra de l'Eixample,2090,1685,908,777
2013,2,Eixample,8,l'Antiga Esquerra de l'Eixample,2091,1840,929,911
2013,2,Eixample,8,l'Antiga Esquerra de l'Eixample,2092,1821,943,878
2013,2,Eixample,8,l'Antiga Esquerra de l'Eixample,2093,1551,802,749
2013,2,Eixample,8,l'Antiga Esquerra de l'Eixample,2094,1487,789,698
2013,2,Eixample,8,l'Antiga Esquerra de l'Eixample,2095,1562,813,749
2013,2,Eixample,8,l'Antiga Esquerra de l'Eixample,2096,1443,777,666
2013,2,Eixample,8,l'Antiga Esquerra de l'Eixample,2097,1133,606,527
2013,2,Eixample,8,l'Antiga Esquerra de l'Eixample,2098,1542,879,663
2013,2,Eixample,8,l'Antiga Esquerra de l'Eixample,2099,1472,791,681
2013,2,Eixample,8,l'Antiga Esquerra de l'Eixample,2100,1386,734,652
2013,2,Eixample,8,l'Antiga Esquerra de l'Eixample,2101,2124,1170,954
2013,2,Eixample,8,l'Antiga Esquerra de l'Eixample,2102,1375,780,595
2013,2,Eixample,8,l'Antiga Esquerra de l'Eixample,2103,1776,992,784
2013,2,Eixample,8,l'Antiga Esquerra de l'Eixample,2104,1121,609,512
2013,2,Eixample,8,l'Antiga Esquerra de l'Eixample,2105,2106,1180,926
2013,2,Eixample,8,l'Antiga Esquerra de l'Eixample,2106,1450,762,688
2013,2,Eixample,8,l'Antiga Esquerra de l'Eixample,2107,1617,892,725
2013,2,Eixample,8,l'Antiga Esquerra de l'Eixample,2108,1526,845,681
2013,2,Eixample,8,l'Antiga Esquerra de l'Eixample,2109,1926,1062,864
2013,2,Eixample,9,la Nova Esquerra de l'Eixample,2110,1916,1011,905
2013,2,Eixample,9,la Nova Esquerra de l'Eixample,2111,1781,997,784
2013,2,Eixample,9,la Nova Esquerra de l'Eixample,2112,1307,706,601
2013,2,Eixample,9,la Nova Esquerra de l'Eixample,2113,1870,987,883
2013,2,Eixample,9,la Nova Esquerra de l'Eixample,2114,1692,939,753
2013,2,Eixample,9,la Nova Esquerra de l'Eixample,2115,1376,751,625
2013,2,Eixample,9,la Nova Esquerra de l'Eixample,2116,1041,575,466
2013,2,Eixample,9,la Nova Esquerra de l'Eixample,2117,1206,627,579
2013,2,Eixample,9,la Nova Esquerra de l'Eixample,2118,1567,877,690
2013,2,Eixample,9,la Nova Esquerra de l'Eixample,2119,1311,722,589
2013,2,Eixample,9,la Nova Esquerra de l'Eixample,2120,1194,635,559
2013,2,Eixample,9,la Nova Esquerra de l'Eixample,2121,1275,686,589
2013,2,Eixample,9,la Nova Esquerra de l'Eixample,2122,1053,578,475
2013,2,Eixample,9,la Nova Esquerra de l'Eixample,2123,1101,587,514
2013,2,Eixample,9,la Nova Esquerra de l'Eixample,2124,1124,612,512
2013,2,Eixample,9,la Nova Esquerra de l'Eixample,2125,1713,937,776
2013,2,Eixample,9,la Nova Esquerra de l'Eixample,2126,1513,826,687
2013,2,Eixample,9,la Nova Esquerra de l'Eixample,2127,1119,572,547
2013,2,Eixample,9,la Nova Esquerra de l'Eixample,2128,1335,724,611
2013,2,Eixample,9,la Nova Esquerra de l'Eixample,2129,1539,840,699
2013,2,Eixample,9,la Nova Esquerra de l'Eixample,2130,1116,570,546
2013,2,Eixample,9,la Nova Esquerra de l'Eixample,2131,1220,656,564
2013,2,Eixample,9,la Nova Esquerra de l'Eixample,2132,1220,639,581
2013,2,Eixample,9,la Nova Esquerra de l'Eixample,2133,870,465,405
2013,2,Eixample,9,la Nova Esquerra de l'Eixample,2134,1476,801,675
2013,2,Eixample,9,la Nova Esquerra de l'Eixample,2135,2090,1138,952
2013,2,Eixample,9,la Nova Esquerra de l'Eixample,2136,900,471,429
2013,2,Eixample,9,la Nova Esquerra de l'Eixample,2137,1452,786,666
2013,2,Eixample,9,la Nova Esquerra de l'Eixample,2138,1915,1015,900
2013,2,Eixample,9,la Nova Esquerra de l'Eixample,2139,1688,901,787
2013,2,Eixample,9,la Nova Esquerra de l'Eixample,2140,1897,1021,876
2013,2,Eixample,9,la Nova Esquerra de l'Eixample,2141,1247,681,566
2013,2,Eixample,9,la Nova Esquerra de l'Eixample,2142,2020,1092,928
2013,2,Eixample,9,la Nova Esquerra de l'Eixample,2143,1253,655,598
2013,2,Eixample,9,la Nova Esquerra de l'Eixample,2144,1455,791,664
2013,2,Eixample,9,la Nova Esquerra de l'Eixample,2145,1257,639,618
2013,2,Eixample,9,la Nova Esquerra de l'Eixample,2146,1160,636,524
2013,2,Eixample,9,la Nova Esquerra de l'Eixample,2147,2200,1223,977
2013,2,Eixample,9,la Nova Esquerra de l'Eixample,2148,1632,855,777
2013,2,Eixample,9,la Nova Esquerra de l'Eixample,2149,1789,936,853
2013,2,Eixample,10,Sant Antoni,2150,1483,798,685
2013,2,Eixample,10,Sant Antoni,2151,1507,812,695
2013,2,Eixample,10,Sant Antoni,2152,1280,716,564
2013,2,Eixample,10,Sant Antoni,2153,1331,729,602
2013,2,Eixample,10,Sant Antoni,2154,1060,570,490
2013,2,Eixample,10,Sant Antoni,2155,1866,1026,840
2013,2,Eixample,10,Sant Antoni,2156,1268,687,581
2013,2,Eixample,10,Sant Antoni,2157,1160,626,534
2013,2,Eixample,10,Sant Antoni,2158,1675,881,794
2013,2,Eixample,10,Sant Antoni,2159,1818,956,862
2013,2,Eixample,10,Sant Antoni,2160,2032,1074,958
2013,2,Eixample,10,Sant Antoni,2161,1139,609,530
2013,2,Eixample,10,Sant Antoni,2162,1349,707,642
2013,2,Eixample,10,Sant Antoni,2163,1767,950,817
2013,2,Eixample,10,Sant Antoni,2164,1443,763,680
2013,2,Eixample,10,Sant Antoni,2165,1579,818,761
2013,2,Eixample,10,Sant Antoni,2166,2100,1118,982
2013,2,Eixample,10,Sant Antoni,2167,2107,1097,1010
2013,2,Eixample,10,Sant Antoni,2168,2204,1159,1045
2013,2,Eixample,10,Sant Antoni,2169,1568,823,745
2013,2,Eixample,10,Sant Antoni,2170,1603,833,770
2013,2,Eixample,10,Sant Antoni,2171,1687,895,792
2013,2,Eixample,10,Sant Antoni,2172,1627,847,780
2013,2,Eixample,10,Sant Antoni,2173,1611,845,766
2013,3,Sants-Montjuïc,11,el Poble-sec,3001,1743,915,828
2013,3,Sants-Montjuïc,11,el Poble-sec,3002,2033,1072,961
2013,3,Sants-Montjuïc,11,el Poble-sec,3003,1676,876,800
2013,3,Sants-Montjuïc,11,el Poble-sec,3004,1584,813,771
2013,3,Sants-Montjuïc,11,el Poble-sec,3005,1231,652,579
2013,3,Sants-Montjuïc,11,el Poble-sec,3006,1401,698,703
2013,3,Sants-Montjuïc,11,el Poble-sec,3007,1668,860,808
2013,3,Sants-Montjuïc,11,el Poble-sec,3008,1236,643,593
2013,3,Sants-Montjuïc,11,el Poble-sec,3009,1236,658,578
2013,3,Sants-Montjuïc,11,el Poble-sec,3010,1725,893,832
2013,3,Sants-Montjuïc,11,el Poble-sec,3011,1881,939,942
2013,3,Sants-Montjuïc,11,el Poble-sec,3012,2263,1174,1089
2013,3,Sants-Montjuïc,11,el Poble-sec,3013,1911,922,989
2013,3,Sants-Montjuïc,11,el Poble-sec,3014,1917,921,996
2013,3,Sants-Montjuïc,11,el Poble-sec,3015,3164,1587,1577
2013,3,Sants-Montjuïc,11,el Poble-sec,3016,1258,641,617
2013,3,Sants-Montjuïc,11,el Poble-sec,3017,1838,902,936
2013,3,Sants-Montjuïc,11,el Poble-sec,3018,1690,849,841
2013,3,Sants-Montjuïc,11,el Poble-sec,3019,1520,796,724
2013,3,Sants-Montjuïc,11,el Poble-sec,3020,1272,636,636
2013,3,Sants-Montjuïc,11,el Poble-sec,3021,1140,608,532
2013,3,Sants-Montjuïc,11,el Poble-sec,3022,1505,759,746
2013,3,Sants-Montjuïc,11,el Poble-sec,3023,1953,972,981
2013,3,Sants-Montjuïc,11,el Poble-sec,3024,2157,1072,1085
2013,3,Sants-Montjuïc,12,la Marina del Prat Vermell,3025,1172,574,598
2013,3,Sants-Montjuïc,13,la Marina de Port,3026,1030,527,503
2013,3,Sants-Montjuïc,13,la Marina de Port,3027,1748,902,846
2013,3,Sants-Montjuïc,13,la Marina de Port,3028,2130,1095,1035
2013,3,Sants-Montjuïc,13,la Marina de Port,3029,1274,700,574
2013,3,Sants-Montjuïc,13,la Marina de Port,3030,1583,871,712
2013,3,Sants-Montjuïc,13,la Marina de Port,3031,2489,1283,1206
2013,3,Sants-Montjuïc,13,la Marina de Port,3032,1564,825,739
2013,3,Sants-Montjuïc,13,la Marina de Port,3033,1422,709,713
2013,3,Sants-Montjuïc,13,la Marina de Port,3034,1606,818,788
2013,3,Sants-Montjuïc,13,la Marina de Port,3035,2344,1195,1149
2013,3,Sants-Montjuïc,13,la Marina de Port,3036,2316,1186,1130
2013,3,Sants-Montjuïc,13,la Marina de Port,3037,1122,575,547
2013,3,Sants-Montjuïc,13,la Marina de Port,3038,1041,550,491
2013,3,Sants-Montjuïc,13,la Marina de Port,3039,2437,1205,1232
2013,3,Sants-Montjuïc,13,la Marina de Port,3211,1421,736,685
2013,3,Sants-Montjuïc,13,la Marina de Port,3212,2372,1264,1108
2013,3,Sants-Montjuïc,13,la Marina de Port,3213,2377,1213,1164
2013,3,Sants-Montjuïc,14,la Font de la Guatlla,3040,1551,811,740
2013,3,Sants-Montjuïc,14,la Font de la Guatlla,3041,1350,722,628
2013,3,Sants-Montjuïc,14,la Font de la Guatlla,3042,1338,686,652
2013,3,Sants-Montjuïc,14,la Font de la Guatlla,3043,1650,862,788
2013,3,Sants-Montjuïc,14,la Font de la Guatlla,3044,1904,1002,902
2013,3,Sants-Montjuïc,14,la Font de la Guatlla,3045,1057,565,492
2013,3,Sants-Montjuïc,14,la Font de la Guatlla,3046,1462,791,671
2013,3,Sants-Montjuïc,15,Hostafrancs,3047,1809,929,880
2013,3,Sants-Montjuïc,15,Hostafrancs,3048,1405,745,660
2013,3,Sants-Montjuïc,15,Hostafrancs,3049,1675,868,807
2013,3,Sants-Montjuïc,15,Hostafrancs,3050,1616,842,774
2013,3,Sants-Montjuïc,15,Hostafrancs,3051,1889,969,920
2013,3,Sants-Montjuïc,15,Hostafrancs,3052,1258,642,616
2013,3,Sants-Montjuïc,15,Hostafrancs,3053,2118,1104,1014
2013,3,Sants-Montjuïc,15,Hostafrancs,3054,1791,932,859
2013,3,Sants-Montjuïc,15,Hostafrancs,3055,1571,805,766
2013,3,Sants-Montjuïc,15,Hostafrancs,3056,850,463,387
2013,3,Sants-Montjuïc,16,la Bordeta,3057,1538,842,696
2013,3,Sants-Montjuïc,16,la Bordeta,3058,1324,752,572
2013,3,Sants-Montjuïc,16,la Bordeta,3059,1219,624,595
2013,3,Sants-Montjuïc,16,la Bordeta,3060,1374,717,657
2013,3,Sants-Montjuïc,16,la Bordeta,3061,1103,598,505
2013,3,Sants-Montjuïc,16,la Bordeta,3062,1667,885,782
2013,3,Sants-Montjuïc,16,la Bordeta,3063,1348,681,667
2013,3,Sants-Montjuïc,16,la Bordeta,3064,1230,659,571
2013,3,Sants-Montjuïc,16,la Bordeta,3065,1438,723,715
2013,3,Sants-Montjuïc,16,la Bordeta,3066,2325,1187,1138
2013,3,Sants-Montjuïc,16,la Bordeta,3067,1654,879,775
2013,3,Sants-Montjuïc,16,la Bordeta,3068,1176,603,573
2013,3,Sants-Montjuïc,16,la Bordeta,3069,1185,619,566
2013,3,Sants-Montjuïc,17,Sants - Badal,3070,1299,662,637
2013,3,Sants-Montjuïc,17,Sants - Badal,3071,1309,683,626
2013,3,Sants-Montjuïc,17,Sants - Badal,3072,1422,764,658
2013,3,Sants-Montjuïc,17,Sants - Badal,3073,1586,851,735
2013,3,Sants-Montjuïc,17,Sants - Badal,3074,1792,962,830
2013,3,Sants-Montjuïc,17,Sants - Badal,3075,1614,861,753
2013,3,Sants-Montjuïc,17,Sants - Badal,3076,1036,533,503
2013,3,Sants-Montjuïc,17,Sants - Badal,3077,1353,730,623
2013,3,Sants-Montjuïc,17,Sants - Badal,3078,1730,881,849
2013,3,Sants-Montjuïc,17,Sants - Badal,3079,1802,938,864
2013,3,Sants-Montjuïc,17,Sants - Badal,3080,1573,867,706
2013,3,Sants-Montjuïc,17,Sants - Badal,3081,1967,1073,894
2013,3,Sants-Montjuïc,17,Sants - Badal,3082,1812,968,844
2013,3,Sants-Montjuïc,17,Sants - Badal,3083,1362,733,629
2013,3,Sants-Montjuïc,17,Sants - Badal,3084,1498,794,704
2013,3,Sants-Montjuïc,17,Sants - Badal,3085,1200,636,564
2013,3,Sants-Montjuïc,18,Sants,3086,1288,679,609
2013,3,Sants-Montjuïc,18,Sants,3087,1474,796,678
2013,3,Sants-Montjuïc,18,Sants,3088,1421,753,668
2013,3,Sants-Montjuïc,18,Sants,3089,1184,646,538
2013,3,Sants-Montjuïc,18,Sants,3090,1078,584,494
2013,3,Sants-Montjuïc,18,Sants,3091,1510,766,744
2013,3,Sants-Montjuïc,18,Sants,3092,1275,650,625
2013,3,Sants-Montjuïc,18,Sants,3093,1591,831,760
2013,3,Sants-Montjuïc,18,Sants,3094,1109,597,512
2013,3,Sants-Montjuïc,18,Sants,3095,1650,903,747
2013,3,Sants-Montjuïc,18,Sants,3096,1593,828,765
2013,3,Sants-Montjuïc,18,Sants,3097,1683,864,819
2013,3,Sants-Montjuïc,18,Sants,3098,1425,724,701
2013,3,Sants-Montjuïc,18,Sants,3099,1023,551,472
2013,3,Sants-Montjuïc,18,Sants,3100,1237,663,574
2013,3,Sants-Montjuïc,18,Sants,3101,1826,842,984
2013,3,Sants-Montjuïc,18,Sants,3102,1343,711,632
2013,3,Sants-Montjuïc,18,Sants,3103,1167,619,548
2013,3,Sants-Montjuïc,18,Sants,3104,1488,759,729
2013,3,Sants-Montjuïc,18,Sants,3105,1173,624,549
2013,3,Sants-Montjuïc,18,Sants,3106,1263,684,579
2013,3,Sants-Montjuïc,18,Sants,3107,1533,786,747
2013,3,Sants-Montjuïc,18,Sants,3108,1594,861,733
2013,3,Sants-Montjuïc,18,Sants,3109,1479,776,703
2013,3,Sants-Montjuïc,18,Sants,3110,1472,775,697
2013,3,Sants-Montjuïc,18,Sants,3111,1300,705,595
2013,3,Sants-Montjuïc,18,Sants,3112,1857,993,864
2013,3,Sants-Montjuïc,18,Sants,3113,1560,823,737
2013,3,Sants-Montjuïc,18,Sants,3114,1465,795,670
2013,4,Les Corts,19,les Corts,4001,1211,648,563
2013,4,Les Corts,19,les Corts,4002,1822,963,859
2013,4,Les Corts,19,les Corts,4003,1054,536,518
2013,4,Les Corts,19,les Corts,4004,1024,547,477
2013,4,Les Corts,19,les Corts,4005,1242,660,582
2013,4,Les Corts,19,les Corts,4006,1171,621,550
2013,4,Les Corts,19,les Corts,4007,1097,615,482
2013,4,Les Corts,19,les Corts,4008,1049,564,485
2013,4,Les Corts,19,les Corts,4009,1461,784,677
2013,4,Les Corts,19,les Corts,4010,932,499,433
2013,4,Les Corts,19,les Corts,4011,1686,887,799
2013,4,Les Corts,19,les Corts,4012,1407,765,642
2013,4,Les Corts,19,les Corts,4013,1230,670,560
2013,4,Les Corts,19,les Corts,4014,808,445,363
2013,4,Les Corts,19,les Corts,4015,1910,1054,856
2013,4,Les Corts,19,les Corts,4016,1149,602,547
2013,4,Les Corts,19,les Corts,4017,1143,628,515
2013,4,Les Corts,19,les Corts,4018,1501,826,675
2013,4,Les Corts,19,les Corts,4019,1260,691,569
2013,4,Les Corts,19,les Corts,4020,1444,780,664
2013,4,Les Corts,19,les Corts,4021,1312,730,582
2013,4,Les Corts,19,les Corts,4022,1497,772,725
2013,4,Les Corts,19,les Corts,4023,1079,567,512
2013,4,Les Corts,19,les Corts,4024,1067,551,516
2013,4,Les Corts,19,les Corts,4025,1196,620,576
2013,4,Les Corts,19,les Corts,4026,1321,714,607
2013,4,Les Corts,19,les Corts,4027,1224,688,536
2013,4,Les Corts,19,les Corts,4028,1342,718,624
2013,4,Les Corts,19,les Corts,4029,1178,647,531
2013,4,Les Corts,19,les Corts,4030,1756,945,811
2013,4,Les Corts,19,les Corts,4031,1934,854,1080
2013,4,Les Corts,19,les Corts,4032,1562,848,714
2013,4,Les Corts,19,les Corts,4033,1239,678,561
2013,4,Les Corts,19,les Corts,4034,1477,784,693
2013,4,Les Corts,19,les Corts,4035,1436,785,651
2013,4,Les Corts,20,la Maternitat i Sant Ramon,4036,1750,959,791
2013,4,Les Corts,20,la Maternitat i Sant Ramon,4037,2100,1118,982
2013,4,Les Corts,20,la Maternitat i Sant Ramon,4038,1276,681,595
2013,4,Les Corts,20,la Maternitat i Sant Ramon,4039,1198,644,554
2013,4,Les Corts,20,la Maternitat i Sant Ramon,4040,1552,830,722
2013,4,Les Corts,20,la Maternitat i Sant Ramon,4041,1392,754,638
2013,4,Les Corts,20,la Maternitat i Sant Ramon,4042,1738,905,833
2013,4,Les Corts,20,la Maternitat i Sant Ramon,4043,1634,901,733
2013,4,Les Corts,20,la Maternitat i Sant Ramon,4044,1619,852,767
2013,4,Les Corts,20,la Maternitat i Sant Ramon,4045,1411,751,660
2013,4,Les Corts,20,la Maternitat i Sant Ramon,4046,2438,1237,1201
2013,4,Les Corts,20,la Maternitat i Sant Ramon,4047,1586,840,746
2013,4,Les Corts,20,la Maternitat i Sant Ramon,4048,1499,812,687
2013,4,Les Corts,20,la Maternitat i Sant Ramon,4049,1135,603,532
2013,4,Les Corts,20,la Maternitat i Sant Ramon,4084,1346,737,609
2013,4,Les Corts,21,Pedralbes,4050,2077,1112,965
2013,4,Les Corts,21,Pedralbes,4051,1570,859,711
2013,4,Les Corts,21,Pedralbes,4052,2164,1168,996
2013,4,Les Corts,21,Pedralbes,4053,1550,824,726
2013,4,Les Corts,21,Pedralbes,4054,1078,581,497
2013,4,Les Corts,21,Pedralbes,4055,1581,810,771
2013,4,Les Corts,21,Pedralbes,4056,1796,963,833
2013,5,Sarrià-Sant Gervasi,22,"Vallvidrera, el Tibidabo i les Planes",5001,1525,775,750
2013,5,Sarrià-Sant Gervasi,22,"Vallvidrera, el Tibidabo i les Planes",5002,1571,836,735
2013,5,Sarrià-Sant Gervasi,22,"Vallvidrera, el Tibidabo i les Planes",5003,1347,698,649
2013,5,Sarrià-Sant Gervasi,23,Sarrià,5004,1121,640,481
2013,5,Sarrià-Sant Gervasi,23,Sarrià,5005,1120,582,538
2013,5,Sarrià-Sant Gervasi,23,Sarrià,5006,1800,902,898
2013,5,Sarrià-Sant Gervasi,23,Sarrià,5007,1525,817,708
2013,5,Sarrià-Sant Gervasi,23,Sarrià,5008,1547,851,696
2013,5,Sarrià-Sant Gervasi,23,Sarrià,5009,1739,960,779
2013,5,Sarrià-Sant Gervasi,23,Sarrià,5010,1545,842,703
2013,5,Sarrià-Sant Gervasi,23,Sarrià,5011,1402,750,652
2013,5,Sarrià-Sant Gervasi,23,Sarrià,5012,1419,766,653
2013,5,Sarrià-Sant Gervasi,23,Sarrià,5013,1704,904,800
2013,5,Sarrià-Sant Gervasi,23,Sarrià,5014,1671,893,778
2013,5,Sarrià-Sant Gervasi,23,Sarrià,5015,1590,847,743
2013,5,Sarrià-Sant Gervasi,23,Sarrià,5016,1761,964,797
2013,5,Sarrià-Sant Gervasi,23,Sarrià,5017,1656,869,787
2013,5,Sarrià-Sant Gervasi,23,Sarrià,5018,1235,676,559
2013,5,Sarrià-Sant Gervasi,23,Sarrià,5019,1675,898,777
2013,5,Sarrià-Sant Gervasi,24,les Tres Torres,5020,1088,612,476
2013,5,Sarrià-Sant Gervasi,24,les Tres Torres,5021,1286,683,603
2013,5,Sarrià-Sant Gervasi,24,les Tres Torres,5022,1721,975,746
2013,5,Sarrià-Sant Gervasi,24,les Tres Torres,5023,1464,801,663
2013,5,Sarrià-Sant Gervasi,24,les Tres Torres,5024,1851,999,852
2013,5,Sarrià-Sant Gervasi,24,les Tres Torres,5025,1306,692,614
2013,5,Sarrià-Sant Gervasi,24,les Tres Torres,5026,1378,727,651
2013,5,Sarrià-Sant Gervasi,24,les Tres Torres,5027,1356,708,648
2013,5,Sarrià-Sant Gervasi,24,les Tres Torres,5028,1462,770,692
2013,5,Sarrià-Sant Gervasi,24,les Tres Torres,5029,1677,873,804
2013,5,Sarrià-Sant Gervasi,24,les Tres Torres,5030,1447,770,677
2013,5,Sarrià-Sant Gervasi,25,Sant Gervasi - la Bonanova,5031,1603,854,749
2013,5,Sarrià-Sant Gervasi,25,Sant Gervasi - la Bonanova,5032,1636,895,741
2013,5,Sarrià-Sant Gervasi,25,Sant Gervasi - la Bonanova,5033,1322,719,603
2013,5,Sarrià-Sant Gervasi,25,Sant Gervasi - la Bonanova,5034,1167,660,507
2013,5,Sarrià-Sant Gervasi,25,Sant Gervasi - la Bonanova,5035,1112,582,530
2013,5,Sarrià-Sant Gervasi,25,Sant Gervasi - la Bonanova,5036,1671,896,775
2013,5,Sarrià-Sant Gervasi,25,Sant Gervasi - la Bonanova,5037,1363,777,586
2013,5,Sarrià-Sant Gervasi,25,Sant Gervasi - la Bonanova,5038,1268,673,595
2013,5,Sarrià-Sant Gervasi,25,Sant Gervasi - la Bonanova,5039,1586,862,724
2013,5,Sarrià-Sant Gervasi,25,Sant Gervasi - la Bonanova,5040,1345,732,613
2013,5,Sarrià-Sant Gervasi,25,Sant Gervasi - la Bonanova,5041,1896,914,982
2013,5,Sarrià-Sant Gervasi,25,Sant Gervasi - la Bonanova,5042,1242,657,585
2013,5,Sarrià-Sant Gervasi,25,Sant Gervasi - la Bonanova,5043,1408,760,648
2013,5,Sarrià-Sant Gervasi,25,Sant Gervasi - la Bonanova,5044,1274,710,564
2013,5,Sarrià-Sant Gervasi,25,Sant Gervasi - la Bonanova,5045,1525,847,678
2013,5,Sarrià-Sant Gervasi,25,Sant Gervasi - la Bonanova,5046,1155,653,502
2013,5,Sarrià-Sant Gervasi,25,Sant Gervasi - la Bonanova,5047,1294,705,589
2013,5,Sarrià-Sant Gervasi,25,Sant Gervasi - la Bonanova,5048,1263,692,571
2013,5,Sarrià-Sant Gervasi,26,Sant Gervasi - Galvany,5049,1617,866,751
2013,5,Sarrià-Sant Gervasi,26,Sant Gervasi - Galvany,5050,1539,851,688
2013,5,Sarrià-Sant Gervasi,26,Sant Gervasi - Galvany,5051,1573,825,748
2013,5,Sarrià-Sant Gervasi,26,Sant Gervasi - Galvany,5052,1466,805,661
2013,5,Sarrià-Sant Gervasi,26,Sant Gervasi - Galvany,5053,1531,823,708
2013,5,Sarrià-Sant Gervasi,26,Sant Gervasi - Galvany,5054,1093,604,489
2013,5,Sarrià-Sant Gervasi,26,Sant Gervasi - Galvany,5055,1480,783,697
2013,5,Sarrià-Sant Gervasi,26,Sant Gervasi - Galvany,5056,1243,716,527
2013,5,Sarrià-Sant Gervasi,26,Sant Gervasi - Galvany,5057,1692,897,795
2013,5,Sarrià-Sant Gervasi,26,Sant Gervasi - Galvany,5058,1563,865,698
2013,5,Sarrià-Sant Gervasi,26,Sant Gervasi - Galvany,5059,1545,868,677
2013,5,Sarrià-Sant Gervasi,26,Sant Gervasi - Galvany,5060,1112,621,491
2013,5,Sarrià-Sant Gervasi,26,Sant Gervasi - Galvany,5061,1499,806,693
2013,5,Sarrià-Sant Gervasi,26,Sant Gervasi - Galvany,5062,1611,899,712
2013,5,Sarrià-Sant Gervasi,26,Sant Gervasi - Galvany,5063,1564,868,696
2013,5,Sarrià-Sant Gervasi,26,Sant Gervasi - Galvany,5064,1611,904,707
2013,5,Sarrià-Sant Gervasi,26,Sant Gervasi - Galvany,5065,1632,907,725
2013,5,Sarrià-Sant Gervasi,26,Sant Gervasi - Galvany,5066,1222,685,537
2013,5,Sarrià-Sant Gervasi,26,Sant Gervasi - Galvany,5067,1293,701,592
2013,5,Sarrià-Sant Gervasi,26,Sant Gervasi - Galvany,5068,1481,804,677
2013,5,Sarrià-Sant Gervasi,26,Sant Gervasi - Galvany,5069,1665,909,756
2013,5,Sarrià-Sant Gervasi,26,Sant Gervasi - Galvany,5070,1439,801,638
2013,5,Sarrià-Sant Gervasi,26,Sant Gervasi - Galvany,5071,1554,858,696
2013,5,Sarrià-Sant Gervasi,26,Sant Gervasi - Galvany,5072,1625,933,692
2013,5,Sarrià-Sant Gervasi,26,Sant Gervasi - Galvany,5073,1625,889,736
2013,5,Sarrià-Sant Gervasi,26,Sant Gervasi - Galvany,5074,1625,883,742
2013,5,Sarrià-Sant Gervasi,26,Sant Gervasi - Galvany,5075,1713,965,748
2013,5,Sarrià-Sant Gervasi,26,Sant Gervasi - Galvany,5076,1343,728,615
2013,5,Sarrià-Sant Gervasi,26,Sant Gervasi - Galvany,5077,1386,774,612
2013,5,Sarrià-Sant Gervasi,26,Sant Gervasi - Galvany,5078,2012,1074,938
2013,5,Sarrià-Sant Gervasi,26,Sant Gervasi - Galvany,5079,1194,646,548
2013,5,Sarrià-Sant Gervasi,27,el Putget i Farró,5080,1325,761,564
2013,5,Sarrià-Sant Gervasi,27,el Putget i Farró,5081,1519,858,661
2013,5,Sarrià-Sant Gervasi,27,el Putget i Farró,5082,1607,874,733
2013,5,Sarrià-Sant Gervasi,27,el Putget i Farró,5083,1266,682,584
2013,5,Sarrià-Sant Gervasi,27,el Putget i Farró,5084,1346,767,579
2013,5,Sarrià-Sant Gervasi,27,el Putget i Farró,5085,1247,656,591
2013,5,Sarrià-Sant Gervasi,27,el Putget i Farró,5086,1274,697,577
2013,5,Sarrià-Sant Gervasi,27,el Putget i Farró,5087,1523,833,690
2013,5,Sarrià-Sant Gervasi,27,el Putget i Farró,5088,1728,910,818
2013,5,Sarrià-Sant Gervasi,27,el Putget i Farró,5089,1662,907,755
2013,5,Sarrià-Sant Gervasi,27,el Putget i Farró,5090,1890,1000,890
2013,5,Sarrià-Sant Gervasi,27,el Putget i Farró,5091,1512,867,645
2013,5,Sarrià-Sant Gervasi,27,el Putget i Farró,5092,1524,853,671
2013,5,Sarrià-Sant Gervasi,27,el Putget i Farró,5093,1103,613,490
2013,5,Sarrià-Sant Gervasi,27,el Putget i Farró,5094,2526,1422,1104
2013,5,Sarrià-Sant Gervasi,27,el Putget i Farró,5095,1604,887,717
2013,5,Sarrià-Sant Gervasi,27,el Putget i Farró,5096,1064,584,480
2013,5,Sarrià-Sant Gervasi,27,el Putget i Farró,5097,1606,840,766
2013,5,Sarrià-Sant Gervasi,27,el Putget i Farró,5098,1522,826,696
2013,6,Gràcia,28,Vallcarca i els Penitents,6001,1171,665,506
2013,6,Gràcia,28,Vallcarca i els Penitents,6002,1485,820,665
2013,6,Gràcia,28,Vallcarca i els Penitents,6003,2228,1154,1074
2013,6,Gràcia,28,Vallcarca i els Penitents,6004,1436,759,677
2013,6,Gràcia,28,Vallcarca i els Penitents,6006,987,528,459
2013,6,Gràcia,28,Vallcarca i els Penitents,6007,1773,952,821
2013,6,Gràcia,28,Vallcarca i els Penitents,6008,1858,1056,802
2013,6,Gràcia,28,Vallcarca i els Penitents,6009,1227,636,591
2013,6,Gràcia,28,Vallcarca i els Penitents,6010,992,531,461
2013,6,Gràcia,28,Vallcarca i els Penitents,6011,1251,671,580
2013,6,Gràcia,28,Vallcarca i els Penitents,6012,1087,578,509
2013,6,Gràcia,29,el Coll,6013,1680,880,800
2013,6,Gràcia,29,el Coll,6014,1301,687,614
2013,6,Gràcia,29,el Coll,6015,1360,723,637
2013,6,Gràcia,29,el Coll,6016,1597,853,744
2013,6,Gràcia,29,el Coll,6017,1289,689,600
2013,6,Gràcia,30,la Salut,6018,1253,672,581
2013,6,Gràcia,30,la Salut,6019,1501,794,707
2013,6,Gràcia,30,la Salut,6020,1140,607,533
2013,6,Gràcia,30,la Salut,6021,1370,728,642
2013,6,Gràcia,30,la Salut,6022,1415,727,688
2013,6,Gràcia,30,la Salut,6023,1348,721,627
2013,6,Gràcia,30,la Salut,6024,1617,905,712
2013,6,Gràcia,30,la Salut,6025,1358,750,608
2013,6,Gràcia,30,la Salut,6026,982,547,435
2013,6,Gràcia,30,la Salut,6027,1215,684,531
2013,6,Gràcia,31,Vila de Gràcia,6028,1348,708,640
2013,6,Gràcia,31,Vila de Gràcia,6029,1267,701,566
2013,6,Gràcia,31,Vila de Gràcia,6030,1341,749,592
2013,6,Gràcia,31,Vila de Gràcia,6031,1120,620,500
2013,6,Gràcia,31,Vila de Gràcia,6032,1114,595,519
2013,6,Gràcia,31,Vila de Gràcia,6033,1305,706,599
2013,6,Gràcia,31,Vila de Gràcia,6034,1287,730,557
2013,6,Gràcia,31,Vila de Gràcia,6035,990,550,440
2013,6,Gràcia,31,Vila de Gràcia,6036,1332,748,584
2013,6,Gràcia,31,Vila de Gràcia,6037,1095,581,514
2013,6,Gràcia,31,Vila de Gràcia,6038,1431,816,615
2013,6,Gràcia,31,Vila de Gràcia,6039,1650,910,740
2013,6,Gràcia,31,Vila de Gràcia,6040,1641,941,700
2013,6,Gràcia,31,Vila de Gràcia,6041,1620,906,714
2013,6,Gràcia,31,Vila de Gràcia,6042,1644,885,759
2013,6,Gràcia,31,Vila de Gràcia,6043,1256,694,562
2013,6,Gràcia,31,Vila de Gràcia,6044,1452,760,692
2013,6,Gràcia,31,Vila de Gràcia,6045,1261,682,579
2013,6,Gràcia,31,Vila de Gràcia,6046,1062,585,477
2013,6,Gràcia,31,Vila de Gràcia,6047,1766,820,946
2013,6,Gràcia,31,Vila de Gràcia,6048,1386,763,623
2013,6,Gràcia,31,Vila de Gràcia,6049,1116,615,501
2013,6,Gràcia,31,Vila de Gràcia,6050,1227,663,564
2013,6,Gràcia,31,Vila de Gràcia,6051,1344,764,580
2013,6,Gràcia,31,Vila de Gràcia,6052,1554,854,700
2013,6,Gràcia,31,Vila de Gràcia,6053,1479,803,676
2013,6,Gràcia,31,Vila de Gràcia,6054,1691,905,786
2013,6,Gràcia,31,Vila de Gràcia,6055,1367,752,615
2013,6,Gràcia,31,Vila de Gràcia,6056,1577,843,734
2013,6,Gràcia,31,Vila de Gràcia,6057,1582,874,708
2013,6,Gràcia,31,Vila de Gràcia,6058,1714,965,749
2013,6,Gràcia,31,Vila de Gràcia,6059,1510,821,689
2013,6,Gràcia,31,Vila de Gràcia,6060,1846,981,865
2013,6,Gràcia,31,Vila de Gràcia,6061,1381,754,627
2013,6,Gràcia,31,Vila de Gràcia,6062,1301,685,616
2013,6,Gràcia,31,Vila de Gràcia,6063,1579,854,725
2013,6,Gràcia,32,el Camp d'en Grassot i Gràcia Nova,6064,1928,1038,890
2013,6,Gràcia,32,el Camp d'en Grassot i Gràcia Nova,6065,1144,617,527
2013,6,Gràcia,32,el Camp d'en Grassot i Gràcia Nova,6066,1017,574,443
2013,6,Gràcia,32,el Camp d'en Grassot i Gràcia Nova,6067,1800,983,817
2013,6,Gràcia,32,el Camp d'en Grassot i Gràcia Nova,6068,1515,844,671
2013,6,Gràcia,32,el Camp d'en Grassot i Gràcia Nova,6069,1167,630,537
2013,6,Gràcia,32,el Camp d'en Grassot i Gràcia Nova,6070,1930,1044,886
2013,6,Gràcia,32,el Camp d'en Grassot i Gràcia Nova,6071,1068,571,497
2013,6,Gràcia,32,el Camp d'en Grassot i Gràcia Nova,6072,1613,876,737
2013,6,Gràcia,32,el Camp d'en Grassot i Gràcia Nova,6073,1405,742,663
2013,6,Gràcia,32,el Camp d'en Grassot i Gràcia Nova,6074,1090,583,507
2013,6,Gràcia,32,el Camp d'en Grassot i Gràcia Nova,6075,1061,566,495
2013,6,Gràcia,32,el Camp d'en Grassot i Gràcia Nova,6076,1291,651,640
2013,6,Gràcia,32,el Camp d'en Grassot i Gràcia Nova,6077,1291,713,578
2013,6,Gràcia,32,el Camp d'en Grassot i Gràcia Nova,6078,1290,683,607
2013,6,Gràcia,32,el Camp d'en Grassot i Gràcia Nova,6079,1117,604,513
2013,6,Gràcia,32,el Camp d'en Grassot i Gràcia Nova,6080,1173,615,558
2013,6,Gràcia,32,el Camp d'en Grassot i Gràcia Nova,6081,1288,695,593
2013,6,Gràcia,32,el Camp d'en Grassot i Gràcia Nova,6082,1744,960,784
2013,6,Gràcia,32,el Camp d'en Grassot i Gràcia Nova,6083,1717,916,801
2013,6,Gràcia,32,el Camp d'en Grassot i Gràcia Nova,6084,1503,812,691
2013,6,Gràcia,32,el Camp d'en Grassot i Gràcia Nova,6085,1223,687,536
2013,6,Gràcia,32,el Camp d'en Grassot i Gràcia Nova,6086,941,505,436
2013,6,Gràcia,32,el Camp d'en Grassot i Gràcia Nova,6087,1885,1023,862
2013,6,Gràcia,32,el Camp d'en Grassot i Gràcia Nova,6088,1239,678,561
2013,7,Horta-Guinardó,33,el Baix Guinardó,7001,1622,920,702
2013,7,Horta-Guinardó,33,el Baix Guinardó,7002,1120,596,524
2013,7,Horta-Guinardó,33,el Baix Guinardó,7003,1348,718,630
2013,7,Horta-Guinardó,33,el Baix Guinardó,7004,1445,788,657
2013,7,Horta-Guinardó,33,el Baix Guinardó,7005,1526,802,724
2013,7,Horta-Guinardó,33,el Baix Guinardó,7006,995,543,452
2013,7,Horta-Guinardó,33,el Baix Guinardó,7007,1424,793,631
2013,7,Horta-Guinardó,33,el Baix Guinardó,7008,1501,779,722
2013,7,Horta-Guinardó,33,el Baix Guinardó,7009,1175,640,535
2013,7,Horta-Guinardó,33,el Baix Guinardó,7010,1314,708,606
2013,7,Horta-Guinardó,33,el Baix Guinardó,7011,1125,625,500
2013,7,Horta-Guinardó,33,el Baix Guinardó,7012,1544,828,716
2013,7,Horta-Guinardó,33,el Baix Guinardó,7013,1254,670,584
2013,7,Horta-Guinardó,33,el Baix Guinardó,7014,912,488,424
2013,7,Horta-Guinardó,33,el Baix Guinardó,7015,1397,740,657
2013,7,Horta-Guinardó,33,el Baix Guinardó,7016,1309,648,661
2013,7,Horta-Guinardó,33,el Baix Guinardó,7017,1598,870,728
2013,7,Horta-Guinardó,33,el Baix Guinardó,7018,1545,859,686
2013,7,Horta-Guinardó,33,el Baix Guinardó,7019,1493,801,692
2013,7,Horta-Guinardó,34,Can Baró,7020,1546,843,703
2013,7,Horta-Guinardó,34,Can Baró,7021,1039,539,500
2013,7,Horta-Guinardó,34,Can Baró,7022,1105,578,527
2013,7,Horta-Guinardó,34,Can Baró,7023,1284,671,613
2013,7,Horta-Guinardó,34,Can Baró,7024,1497,790,707
2013,7,Horta-Guinardó,34,Can Baró,7025,1436,750,686
2013,7,Horta-Guinardó,34,Can Baró,7026,1066,576,490
2013,7,Horta-Guinardó,35,el Guinardó,7027,1970,1043,927
2013,7,Horta-Guinardó,35,el Guinardó,7028,1437,745,692
2013,7,Horta-Guinardó,35,el Guinardó,7029,1304,664,640
2013,7,Horta-Guinardó,35,el Guinardó,7030,1304,704,600
2013,7,Horta-Guinardó,35,el Guinardó,7031,1504,789,715
2013,7,Horta-Guinardó,35,el Guinardó,7032,1233,614,619
2013,7,Horta-Guinardó,35,el Guinardó,7033,1407,743,664
2013,7,Horta-Guinardó,35,el Guinardó,7034,1417,747,670
2013,7,Horta-Guinardó,35,el Guinardó,7035,1747,972,775
2013,7,Horta-Guinardó,35,el Guinardó,7036,1396,771,625
2013,7,Horta-Guinardó,35,el Guinardó,7037,1444,798,646
2013,7,Horta-Guinardó,35,el Guinardó,7038,1349,732,617
2013,7,Horta-Guinardó,35,el Guinardó,7039,1562,836,726
2013,7,Horta-Guinardó,35,el Guinardó,7040,1472,799,673
2013,7,Horta-Guinardó,35,el Guinardó,7041,1368,767,601
2013,7,Horta-Guinardó,35,el Guinardó,7042,1488,804,684
2013,7,Horta-Guinardó,35,el Guinardó,7043,1383,744,639
2013,7,Horta-Guinardó,35,el Guinardó,7044,1308,700,608
2013,7,Horta-Guinardó,35,el Guinardó,7045,1487,803,684
2013,7,Horta-Guinardó,35,el Guinardó,7046,1426,791,635
2013,7,Horta-Guinardó,35,el Guinardó,7047,1367,747,620
2013,7,Horta-Guinardó,35,el Guinardó,7048,1243,685,558
2013,7,Horta-Guinardó,35,el Guinardó,7049,1223,649,574
2013,7,Horta-Guinardó,35,el Guinardó,7050,1115,591,524
2013,7,Horta-Guinardó,35,el Guinardó,7051,1758,963,795
2013,7,Horta-Guinardó,36,la Font d'en Fargues,7052,1309,708,601
2013,7,Horta-Guinardó,36,la Font d'en Fargues,7053,1493,784,709
2013,7,Horta-Guinardó,36,la Font d'en Fargues,7054,1543,796,747
2013,7,Horta-Guinardó,36,la Font d'en Fargues,7055,1183,626,557
2013,7,Horta-Guinardó,36,la Font d'en Fargues,7056,1183,606,577
2013,7,Horta-Guinardó,36,la Font d'en Fargues,7057,1412,746,666
2013,7,Horta-Guinardó,36,la Font d'en Fargues,7058,1376,702,674
2013,7,Horta-Guinardó,37,el Carmel,7059,1275,665,610
2013,7,Horta-Guinardó,37,el Carmel,7060,1877,948,929
2013,7,Horta-Guinardó,37,el Carmel,7061,1262,621,641
2013,7,Horta-Guinardó,37,el Carmel,7062,1251,657,594
2013,7,Horta-Guinardó,37,el Carmel,7063,1494,744,750
2013,7,Horta-Guinardó,37,el Carmel,7064,1666,876,790
2013,7,Horta-Guinardó,37,el Carmel,7065,1734,896,838
2013,7,Horta-Guinardó,37,el Carmel,7066,1794,933,861
2013,7,Horta-Guinardó,37,el Carmel,7067,1519,795,724
2013,7,Horta-Guinardó,37,el Carmel,7068,1176,642,534
2013,7,Horta-Guinardó,37,el Carmel,7069,1441,729,712
2013,7,Horta-Guinardó,37,el Carmel,7070,1378,715,663
2013,7,Horta-Guinardó,37,el Carmel,7071,1397,723,674
2013,7,Horta-Guinardó,37,el Carmel,7072,1334,694,640
2013,7,Horta-Guinardó,37,el Carmel,7073,1060,592,468
2013,7,Horta-Guinardó,37,el Carmel,7074,1719,902,817
2013,7,Horta-Guinardó,37,el Carmel,7075,1232,625,607
2013,7,Horta-Guinardó,37,el Carmel,7076,1287,674,613
2013,7,Horta-Guinardó,37,el Carmel,7077,1317,683,634
2013,7,Horta-Guinardó,37,el Carmel,7078,1382,707,675
2013,7,Horta-Guinardó,37,el Carmel,7079,1456,766,690
2013,7,Horta-Guinardó,37,el Carmel,7080,1746,914,832
2013,7,Horta-Guinardó,38,la Teixonera,7081,2007,1035,972
2013,7,Horta-Guinardó,38,la Teixonera,7082,1301,676,625
2013,7,Horta-Guinardó,38,la Teixonera,7083,1287,664,623
2013,7,Horta-Guinardó,38,la Teixonera,7084,1318,672,646
2013,7,Horta-Guinardó,38,la Teixonera,7085,1355,699,656
2013,7,Horta-Guinardó,38,la Teixonera,7086,1506,778,728
2013,7,Horta-Guinardó,38,la Teixonera,7087,1608,843,765
2013,7,Horta-Guinardó,38,la Teixonera,7088,1277,656,621
2013,7,Horta-Guinardó,39,Sant Genís dels Agudells,7089,1332,720,612
2013,7,Horta-Guinardó,39,Sant Genís dels Agudells,7090,1400,702,698
2013,7,Horta-Guinardó,39,Sant Genís dels Agudells,7091,1195,624,571
2013,7,Horta-Guinardó,39,Sant Genís dels Agudells,7092,1446,781,665
2013,7,Horta-Guinardó,39,Sant Genís dels Agudells,7093,1530,798,732
2013,7,Horta-Guinardó,40,Montbau,7094,1166,668,498
2013,7,Horta-Guinardó,40,Montbau,7095,1566,853,713
2013,7,Horta-Guinardó,40,Montbau,7096,1458,780,678
2013,7,Horta-Guinardó,40,Montbau,7097,920,528,392
2013,7,Horta-Guinardó,41,la Vall d'Hebron,7098,1803,949,854
2013,7,Horta-Guinardó,41,la Vall d'Hebron,7099,1087,562,525
2013,7,Horta-Guinardó,41,la Vall d'Hebron,7100,1208,647,561
2013,7,Horta-Guinardó,41,la Vall d'Hebron,7101,1392,743,649
2013,7,Horta-Guinardó,42,la Clota,7102,439,223,216
2013,7,Horta-Guinardó,43,Horta,7103,1481,783,698
2013,7,Horta-Guinardó,43,Horta,7104,1612,849,763
2013,7,Horta-Guinardó,43,Horta,7105,1083,560,523
2013,7,Horta-Guinardó,43,Horta,7106,1116,589,527
2013,7,Horta-Guinardó,43,Horta,7107,1237,652,585
2013,7,Horta-Guinardó,43,Horta,7108,1258,650,608
2013,7,Horta-Guinardó,43,Horta,7109,1703,908,795
2013,7,Horta-Guinardó,43,Horta,7110,1032,595,437
2013,7,Horta-Guinardó,43,Horta,7111,904,495,409
2013,7,Horta-Guinardó,43,Horta,7112,1261,661,600
2013,7,Horta-Guinardó,43,Horta,7113,1190,602,588
2013,7,Horta-Guinardó,43,Horta,7114,1160,630,530
2013,7,Horta-Guinardó,43,Horta,7115,1066,577,489
2013,7,Horta-Guinardó,43,Horta,7116,1511,805,706
2013,7,Horta-Guinardó,43,Horta,7117,1551,682,869
2013,7,Horta-Guinardó,43,Horta,7118,1192,662,530
2013,7,Horta-Guinardó,43,Horta,7119,1194,637,557
2013,7,Horta-Guinardó,43,Horta,7120,1261,689,572
2013,7,Horta-Guinardó,43,Horta,7121,1132,614,518
2013,7,Horta-Guinardó,43,Horta,7122,1301,717,584
2013,7,Horta-Guinardó,43,Horta,7123,1326,707,619
2013,8,Nou Barris,44,Vilapicina i la Torre Llobeta,8001,1288,679,609
2013,8,Nou Barris,44,Vilapicina i la Torre Llobeta,8002,1274,684,590
2013,8,Nou Barris,44,Vilapicina i la Torre Llobeta,8003,1257,659,598
2013,8,Nou Barris,44,Vilapicina i la Torre Llobeta,8004,1393,751,642
2013,8,Nou Barris,44,Vilapicina i la Torre Llobeta,8005,1183,621,562
2013,8,Nou Barris,44,Vilapicina i la Torre Llobeta,8006,1431,766,665
2013,8,Nou Barris,44,Vilapicina i la Torre Llobeta,8007,1247,707,540
2013,8,Nou Barris,44,Vilapicina i la Torre Llobeta,8008,1594,848,746
2013,8,Nou Barris,44,Vilapicina i la Torre Llobeta,8009,1667,889,778
2013,8,Nou Barris,44,Vilapicina i la Torre Llobeta,8010,1085,586,499
2013,8,Nou Barris,44,Vilapicina i la Torre Llobeta,8011,1184,654,530
2013,8,Nou Barris,44,Vilapicina i la Torre Llobeta,8012,1350,745,605
2013,8,Nou Barris,44,Vilapicina i la Torre Llobeta,8013,1225,662,563
2013,8,Nou Barris,44,Vilapicina i la Torre Llobeta,8014,1156,618,538
2013,8,Nou Barris,44,Vilapicina i la Torre Llobeta,8015,1407,779,628
2013,8,Nou Barris,44,Vilapicina i la Torre Llobeta,8016,1169,645,524
2013,8,Nou Barris,44,Vilapicina i la Torre Llobeta,8017,1354,711,643
2013,8,Nou Barris,44,Vilapicina i la Torre Llobeta,8018,1519,823,696
2013,8,Nou Barris,44,Vilapicina i la Torre Llobeta,8019,1765,971,794
2013,8,Nou Barris,45,Porta,8020,1252,678,574
2013,8,Nou Barris,45,Porta,8021,1493,818,675
2013,8,Nou Barris,45,Porta,8022,1223,651,572
2013,8,Nou Barris,45,Porta,8023,1384,732,652
2013,8,Nou Barris,45,Porta,8024,1411,756,655
2013,8,Nou Barris,45,Porta,8025,1224,665,559
2013,8,Nou Barris,45,Porta,8026,1264,683,581
2013,8,Nou Barris,45,Porta,8027,1271,646,625
2013,8,Nou Barris,45,Porta,8028,1087,573,514
2013,8,Nou Barris,45,Porta,8029,1447,774,673
2013,8,Nou Barris,45,Porta,8030,1392,713,679
2013,8,Nou Barris,45,Porta,8031,1278,671,607
2013,8,Nou Barris,45,Porta,8032,1307,696,611
2013,8,Nou Barris,45,Porta,8033,1399,727,672
2013,8,Nou Barris,45,Porta,8034,1170,657,513
2013,8,Nou Barris,45,Porta,8035,1748,785,963
2013,8,Nou Barris,45,Porta,8036,1478,774,704
2013,8,Nou Barris,45,Porta,8037,1526,809,717
2013,8,Nou Barris,46,el Turó de la Peira,8038,1444,804,640
2013,8,Nou Barris,46,el Turó de la Peira,8039,1548,836,712
2013,8,Nou Barris,46,el Turó de la Peira,8040,1621,880,741
2013,8,Nou Barris,46,el Turó de la Peira,8041,2388,1255,1133
2013,8,Nou Barris,46,el Turó de la Peira,8042,1290,707,583
2013,8,Nou Barris,46,el Turó de la Peira,8043,1126,642,484
2013,8,Nou Barris,46,el Turó de la Peira,8044,1363,718,645
2013,8,Nou Barris,46,el Turó de la Peira,8045,1693,909,784
2013,8,Nou Barris,46,el Turó de la Peira,8046,1437,788,649
2013,8,Nou Barris,46,el Turó de la Peira,8047,1522,813,709
2013,8,Nou Barris,47,Can Peguera,8048,1029,553,476
2013,8,Nou Barris,47,Can Peguera,8049,1200,630,570
2013,8,Nou Barris,48,la Guineueta,8050,1409,753,656
2013,8,Nou Barris,48,la Guineueta,8051,1327,694,633
2013,8,Nou Barris,48,la Guineueta,8052,881,481,400
2013,8,Nou Barris,48,la Guineueta,8053,1120,578,542
2013,8,Nou Barris,48,la Guineueta,8054,1682,921,761
2013,8,Nou Barris,48,la Guineueta,8055,1880,991,889
2013,8,Nou Barris,48,la Guineueta,8056,1518,799,719
2013,8,Nou Barris,48,la Guineueta,8057,1310,698,612
2013,8,Nou Barris,48,la Guineueta,8058,1611,878,733
2013,8,Nou Barris,48,la Guineueta,8059,1013,526,487
2013,8,Nou Barris,48,la Guineueta,8215,1375,747,628
2013,8,Nou Barris,49,Canyelles,8060,1244,654,590
2013,8,Nou Barris,49,Canyelles,8061,1700,869,831
2013,8,Nou Barris,49,Canyelles,8062,1259,647,612
2013,8,Nou Barris,49,Canyelles,8063,1167,616,551
2013,8,Nou Barris,49,Canyelles,8064,1738,913,825
2013,8,Nou Barris,50,les Roquetes,8065,1702,849,853
2013,8,Nou Barris,50,les Roquetes,8066,1689,853,836
2013,8,Nou Barris,50,les Roquetes,8067,1607,819,788
2013,8,Nou Barris,50,les Roquetes,8068,1799,932,867
2013,8,Nou Barris,50,les Roquetes,8069,1489,744,745
2013,8,Nou Barris,50,les Roquetes,8070,1472,786,686
2013,8,Nou Barris,50,les Roquetes,8071,1639,834,805
2013,8,Nou Barris,50,les Roquetes,8072,1186,612,574
2013,8,Nou Barris,50,les Roquetes,8073,1727,913,814
2013,8,Nou Barris,50,les Roquetes,8074,1464,748,716
2013,8,Nou Barris,51,Verdun,8075,1848,980,868
2013,8,Nou Barris,51,Verdun,8076,1553,835,718
2013,8,Nou Barris,51,Verdun,8077,1477,769,708
2013,8,Nou Barris,51,Verdun,8078,1502,800,702
2013,8,Nou Barris,51,Verdun,8079,1427,748,679
2013,8,Nou Barris,51,Verdun,8080,1447,779,668
2013,8,Nou Barris,51,Verdun,8081,1504,798,706
2013,8,Nou Barris,51,Verdun,8082,1579,852,727
2013,8,Nou Barris,52,la Prosperitat,8083,1310,680,630
2013,8,Nou Barris,52,la Prosperitat,8084,1150,611,539
2013,8,Nou Barris,52,la Prosperitat,8085,1508,773,735
2013,8,Nou Barris,52,la Prosperitat,8086,1660,899,761
2013,8,Nou Barris,52,la Prosperitat,8087,1258,685,573
2013,8,Nou Barris,52,la Prosperitat,8088,1273,655,618
2013,8,Nou Barris,52,la Prosperitat,8089,1207,626,581
2013,8,Nou Barris,52,la Prosperitat,8090,1187,632,555
2013,8,Nou Barris,52,la Prosperitat,8091,1180,590,590
2013,8,Nou Barris,52,la Prosperitat,8092,1023,521,502
2013,8,Nou Barris,52,la Prosperitat,8093,1256,647,609
2013,8,Nou Barris,52,la Prosperitat,8094,1485,776,709
2013,8,Nou Barris,52,la Prosperitat,8095,1094,571,523
2013,8,Nou Barris,52,la Prosperitat,8096,1438,742,696
2013,8,Nou Barris,52,la Prosperitat,8097,1348,696,652
2013,8,Nou Barris,52,la Prosperitat,8098,1224,648,576
2013,8,Nou Barris,52,la Prosperitat,8099,1406,721,685
2013,8,Nou Barris,52,la Prosperitat,8100,1232,662,570
2013,8,Nou Barris,52,la Prosperitat,8101,1723,921,802
2013,8,Nou Barris,52,la Prosperitat,8102,1346,717,629
2013,8,Nou Barris,53,la Trinitat Nova,8103,1521,779,742
2013,8,Nou Barris,53,la Trinitat Nova,8104,1267,695,572
2013,8,Nou Barris,53,la Trinitat Nova,8105,1611,836,775
2013,8,Nou Barris,53,la Trinitat Nova,8106,1288,667,621
2013,8,Nou Barris,53,la Trinitat Nova,8107,1868,965,903
2013,8,Nou Barris,54,Torre Baró,8108,1173,584,589
2013,8,Nou Barris,54,Torre Baró,8109,1023,500,523
2013,8,Nou Barris,55,Ciutat Meridiana,8110,1962,979,983
2013,8,Nou Barris,55,Ciutat Meridiana,8111,1565,785,780
2013,8,Nou Barris,55,Ciutat Meridiana,8112,1653,828,825
2013,8,Nou Barris,55,Ciutat Meridiana,8113,1740,838,902
2013,8,Nou Barris,55,Ciutat Meridiana,8114,1874,935,939
2013,8,Nou Barris,55,Ciutat Meridiana,8115,1700,863,837
2013,8,Nou Barris,56,Vallbona,8116,1348,685,663
2013,9,Sant Andreu,57,la Trinitat Vella,9001,2709,1235,1474
2013,9,Sant Andreu,57,la Trinitat Vella,9002,2307,1068,1239
2013,9,Sant Andreu,57,la Trinitat Vella,9003,2128,1047,1081
2013,9,Sant Andreu,57,la Trinitat Vella,9004,1731,880,851
2013,9,Sant Andreu,57,la Trinitat Vella,9005,1559,780,779
2013,9,Sant Andreu,58,Baró de Viver,9006,1183,620,563
2013,9,Sant Andreu,58,Baró de Viver,9007,1233,623,610
2013,9,Sant Andreu,59,el Bon Pastor,9008,1862,926,936
2013,9,Sant Andreu,59,el Bon Pastor,9009,1410,735,675
2013,9,Sant Andreu,59,el Bon Pastor,9010,1803,917,886
2013,9,Sant Andreu,59,el Bon Pastor,9011,1992,999,993
2013,9,Sant Andreu,59,el Bon Pastor,9013,1920,977,943
2013,9,Sant Andreu,59,el Bon Pastor,9014,2030,874,1156
2013,9,Sant Andreu,59,el Bon Pastor,9015,1796,901,895
2013,9,Sant Andreu,60,Sant Andreu,9016,1417,732,685
2013,9,Sant Andreu,60,Sant Andreu,9017,1469,754,715
2013,9,Sant Andreu,60,Sant Andreu,9018,1465,751,714
2013,9,Sant Andreu,60,Sant Andreu,9019,2365,1207,1158
2013,9,Sant Andreu,60,Sant Andreu,9020,1169,635,534
2013,9,Sant Andreu,60,Sant Andreu,9021,1398,733,665
2013,9,Sant Andreu,60,Sant Andreu,9022,1220,642,578
2013,9,Sant Andreu,60,Sant Andreu,9023,1200,631,569
2013,9,Sant Andreu,60,Sant Andreu,9024,1179,627,552
2013,9,Sant Andreu,60,Sant Andreu,9025,1143,606,537
2013,9,Sant Andreu,60,Sant Andreu,9026,1541,815,726
2013,9,Sant Andreu,60,Sant Andreu,9027,1384,705,679
2013,9,Sant Andreu,60,Sant Andreu,9028,1583,806,777
2013,9,Sant Andreu,60,Sant Andreu,9029,1186,611,575
2013,9,Sant Andreu,60,Sant Andreu,9030,1468,788,680
2013,9,Sant Andreu,60,Sant Andreu,9031,1173,609,564
2013,9,Sant Andreu,60,Sant Andreu,9032,1621,850,771
2013,9,Sant Andreu,60,Sant Andreu,9033,3051,1561,1490
2013,9,Sant Andreu,60,Sant Andreu,9034,1434,747,687
2013,9,Sant Andreu,60,Sant Andreu,9035,1544,807,737
2013,9,Sant Andreu,60,Sant Andreu,9036,1465,790,675
2013,9,Sant Andreu,60,Sant Andreu,9037,1382,764,618
2013,9,Sant Andreu,60,Sant Andreu,9038,1602,852,750
2013,9,Sant Andreu,60,Sant Andreu,9039,1579,820,759
2013,9,Sant Andreu,60,Sant Andreu,9040,1509,823,686
2013,9,Sant Andreu,60,Sant Andreu,9041,1400,770,630
2013,9,Sant Andreu,60,Sant Andreu,9042,1256,664,592
2013,9,Sant Andreu,60,Sant Andreu,9043,1367,716,651
2013,9,Sant Andreu,60,Sant Andreu,9044,1465,770,695
2013,9,Sant Andreu,60,Sant Andreu,9045,1398,735,663
2013,9,Sant Andreu,60,Sant Andreu,9046,1294,687,607
2013,9,Sant Andreu,60,Sant Andreu,9047,1496,790,706
2013,9,Sant Andreu,60,Sant Andreu,9048,1349,719,630
2013,9,Sant Andreu,60,Sant Andreu,9049,1284,696,588
2013,9,Sant Andreu,60,Sant Andreu,9050,1594,847,747
2013,9,Sant Andreu,60,Sant Andreu,9051,1224,644,580
2013,9,Sant Andreu,60,Sant Andreu,9052,1194,630,564
2013,9,Sant Andreu,60,Sant Andreu,9053,1503,813,690
2013,9,Sant Andreu,60,Sant Andreu,9054,1129,607,522
2013,9,Sant Andreu,61,la Sagrera,9055,1766,916,850
2013,9,Sant Andreu,61,la Sagrera,9056,1225,654,571
2013,9,Sant Andreu,61,la Sagrera,9057,1560,835,725
2013,9,Sant Andreu,61,la Sagrera,9058,1403,752,651
2013,9,Sant Andreu,61,la Sagrera,9059,1325,682,643
2013,9,Sant Andreu,61,la Sagrera,9060,1366,737,629
2013,9,Sant Andreu,61,la Sagrera,9061,1660,853,807
2013,9,Sant Andreu,61,la Sagrera,9062,1101,560,541
2013,9,Sant Andreu,61,la Sagrera,9063,1180,611,569
2013,9,Sant Andreu,61,la Sagrera,9064,1249,676,573
2013,9,Sant Andreu,61,la Sagrera,9065,2043,1096,947
2013,9,Sant Andreu,61,la Sagrera,9066,1331,702,629
2013,9,Sant Andreu,61,la Sagrera,9067,1397,757,640
2013,9,Sant Andreu,61,la Sagrera,9068,1545,803,742
2013,9,Sant Andreu,61,la Sagrera,9069,921,520,401
2013,9,Sant Andreu,61,la Sagrera,9070,1773,945,828
2013,9,Sant Andreu,61,la Sagrera,9071,1802,977,825
2013,9,Sant Andreu,61,la Sagrera,9072,1471,804,667
2013,9,Sant Andreu,61,la Sagrera,9073,1556,824,732
2013,9,Sant Andreu,61,la Sagrera,9156,1250,660,590
2013,9,Sant Andreu,62,el Congrés i els Indians,9074,1584,883,701
2013,9,Sant Andreu,62,el Congrés i els Indians,9075,1498,833,665
2013,9,Sant Andreu,62,el Congrés i els Indians,9076,1379,785,594
2013,9,Sant Andreu,62,el Congrés i els Indians,9077,1485,835,650
2013,9,Sant Andreu,62,el Congrés i els Indians,9078,1512,799,713
2013,9,Sant Andreu,62,el Congrés i els Indians,9079,1561,841,720
2013,9,Sant Andreu,62,el Congrés i els Indians,9080,1373,709,664
2013,9,Sant Andreu,62,el Congrés i els Indians,9081,1758,954,804
2013,9,Sant Andreu,62,el Congrés i els Indians,9082,1878,1024,854
2013,9,Sant Andreu,63,Navas,9083,1599,855,744
2013,9,Sant Andreu,63,Navas,9084,1699,909,790
2013,9,Sant Andreu,63,Navas,9085,1661,889,772
2013,9,Sant Andreu,63,Navas,9086,1419,777,642
2013,9,Sant Andreu,63,Navas,9087,1221,649,572
2013,9,Sant Andreu,63,Navas,9088,1787,965,822
2013,9,Sant Andreu,63,Navas,9089,1468,824,644
2013,9,Sant Andreu,63,Navas,9090,1607,854,753
2013,9,Sant Andreu,63,Navas,9091,1874,984,890
2013,9,Sant Andreu,63,Navas,9092,1999,1054,945
2013,9,Sant Andreu,63,Navas,9093,1397,740,657
2013,9,Sant Andreu,63,Navas,9094,2022,1072,950
2013,9,Sant Andreu,63,Navas,9095,2081,1106,975
2013,10,Sant Martí,64,Camp de l'Arpa del Clot,10001,1630,858,772
2013,10,Sant Martí,64,Camp de l'Arpa del Clot,10002,1733,901,832
2013,10,Sant Martí,64,Camp de l'Arpa del Clot,10003,1481,766,715
2013,10,Sant Martí,64,Camp de l'Arpa del Clot,10004,1426,781,645
2013,10,Sant Martí,64,Camp de l'Arpa del Clot,10005,1636,861,775
2013,10,Sant Martí,64,Camp de l'Arpa del Clot,10006,1705,932,773
2013,10,Sant Martí,64,Camp de l'Arpa del Clot,10007,1300,662,638
2013,10,Sant Martí,64,Camp de l'Arpa del Clot,10008,1658,897,761
2013,10,Sant Martí,64,Camp de l'Arpa del Clot,10009,1594,861,733
2013,10,Sant Martí,64,Camp de l'Arpa del Clot,10010,1740,942,798
2013,10,Sant Martí,64,Camp de l'Arpa del Clot,10011,1214,664,550
2013,10,Sant Martí,64,Camp de l'Arpa del Clot,10012,1839,954,885
2013,10,Sant Martí,64,Camp de l'Arpa del Clot,10013,1371,748,623
2013,10,Sant Martí,64,Camp de l'Arpa del Clot,10014,1398,762,636
2013,10,Sant Martí,64,Camp de l'Arpa del Clot,10015,1790,945,845
2013,10,Sant Martí,64,Camp de l'Arpa del Clot,10016,1277,673,604
2013,10,Sant Martí,64,Camp de l'Arpa del Clot,10017,1680,892,788
2013,10,Sant Martí,64,Camp de l'Arpa del Clot,10018,1361,701,660
2013,10,Sant Martí,64,Camp de l'Arpa del Clot,10019,1630,892,738
2013,10,Sant Martí,64,Camp de l'Arpa del Clot,10020,1495,786,709
2013,10,Sant Martí,64,Camp de l'Arpa del Clot,10021,1414,727,687
2013,10,Sant Martí,64,Camp de l'Arpa del Clot,10022,1302,698,604
2013,10,Sant Martí,64,Camp de l'Arpa del Clot,10023,1486,792,694
2013,10,Sant Martí,64,Camp de l'Arpa del Clot,10024,1448,752,696
2013,10,Sant Martí,64,Camp de l'Arpa del Clot,10025,1369,738,631
2013,10,Sant Martí,65,el Clot,10026,1532,815,717
2013,10,Sant Martí,65,el Clot,10027,1579,822,757
2013,10,Sant Martí,65,el Clot,10028,1792,924,868
2013,10,Sant Martí,65,el Clot,10029,1498,757,741
2013,10,Sant Martí,65,el Clot,10030,1746,932,814
2013,10,Sant Martí,65,el Clot,10031,1574,810,764
2013,10,Sant Martí,65,el Clot,10032,1477,768,709
2013,10,Sant Martí,65,el Clot,10033,918,510,408
2013,10,Sant Martí,65,el Clot,10034,1726,870,856
2013,10,Sant Martí,65,el Clot,10035,2065,1037,1028
2013,10,Sant Martí,65,el Clot,10036,1442,705,737
2013,10,Sant Martí,65,el Clot,10037,1066,541,525
2013,10,Sant Martí,65,el Clot,10038,1682,857,825
2013,10,Sant Martí,65,el Clot,10039,1750,933,817
2013,10,Sant Martí,65,el Clot,10040,1854,985,869
2013,10,Sant Martí,65,el Clot,10041,1541,774,767
2013,10,Sant Martí,65,el Clot,10234,1937,1031,906
2013,10,Sant Martí,66,el Parc i la Llacuna del Poblenou,10042,2078,1089,989
2013,10,Sant Martí,66,el Parc i la Llacuna del Poblenou,10043,1739,874,865
2013,10,Sant Martí,66,el Parc i la Llacuna del Poblenou,10044,1471,764,707
2013,10,Sant Martí,66,el Parc i la Llacuna del Poblenou,10045,1292,693,599
2013,10,Sant Martí,66,el Parc i la Llacuna del Poblenou,10046,1270,647,623
2013,10,Sant Martí,66,el Parc i la Llacuna del Poblenou,10047,1801,943,858
2013,10,Sant Martí,66,el Parc i la Llacuna del Poblenou,10048,1697,894,803
2013,10,Sant Martí,66,el Parc i la Llacuna del Poblenou,10049,1350,698,652
2013,10,Sant Martí,66,el Parc i la Llacuna del Poblenou,10050,1658,891,767
2013,10,Sant Martí,67,la Vila Olímpica del Poblenou,10051,1619,839,780
2013,10,Sant Martí,67,la Vila Olímpica del Poblenou,10052,2338,1175,1163
2013,10,Sant Martí,67,la Vila Olímpica del Poblenou,10053,1833,928,905
2013,10,Sant Martí,67,la Vila Olímpica del Poblenou,10054,965,503,462
2013,10,Sant Martí,67,la Vila Olímpica del Poblenou,10055,2565,1287,1278
2013,10,Sant Martí,68,el Poblenou,10056,1812,890,922
2013,10,Sant Martí,68,el Poblenou,10057,1348,662,686
2013,10,Sant Martí,68,el Poblenou,10058,1162,577,585
2013,10,Sant Martí,68,el Poblenou,10059,1607,819,788
2013,10,Sant Martí,68,el Poblenou,10060,1623,811,812
2013,10,Sant Martí,68,el Poblenou,10061,1675,874,801
2013,10,Sant Martí,68,el Poblenou,10062,1570,806,764
2013,10,Sant Martí,68,el Poblenou,10063,1245,633,612
2013,10,Sant Martí,68,el Poblenou,10064,1600,833,767
2013,10,Sant Martí,68,el Poblenou,10065,1560,791,769
2013,10,Sant Martí,68,el Poblenou,10066,2014,1052,962
2013,10,Sant Martí,68,el Poblenou,10067,1892,998,894
2013,10,Sant Martí,68,el Poblenou,10068,1555,786,769
2013,10,Sant Martí,68,el Poblenou,10069,2045,1062,983
2013,10,Sant Martí,68,el Poblenou,10070,1642,886,756
2013,10,Sant Martí,68,el Poblenou,10071,1821,911,910
2013,10,Sant Martí,68,el Poblenou,10072,2020,1024,996
2013,10,Sant Martí,68,el Poblenou,10073,1520,781,739
2013,10,Sant Martí,68,el Poblenou,10074,1704,891,813
2013,10,Sant Martí,68,el Poblenou,10075,1466,753,713
2013,10,Sant Martí,69,Diagonal Mar i el Front Marítim del Poblenou,10076,1732,901,831
2013,10,Sant Martí,69,Diagonal Mar i el Front Marítim del Poblenou,10077,1839,928,911
2013,10,Sant Martí,69,Diagonal Mar i el Front Marítim del Poblenou,10078,2141,1098,1043
2013,10,Sant Martí,69,Diagonal Mar i el Front Marítim del Poblenou,10079,1780,917,863
2013,10,Sant Martí,69,Diagonal Mar i el Front Marítim del Poblenou,10080,2416,1162,1254
2013,10,Sant Martí,69,Diagonal Mar i el Front Marítim del Poblenou,10235,1339,707,632
2013,10,Sant Martí,69,Diagonal Mar i el Front Marítim del Poblenou,10236,1681,893,788
2013,10,Sant Martí,70,el Besòs i el Maresme,10081,1855,931,924
2013,10,Sant Martí,70,el Besòs i el Maresme,10082,2071,957,1114
2013,10,Sant Martí,70,el Besòs i el Maresme,10083,2237,909,1328
2013,10,Sant Martí,70,el Besòs i el Maresme,10084,1603,831,772
2013,10,Sant Martí,70,el Besòs i el Maresme,10085,2033,945,1088
2013,10,Sant Martí,70,el Besòs i el Maresme,10086,1838,918,920
2013,10,Sant Martí,70,el Besòs i el Maresme,10087,1820,921,899
2013,10,Sant Martí,70,el Besòs i el Maresme,10088,1561,801,760
2013,10,Sant Martí,70,el Besòs i el Maresme,10089,2068,930,1138
2013,10,Sant Martí,70,el Besòs i el Maresme,10090,1389,724,665
2013,10,Sant Martí,70,el Besòs i el Maresme,10091,1985,1015,970
2013,10,Sant Martí,70,el Besòs i el Maresme,10092,1564,829,735
2013,10,Sant Martí,70,el Besòs i el Maresme,10093,1119,557,562
2013,10,Sant Martí,71,Provençals del Poblenou,10094,2579,1286,1293
2013,10,Sant Martí,71,Provençals del Poblenou,10095,1246,623,623
2013,10,Sant Martí,71,Provençals del Poblenou,10096,1583,844,739
2013,10,Sant Martí,71,Provençals del Poblenou,10097,1549,817,732
2013,10,Sant Martí,71,Provençals del Poblenou,10098,1879,967,912
2013,10,Sant Martí,71,Provençals del Poblenou,10099,1085,573,512
2013,10,Sant Martí,71,Provençals del Poblenou,10100,1564,830,734
2013,10,Sant Martí,71,Provençals del Poblenou,10101,1201,601,600
2013,10,Sant Martí,71,Provençals del Poblenou,10102,2646,1348,1298
2013,10,Sant Martí,71,Provençals del Poblenou,10103,2190,1143,1047
2013,10,Sant Martí,71,Provençals del Poblenou,10104,1712,877,835
2013,10,Sant Martí,71,Provençals del Poblenou,10237,834,457,377
2013,10,Sant Martí,72,Sant Martí de Provençals,10105,2217,1177,1040
2013,10,Sant Martí,72,Sant Martí de Provençals,10106,1055,546,509
2013,10,Sant Martí,72,Sant Martí de Provençals,10107,1477,765,712
2013,10,Sant Martí,72,Sant Martí de Provençals,10108,1411,746,665
2013,10,Sant Martí,72,Sant Martí de Provençals,10109,1509,826,683
2013,10,Sant Martí,72,Sant Martí de Provençals,10110,1649,903,746
2013,10,Sant Martí,72,Sant Martí de Provençals,10111,1308,683,625
2013,10,Sant Martí,72,Sant Martí de Provençals,10112,1578,813,765
2013,10,Sant Martí,72,Sant Martí de Provençals,10113,1146,605,541
2013,10,Sant Martí,72,Sant Martí de Provençals,10114,1393,751,642
2013,10,Sant Martí,72,Sant Martí de Provençals,10115,1421,726,695
2013,10,Sant Martí,72,Sant Martí de Provençals,10116,1864,981,883
2013,10,Sant Martí,72,Sant Martí de Provençals,10117,1311,693,618
2013,10,Sant Martí,72,Sant Martí de Provençals,10118,1020,545,475
2013,10,Sant Martí,72,Sant Martí de Provençals,10119,1108,611,497
2013,10,Sant Martí,72,Sant Martí de Provençals,10120,1403,800,603
2013,10,Sant Martí,72,Sant Martí de Provençals,10121,1566,847,719
2013,10,Sant Martí,72,Sant Martí de Provençals,10122,1565,808,757
2013,10,Sant Martí,73,la Verneda i la Pau,10123,1398,725,673
2013,10,Sant Martí,73,la Verneda i la Pau,10124,1153,588,565
2013,10,Sant Martí,73,la Verneda i la Pau,10125,1175,600,575
2013,10,Sant Martí,73,la Verneda i la Pau,10126,1126,582,544
2013,10,Sant Martí,73,la Verneda i la Pau,10127,998,514,484
2013,10,Sant Martí,73,la Verneda i la Pau,10128,1663,886,777
2013,10,Sant Martí,73,la Verneda i la Pau,10129,1237,633,604
2013,10,Sant Martí,73,la Verneda i la Pau,10130,1219,650,569
2013,10,Sant Martí,73,la Verneda i la Pau,10131,1188,644,544
2013,10,Sant Martí,73,la Verneda i la Pau,10132,1274,660,614
2013,10,Sant Martí,73,la Verneda i la Pau,10133,1733,913,820
2013,10,Sant Martí,73,la Verneda i la Pau,10134,1532,819,713
2013,10,Sant Martí,73,la Verneda i la Pau,10135,1223,647,576
2013,10,Sant Martí,73,la Verneda i la Pau,10136,1399,722,677
2013,10,Sant Martí,73,la Verneda i la Pau,10137,1587,820,767
2013,10,Sant Martí,73,la Verneda i la Pau,10138,1583,803,780
2013,10,Sant Martí,73,la Verneda i la Pau,10139,1654,846,808
2013,10,Sant Martí,73,la Verneda i la Pau,10140,1616,849,767
2013,10,Sant Martí,73,la Verneda i la Pau,10141,1107,584,523
2013,10,Sant Martí,73,la Verneda i la Pau,10142,1570,839,731
2013,10,Sant Martí,73,la Verneda i la Pau,10143,1747,914,833
2014,1,Ciutat Vella,1,el Raval,1001,1326,575,751
2014,1,Ciutat Vella,1,el Raval,1002,1556,698,858
2014,1,Ciutat Vella,1,el Raval,1003,3305,1530,1775
2014,1,Ciutat Vella,1,el Raval,1004,2853,1246,1607
2014,1,Ciutat Vella,1,el Raval,1005,2452,1068,1384
2014,1,Ciutat Vella,1,el Raval,1006,1620,731,889
2014,1,Ciutat Vella,1,el Raval,1007,2052,794,1258
2014,1,Ciutat Vella,1,el Raval,1008,3504,1364,2140
2014,1,Ciutat Vella,1,el Raval,1009,2192,1016,1176
2014,1,Ciutat Vella,1,el Raval,1010,2389,1002,1387
2014,1,Ciutat Vella,1,el Raval,1011,3481,1472,2009
2014,1,Ciutat Vella,1,el Raval,1012,1898,915,983
2014,1,Ciutat Vella,1,el Raval,1013,1335,690,645
2014,1,Ciutat Vella,1,el Raval,1014,1978,978,1000
2014,1,Ciutat Vella,1,el Raval,1015,2275,1106,1169
2014,1,Ciutat Vella,1,el Raval,1016,2166,1079,1087
2014,1,Ciutat Vella,1,el Raval,1017,2705,1268,1437
2014,1,Ciutat Vella,1,el Raval,1018,1521,746,775
2014,1,Ciutat Vella,1,el Raval,1019,2833,1256,1577
2014,1,Ciutat Vella,1,el Raval,1020,2057,1096,961
2014,1,Ciutat Vella,1,el Raval,1021,1992,988,1004
2014,1,Ciutat Vella,2,el Barri Gòtic,1022,1228,637,591
2014,1,Ciutat Vella,2,el Barri Gòtic,1023,1964,1040,924
2014,1,Ciutat Vella,2,el Barri Gòtic,1025,1286,651,635
2014,1,Ciutat Vella,2,el Barri Gòtic,1026,2149,889,1260
2014,1,Ciutat Vella,2,el Barri Gòtic,1027,1595,772,823
2014,1,Ciutat Vella,2,el Barri Gòtic,1028,1944,894,1050
2014,1,Ciutat Vella,2,el Barri Gòtic,1029,1367,664,703
2014,1,Ciutat Vella,2,el Barri Gòtic,1030,2512,1162,1350
2014,1,Ciutat Vella,2,el Barri Gòtic,1031,1690,742,948
2014,1,Ciutat Vella,3,la Barceloneta,1032,1852,904,948
2014,1,Ciutat Vella,3,la Barceloneta,1033,1115,533,582
2014,1,Ciutat Vella,3,la Barceloneta,1034,1069,531,538
2014,1,Ciutat Vella,3,la Barceloneta,1035,1303,644,659
2014,1,Ciutat Vella,3,la Barceloneta,1036,1190,626,564
2014,1,Ciutat Vella,3,la Barceloneta,1037,1443,762,681
2014,1,Ciutat Vella,3,la Barceloneta,1038,1490,721,769
2014,1,Ciutat Vella,3,la Barceloneta,1039,1278,650,628
2014,1,Ciutat Vella,3,la Barceloneta,1040,1106,564,542
2014,1,Ciutat Vella,3,la Barceloneta,1041,1486,727,759
2014,1,Ciutat Vella,3,la Barceloneta,1042,1775,945,830
2014,1,Ciutat Vella,4,"Sant Pere, Santa Caterina i la Ribera",1043,1228,585,643
2014,1,Ciutat Vella,4,"Sant Pere, Santa Caterina i la Ribera",1044,1496,772,724
2014,1,Ciutat Vella,4,"Sant Pere, Santa Caterina i la Ribera",1045,2081,1046,1035
2014,1,Ciutat Vella,4,"Sant Pere, Santa Caterina i la Ribera",1046,1688,838,850
2014,1,Ciutat Vella,4,"Sant Pere, Santa Caterina i la Ribera",1047,1844,967,877
2014,1,Ciutat Vella,4,"Sant Pere, Santa Caterina i la Ribera",1048,2242,1102,1140
2014,1,Ciutat Vella,4,"Sant Pere, Santa Caterina i la Ribera",1049,1375,723,652
2014,1,Ciutat Vella,4,"Sant Pere, Santa Caterina i la Ribera",1050,1575,762,813
2014,1,Ciutat Vella,4,"Sant Pere, Santa Caterina i la Ribera",1051,1842,902,940
2014,1,Ciutat Vella,4,"Sant Pere, Santa Caterina i la Ribera",1052,2390,1128,1262
2014,1,Ciutat Vella,4,"Sant Pere, Santa Caterina i la Ribera",1053,1975,995,980
2014,1,Ciutat Vella,4,"Sant Pere, Santa Caterina i la Ribera",1054,1320,654,666
2014,1,Ciutat Vella,4,"Sant Pere, Santa Caterina i la Ribera",1055,1312,700,612
2014,2,Eixample,5,el Fort Pienc,2001,1242,656,586
2014,2,Eixample,5,el Fort Pienc,2002,2214,1022,1192
2014,2,Eixample,5,el Fort Pienc,2003,1232,700,532
2014,2,Eixample,5,el Fort Pienc,2004,1462,752,710
2014,2,Eixample,5,el Fort Pienc,2005,2156,1146,1010
2014,2,Eixample,5,el Fort Pienc,2006,1596,830,766
2014,2,Eixample,5,el Fort Pienc,2007,1209,703,506
2014,2,Eixample,5,el Fort Pienc,2008,1843,1005,838
2014,2,Eixample,5,el Fort Pienc,2009,1730,941,789
2014,2,Eixample,5,el Fort Pienc,2010,1201,643,558
2014,2,Eixample,5,el Fort Pienc,2011,1092,562,530
2014,2,Eixample,5,el Fort Pienc,2012,1552,803,749
2014,2,Eixample,5,el Fort Pienc,2013,1137,607,530
2014,2,Eixample,5,el Fort Pienc,2014,1313,677,636
2014,2,Eixample,5,el Fort Pienc,2015,1562,842,720
2014,2,Eixample,5,el Fort Pienc,2016,1864,1028,836
2014,2,Eixample,5,el Fort Pienc,2017,1922,1034,888
2014,2,Eixample,5,el Fort Pienc,2018,1818,984,834
2014,2,Eixample,5,el Fort Pienc,2019,1934,1048,886
2014,2,Eixample,5,el Fort Pienc,2020,1410,753,657
2014,2,Eixample,6,la Sagrada Família,2021,1452,772,680
2014,2,Eixample,6,la Sagrada Família,2022,1262,658,604
2014,2,Eixample,6,la Sagrada Família,2023,1112,582,530
2014,2,Eixample,6,la Sagrada Família,2024,1113,599,514
2014,2,Eixample,6,la Sagrada Família,2025,1174,631,543
2014,2,Eixample,6,la Sagrada Família,2026,2121,1133,988
2014,2,Eixample,6,la Sagrada Família,2027,1992,1090,902
2014,2,Eixample,6,la Sagrada Família,2028,2068,1128,940
2014,2,Eixample,6,la Sagrada Família,2029,1167,630,537
2014,2,Eixample,6,la Sagrada Família,2030,1231,648,583
2014,2,Eixample,6,la Sagrada Família,2031,1070,559,511
2014,2,Eixample,6,la Sagrada Família,2032,1192,701,491
2014,2,Eixample,6,la Sagrada Família,2033,1179,640,539
2014,2,Eixample,6,la Sagrada Família,2034,1151,644,507
2014,2,Eixample,6,la Sagrada Família,2035,1276,685,591
2014,2,Eixample,6,la Sagrada Família,2036,1253,669,584
2014,2,Eixample,6,la Sagrada Família,2037,1245,641,604
2014,2,Eixample,6,la Sagrada Família,2038,1617,861,756
2014,2,Eixample,6,la Sagrada Família,2039,1705,938,767
2014,2,Eixample,6,la Sagrada Família,2040,1640,864,776
2014,2,Eixample,6,la Sagrada Família,2041,1635,904,731
2014,2,Eixample,6,la Sagrada Família,2042,1685,894,791
2014,2,Eixample,6,la Sagrada Família,2043,1440,777,663
2014,2,Eixample,6,la Sagrada Família,2044,1242,702,540
2014,2,Eixample,6,la Sagrada Família,2045,1197,638,559
2014,2,Eixample,6,la Sagrada Família,2046,1849,1017,832
2014,2,Eixample,6,la Sagrada Família,2047,1888,1019,869
2014,2,Eixample,6,la Sagrada Família,2048,1224,677,547
2014,2,Eixample,6,la Sagrada Família,2049,2051,1127,924
2014,2,Eixample,6,la Sagrada Família,2050,1602,864,738
2014,2,Eixample,6,la Sagrada Família,2051,1905,1030,875
2014,2,Eixample,6,la Sagrada Família,2052,1827,1000,827
2014,2,Eixample,6,la Sagrada Família,2053,1860,1003,857
2014,2,Eixample,6,la Sagrada Família,2054,1858,998,860
2014,2,Eixample,7,la Dreta de l'Eixample,2055,1882,1014,868
2014,2,Eixample,7,la Dreta de l'Eixample,2056,1501,853,648
2014,2,Eixample,7,la Dreta de l'Eixample,2057,1237,657,580
2014,2,Eixample,7,la Dreta de l'Eixample,2058,1374,743,631
2014,2,Eixample,7,la Dreta de l'Eixample,2059,1642,882,760
2014,2,Eixample,7,la Dreta de l'Eixample,2060,1661,909,752
2014,2,Eixample,7,la Dreta de l'Eixample,2061,1364,768,596
2014,2,Eixample,7,la Dreta de l'Eixample,2062,1546,840,706
2014,2,Eixample,7,la Dreta de l'Eixample,2063,1175,724,451
2014,2,Eixample,7,la Dreta de l'Eixample,2064,1367,717,650
2014,2,Eixample,7,la Dreta de l'Eixample,2065,1852,1004,848
2014,2,Eixample,7,la Dreta de l'Eixample,2066,1905,1015,890
2014,2,Eixample,7,la Dreta de l'Eixample,2067,1650,894,756
2014,2,Eixample,7,la Dreta de l'Eixample,2068,1719,931,788
2014,2,Eixample,7,la Dreta de l'Eixample,2069,1375,733,642
2014,2,Eixample,7,la Dreta de l'Eixample,2070,1338,745,593
2014,2,Eixample,7,la Dreta de l'Eixample,2071,1696,881,815
2014,2,Eixample,7,la Dreta de l'Eixample,2072,1221,646,575
2014,2,Eixample,7,la Dreta de l'Eixample,2073,1633,859,774
2014,2,Eixample,7,la Dreta de l'Eixample,2074,1156,590,566
2014,2,Eixample,7,la Dreta de l'Eixample,2075,1233,670,563
2014,2,Eixample,7,la Dreta de l'Eixample,2076,1654,884,770
2014,2,Eixample,7,la Dreta de l'Eixample,2077,1425,723,702
2014,2,Eixample,7,la Dreta de l'Eixample,2078,1397,784,613
2014,2,Eixample,7,la Dreta de l'Eixample,2079,1236,669,567
2014,2,Eixample,7,la Dreta de l'Eixample,2080,1417,762,655
2014,2,Eixample,7,la Dreta de l'Eixample,2081,2082,1142,940
2014,2,Eixample,7,la Dreta de l'Eixample,2082,935,518,417
2014,2,Eixample,7,la Dreta de l'Eixample,2083,1670,935,735
2014,2,Eixample,8,l'Antiga Esquerra de l'Eixample,2084,2024,1113,911
2014,2,Eixample,8,l'Antiga Esquerra de l'Eixample,2085,1490,814,676
2014,2,Eixample,8,l'Antiga Esquerra de l'Eixample,2086,1386,772,614
2014,2,Eixample,8,l'Antiga Esquerra de l'Eixample,2087,1451,804,647
2014,2,Eixample,8,l'Antiga Esquerra de l'Eixample,2088,1639,899,740
2014,2,Eixample,8,l'Antiga Esquerra de l'Eixample,2089,1912,1017,895
2014,2,Eixample,8,l'Antiga Esquerra de l'Eixample,2090,1645,880,765
2014,2,Eixample,8,l'Antiga Esquerra de l'Eixample,2091,1800,903,897
2014,2,Eixample,8,l'Antiga Esquerra de l'Eixample,2092,1765,912,853
2014,2,Eixample,8,l'Antiga Esquerra de l'Eixample,2093,1598,816,782
2014,2,Eixample,8,l'Antiga Esquerra de l'Eixample,2094,1475,770,705
2014,2,Eixample,8,l'Antiga Esquerra de l'Eixample,2095,1543,819,724
2014,2,Eixample,8,l'Antiga Esquerra de l'Eixample,2096,1365,738,627
2014,2,Eixample,8,l'Antiga Esquerra de l'Eixample,2097,1129,600,529
2014,2,Eixample,8,l'Antiga Esquerra de l'Eixample,2098,1576,888,688
2014,2,Eixample,8,l'Antiga Esquerra de l'Eixample,2099,1491,789,702
2014,2,Eixample,8,l'Antiga Esquerra de l'Eixample,2100,1393,744,649
2014,2,Eixample,8,l'Antiga Esquerra de l'Eixample,2101,2177,1196,981
2014,2,Eixample,8,l'Antiga Esquerra de l'Eixample,2102,1369,763,606
2014,2,Eixample,8,l'Antiga Esquerra de l'Eixample,2103,1744,956,788
2014,2,Eixample,8,l'Antiga Esquerra de l'Eixample,2104,1115,606,509
2014,2,Eixample,8,l'Antiga Esquerra de l'Eixample,2105,2089,1157,932
2014,2,Eixample,8,l'Antiga Esquerra de l'Eixample,2106,1443,751,692
2014,2,Eixample,8,l'Antiga Esquerra de l'Eixample,2107,1630,881,749
2014,2,Eixample,8,l'Antiga Esquerra de l'Eixample,2108,1558,859,699
2014,2,Eixample,8,l'Antiga Esquerra de l'Eixample,2109,1921,1058,863
2014,2,Eixample,9,la Nova Esquerra de l'Eixample,2110,1900,1012,888
2014,2,Eixample,9,la Nova Esquerra de l'Eixample,2111,1778,994,784
2014,2,Eixample,9,la Nova Esquerra de l'Eixample,2112,1281,688,593
2014,2,Eixample,9,la Nova Esquerra de l'Eixample,2113,1934,1015,919
2014,2,Eixample,9,la Nova Esquerra de l'Eixample,2114,1670,931,739
2014,2,Eixample,9,la Nova Esquerra de l'Eixample,2115,1360,749,611
2014,2,Eixample,9,la Nova Esquerra de l'Eixample,2116,1030,569,461
2014,2,Eixample,9,la Nova Esquerra de l'Eixample,2117,1180,618,562
2014,2,Eixample,9,la Nova Esquerra de l'Eixample,2118,1552,867,685
2014,2,Eixample,9,la Nova Esquerra de l'Eixample,2119,1312,724,588
2014,2,Eixample,9,la Nova Esquerra de l'Eixample,2120,1203,633,570
2014,2,Eixample,9,la Nova Esquerra de l'Eixample,2121,1255,673,582
2014,2,Eixample,9,la Nova Esquerra de l'Eixample,2122,1052,590,462
2014,2,Eixample,9,la Nova Esquerra de l'Eixample,2123,1112,578,534
2014,2,Eixample,9,la Nova Esquerra de l'Eixample,2124,1100,594,506
2014,2,Eixample,9,la Nova Esquerra de l'Eixample,2125,1707,937,770
2014,2,Eixample,9,la Nova Esquerra de l'Eixample,2126,1509,831,678
2014,2,Eixample,9,la Nova Esquerra de l'Eixample,2127,1109,575,534
2014,2,Eixample,9,la Nova Esquerra de l'Eixample,2128,1277,683,594
2014,2,Eixample,9,la Nova Esquerra de l'Eixample,2129,1525,819,706
2014,2,Eixample,9,la Nova Esquerra de l'Eixample,2130,1114,566,548
2014,2,Eixample,9,la Nova Esquerra de l'Eixample,2131,1215,649,566
2014,2,Eixample,9,la Nova Esquerra de l'Eixample,2132,1213,631,582
2014,2,Eixample,9,la Nova Esquerra de l'Eixample,2133,878,477,401
2014,2,Eixample,9,la Nova Esquerra de l'Eixample,2134,1452,785,667
2014,2,Eixample,9,la Nova Esquerra de l'Eixample,2135,2088,1113,975
2014,2,Eixample,9,la Nova Esquerra de l'Eixample,2136,893,479,414
2014,2,Eixample,9,la Nova Esquerra de l'Eixample,2137,1411,749,662
2014,2,Eixample,9,la Nova Esquerra de l'Eixample,2138,1885,990,895
2014,2,Eixample,9,la Nova Esquerra de l'Eixample,2139,1661,888,773
2014,2,Eixample,9,la Nova Esquerra de l'Eixample,2140,1916,1035,881
2014,2,Eixample,9,la Nova Esquerra de l'Eixample,2141,1252,685,567
2014,2,Eixample,9,la Nova Esquerra de l'Eixample,2142,1961,1053,908
2014,2,Eixample,9,la Nova Esquerra de l'Eixample,2143,1277,667,610
2014,2,Eixample,9,la Nova Esquerra de l'Eixample,2144,1493,803,690
2014,2,Eixample,9,la Nova Esquerra de l'Eixample,2145,1287,664,623
2014,2,Eixample,9,la Nova Esquerra de l'Eixample,2146,1186,641,545
2014,2,Eixample,9,la Nova Esquerra de l'Eixample,2147,2192,1188,1004
2014,2,Eixample,9,la Nova Esquerra de l'Eixample,2148,1626,861,765
2014,2,Eixample,9,la Nova Esquerra de l'Eixample,2149,1779,935,844
2014,2,Eixample,10,Sant Antoni,2150,1522,803,719
2014,2,Eixample,10,Sant Antoni,2151,1479,793,686
2014,2,Eixample,10,Sant Antoni,2152,1252,693,559
2014,2,Eixample,10,Sant Antoni,2153,1337,736,601
2014,2,Eixample,10,Sant Antoni,2154,1043,550,493
2014,2,Eixample,10,Sant Antoni,2155,1887,1025,862
2014,2,Eixample,10,Sant Antoni,2156,1273,679,594
2014,2,Eixample,10,Sant Antoni,2157,1216,650,566
2014,2,Eixample,10,Sant Antoni,2158,1637,862,775
2014,2,Eixample,10,Sant Antoni,2159,1869,977,892
2014,2,Eixample,10,Sant Antoni,2160,2016,1080,936
2014,2,Eixample,10,Sant Antoni,2161,1164,614,550
2014,2,Eixample,10,Sant Antoni,2162,1363,718,645
2014,2,Eixample,10,Sant Antoni,2163,1799,961,838
2014,2,Eixample,10,Sant Antoni,2164,1409,742,667
2014,2,Eixample,10,Sant Antoni,2165,1548,815,733
2014,2,Eixample,10,Sant Antoni,2166,2083,1105,978
2014,2,Eixample,10,Sant Antoni,2167,2070,1089,981
2014,2,Eixample,10,Sant Antoni,2168,2242,1190,1052
2014,2,Eixample,10,Sant Antoni,2169,1565,814,751
2014,2,Eixample,10,Sant Antoni,2170,1595,817,778
2014,2,Eixample,10,Sant Antoni,2171,1610,855,755
2014,2,Eixample,10,Sant Antoni,2172,1565,791,774
2014,2,Eixample,10,Sant Antoni,2173,1552,833,719
2014,3,Sants-Montjuïc,11,el Poble-sec,3001,1671,892,779
2014,3,Sants-Montjuïc,11,el Poble-sec,3002,1985,1066,919
2014,3,Sants-Montjuïc,11,el Poble-sec,3003,1668,869,799
2014,3,Sants-Montjuïc,11,el Poble-sec,3004,1544,795,749
2014,3,Sants-Montjuïc,11,el Poble-sec,3005,1254,656,598
2014,3,Sants-Montjuïc,11,el Poble-sec,3006,1369,673,696
2014,3,Sants-Montjuïc,11,el Poble-sec,3007,1666,872,794
2014,3,Sants-Montjuïc,11,el Poble-sec,3008,1230,642,588
2014,3,Sants-Montjuïc,11,el Poble-sec,3009,1214,655,559
2014,3,Sants-Montjuïc,11,el Poble-sec,3010,1783,925,858
2014,3,Sants-Montjuïc,11,el Poble-sec,3011,1756,891,865
2014,3,Sants-Montjuïc,11,el Poble-sec,3012,2216,1152,1064
2014,3,Sants-Montjuïc,11,el Poble-sec,3013,1860,891,969
2014,3,Sants-Montjuïc,11,el Poble-sec,3014,1858,883,975
2014,3,Sants-Montjuïc,11,el Poble-sec,3015,3064,1555,1509
2014,3,Sants-Montjuïc,11,el Poble-sec,3016,1284,642,642
2014,3,Sants-Montjuïc,11,el Poble-sec,3017,1731,846,885
2014,3,Sants-Montjuïc,11,el Poble-sec,3018,1694,852,842
2014,3,Sants-Montjuïc,11,el Poble-sec,3019,1433,734,699
2014,3,Sants-Montjuïc,11,el Poble-sec,3020,1243,614,629
2014,3,Sants-Montjuïc,11,el Poble-sec,3021,1140,620,520
2014,3,Sants-Montjuïc,11,el Poble-sec,3022,1511,768,743
2014,3,Sants-Montjuïc,11,el Poble-sec,3023,2031,991,1040
2014,3,Sants-Montjuïc,11,el Poble-sec,3024,2082,1043,1039
2014,3,Sants-Montjuïc,12,la Marina del Prat Vermell,3025,1143,567,576
2014,3,Sants-Montjuïc,13,la Marina de Port,3026,985,504,481
2014,3,Sants-Montjuïc,13,la Marina de Port,3027,1756,900,856
2014,3,Sants-Montjuïc,13,la Marina de Port,3028,2201,1136,1065
2014,3,Sants-Montjuïc,13,la Marina de Port,3029,1262,684,578
2014,3,Sants-Montjuïc,13,la Marina de Port,3030,1561,858,703
2014,3,Sants-Montjuïc,13,la Marina de Port,3031,2513,1297,1216
2014,3,Sants-Montjuïc,13,la Marina de Port,3032,1565,821,744
2014,3,Sants-Montjuïc,13,la Marina de Port,3033,1419,717,702
2014,3,Sants-Montjuïc,13,la Marina de Port,3034,1566,804,762
2014,3,Sants-Montjuïc,13,la Marina de Port,3035,2264,1164,1100
2014,3,Sants-Montjuïc,13,la Marina de Port,3036,2308,1186,1122
2014,3,Sants-Montjuïc,13,la Marina de Port,3037,1119,579,540
2014,3,Sants-Montjuïc,13,la Marina de Port,3038,991,531,460
2014,3,Sants-Montjuïc,13,la Marina de Port,3039,2382,1197,1185
2014,3,Sants-Montjuïc,13,la Marina de Port,3211,1411,717,694
2014,3,Sants-Montjuïc,13,la Marina de Port,3212,2372,1274,1098
2014,3,Sants-Montjuïc,13,la Marina de Port,3213,2376,1200,1176
2014,3,Sants-Montjuïc,14,la Font de la Guatlla,3040,1494,783,711
2014,3,Sants-Montjuïc,14,la Font de la Guatlla,3041,1344,721,623
2014,3,Sants-Montjuïc,14,la Font de la Guatlla,3042,1337,699,638
2014,3,Sants-Montjuïc,14,la Font de la Guatlla,3043,1694,907,787
2014,3,Sants-Montjuïc,14,la Font de la Guatlla,3044,1904,1016,888
2014,3,Sants-Montjuïc,14,la Font de la Guatlla,3045,1087,561,526
2014,3,Sants-Montjuïc,14,la Font de la Guatlla,3046,1450,782,668
2014,3,Sants-Montjuïc,15,Hostafrancs,3047,1782,913,869
2014,3,Sants-Montjuïc,15,Hostafrancs,3048,1376,731,645
2014,3,Sants-Montjuïc,15,Hostafrancs,3049,1648,868,780
2014,3,Sants-Montjuïc,15,Hostafrancs,3050,1588,836,752
2014,3,Sants-Montjuïc,15,Hostafrancs,3051,1773,911,862
2014,3,Sants-Montjuïc,15,Hostafrancs,3052,1241,622,619
2014,3,Sants-Montjuïc,15,Hostafrancs,3053,2081,1073,1008
2014,3,Sants-Montjuïc,15,Hostafrancs,3054,1793,938,855
2014,3,Sants-Montjuïc,15,Hostafrancs,3055,1556,787,769
2014,3,Sants-Montjuïc,15,Hostafrancs,3056,833,455,378
2014,3,Sants-Montjuïc,16,la Bordeta,3057,1500,821,679
2014,3,Sants-Montjuïc,16,la Bordeta,3058,1337,762,575
2014,3,Sants-Montjuïc,16,la Bordeta,3059,1232,629,603
2014,3,Sants-Montjuïc,16,la Bordeta,3060,1363,716,647
2014,3,Sants-Montjuïc,16,la Bordeta,3061,1089,588,501
2014,3,Sants-Montjuïc,16,la Bordeta,3062,1647,870,777
2014,3,Sants-Montjuïc,16,la Bordeta,3063,1287,660,627
2014,3,Sants-Montjuïc,16,la Bordeta,3064,1255,658,597
2014,3,Sants-Montjuïc,16,la Bordeta,3065,1403,710,693
2014,3,Sants-Montjuïc,16,la Bordeta,3066,2252,1160,1092
2014,3,Sants-Montjuïc,16,la Bordeta,3067,1650,886,764
2014,3,Sants-Montjuïc,16,la Bordeta,3068,1191,621,570
2014,3,Sants-Montjuïc,16,la Bordeta,3069,1191,616,575
2014,3,Sants-Montjuïc,17,Sants - Badal,3070,1266,640,626
2014,3,Sants-Montjuïc,17,Sants - Badal,3071,1308,682,626
2014,3,Sants-Montjuïc,17,Sants - Badal,3072,1378,749,629
2014,3,Sants-Montjuïc,17,Sants - Badal,3073,1591,848,743
2014,3,Sants-Montjuïc,17,Sants - Badal,3074,1767,961,806
2014,3,Sants-Montjuïc,17,Sants - Badal,3075,1651,877,774
2014,3,Sants-Montjuïc,17,Sants - Badal,3076,970,497,473
2014,3,Sants-Montjuïc,17,Sants - Badal,3077,1346,727,619
2014,3,Sants-Montjuïc,17,Sants - Badal,3078,1711,876,835
2014,3,Sants-Montjuïc,17,Sants - Badal,3079,1792,936,856
2014,3,Sants-Montjuïc,17,Sants - Badal,3080,1570,863,707
2014,3,Sants-Montjuïc,17,Sants - Badal,3081,1961,1064,897
2014,3,Sants-Montjuïc,17,Sants - Badal,3082,1803,957,846
2014,3,Sants-Montjuïc,17,Sants - Badal,3083,1356,726,630
2014,3,Sants-Montjuïc,17,Sants - Badal,3084,1474,777,697
2014,3,Sants-Montjuïc,17,Sants - Badal,3085,1181,628,553
2014,3,Sants-Montjuïc,18,Sants,3086,1264,664,600
2014,3,Sants-Montjuïc,18,Sants,3087,1453,798,655
2014,3,Sants-Montjuïc,18,Sants,3088,1419,760,659
2014,3,Sants-Montjuïc,18,Sants,3089,1191,646,545
2014,3,Sants-Montjuïc,18,Sants,3090,1051,568,483
2014,3,Sants-Montjuïc,18,Sants,3091,1489,762,727
2014,3,Sants-Montjuïc,18,Sants,3092,1275,648,627
2014,3,Sants-Montjuïc,18,Sants,3093,1626,854,772
2014,3,Sants-Montjuïc,18,Sants,3094,1160,629,531
2014,3,Sants-Montjuïc,18,Sants,3095,1642,900,742
2014,3,Sants-Montjuïc,18,Sants,3096,1567,814,753
2014,3,Sants-Montjuïc,18,Sants,3097,1623,839,784
2014,3,Sants-Montjuïc,18,Sants,3098,1368,689,679
2014,3,Sants-Montjuïc,18,Sants,3099,1002,550,452
2014,3,Sants-Montjuïc,18,Sants,3100,1228,648,580
2014,3,Sants-Montjuïc,18,Sants,3101,1847,852,995
2014,3,Sants-Montjuïc,18,Sants,3102,1316,703,613
2014,3,Sants-Montjuïc,18,Sants,3103,1193,640,553
2014,3,Sants-Montjuïc,18,Sants,3104,1440,753,687
2014,3,Sants-Montjuïc,18,Sants,3105,1157,612,545
2014,3,Sants-Montjuïc,18,Sants,3106,1239,677,562
2014,3,Sants-Montjuïc,18,Sants,3107,1534,771,763
2014,3,Sants-Montjuïc,18,Sants,3108,1614,874,740
2014,3,Sants-Montjuïc,18,Sants,3109,1470,769,701
2014,3,Sants-Montjuïc,18,Sants,3110,1490,783,707
2014,3,Sants-Montjuïc,18,Sants,3111,1278,682,596
2014,3,Sants-Montjuïc,18,Sants,3112,1863,990,873
2014,3,Sants-Montjuïc,18,Sants,3113,1586,826,760
2014,3,Sants-Montjuïc,18,Sants,3114,1464,774,690
2014,4,Les Corts,19,les Corts,4001,1212,647,565
2014,4,Les Corts,19,les Corts,4002,1815,946,869
2014,4,Les Corts,19,les Corts,4003,1061,537,524
2014,4,Les Corts,19,les Corts,4004,1003,537,466
2014,4,Les Corts,19,les Corts,4005,1230,660,570
2014,4,Les Corts,19,les Corts,4006,1139,611,528
2014,4,Les Corts,19,les Corts,4007,1094,618,476
2014,4,Les Corts,19,les Corts,4008,1043,565,478
2014,4,Les Corts,19,les Corts,4009,1443,776,667
2014,4,Les Corts,19,les Corts,4010,941,503,438
2014,4,Les Corts,19,les Corts,4011,1669,875,794
2014,4,Les Corts,19,les Corts,4012,1412,772,640
2014,4,Les Corts,19,les Corts,4013,1255,686,569
2014,4,Les Corts,19,les Corts,4014,785,434,351
2014,4,Les Corts,19,les Corts,4015,1889,1032,857
2014,4,Les Corts,19,les Corts,4016,1123,588,535
2014,4,Les Corts,19,les Corts,4017,1114,626,488
2014,4,Les Corts,19,les Corts,4018,1525,842,683
2014,4,Les Corts,19,les Corts,4019,1270,704,566
2014,4,Les Corts,19,les Corts,4020,1392,742,650
2014,4,Les Corts,19,les Corts,4021,1280,705,575
2014,4,Les Corts,19,les Corts,4022,1524,809,715
2014,4,Les Corts,19,les Corts,4023,1098,573,525
2014,4,Les Corts,19,les Corts,4024,1068,555,513
2014,4,Les Corts,19,les Corts,4025,1207,633,574
2014,4,Les Corts,19,les Corts,4026,1355,745,610
2014,4,Les Corts,19,les Corts,4027,1223,673,550
2014,4,Les Corts,19,les Corts,4028,1329,702,627
2014,4,Les Corts,19,les Corts,4029,1159,621,538
2014,4,Les Corts,19,les Corts,4030,1742,935,807
2014,4,Les Corts,19,les Corts,4031,1933,867,1066
2014,4,Les Corts,19,les Corts,4032,1542,842,700
2014,4,Les Corts,19,les Corts,4033,1214,652,562
2014,4,Les Corts,19,les Corts,4034,1474,792,682
2014,4,Les Corts,19,les Corts,4035,1426,771,655
2014,4,Les Corts,20,la Maternitat i Sant Ramon,4036,1727,955,772
2014,4,Les Corts,20,la Maternitat i Sant Ramon,4037,2085,1121,964
2014,4,Les Corts,20,la Maternitat i Sant Ramon,4038,1247,673,574
2014,4,Les Corts,20,la Maternitat i Sant Ramon,4039,1206,643,563
2014,4,Les Corts,20,la Maternitat i Sant Ramon,4040,1576,837,739
2014,4,Les Corts,20,la Maternitat i Sant Ramon,4041,1298,702,596
2014,4,Les Corts,20,la Maternitat i Sant Ramon,4042,1723,921,802
2014,4,Les Corts,20,la Maternitat i Sant Ramon,4043,1662,912,750
2014,4,Les Corts,20,la Maternitat i Sant Ramon,4044,1651,864,787
2014,4,Les Corts,20,la Maternitat i Sant Ramon,4045,1394,742,652
2014,4,Les Corts,20,la Maternitat i Sant Ramon,4046,2415,1232,1183
2014,4,Les Corts,20,la Maternitat i Sant Ramon,4047,1566,824,742
2014,4,Les Corts,20,la Maternitat i Sant Ramon,4048,1517,807,710
2014,4,Les Corts,20,la Maternitat i Sant Ramon,4049,1140,596,544
2014,4,Les Corts,20,la Maternitat i Sant Ramon,4084,1347,733,614
2014,4,Les Corts,21,Pedralbes,4050,2035,1095,940
2014,4,Les Corts,21,Pedralbes,4051,1536,836,700
2014,4,Les Corts,21,Pedralbes,4052,2138,1148,990
2014,4,Les Corts,21,Pedralbes,4053,1566,810,756
2014,4,Les Corts,21,Pedralbes,4054,1049,560,489
2014,4,Les Corts,21,Pedralbes,4055,1558,794,764
2014,4,Les Corts,21,Pedralbes,4056,1771,954,817
2014,5,Sarrià-Sant Gervasi,22,"Vallvidrera, el Tibidabo i les Planes",5001,1556,783,773
2014,5,Sarrià-Sant Gervasi,22,"Vallvidrera, el Tibidabo i les Planes",5002,1583,842,741
2014,5,Sarrià-Sant Gervasi,22,"Vallvidrera, el Tibidabo i les Planes",5003,1377,706,671
2014,5,Sarrià-Sant Gervasi,23,Sarrià,5004,1134,654,480
2014,5,Sarrià-Sant Gervasi,23,Sarrià,5005,1112,576,536
2014,5,Sarrià-Sant Gervasi,23,Sarrià,5006,1775,891,884
2014,5,Sarrià-Sant Gervasi,23,Sarrià,5007,1580,826,754
2014,5,Sarrià-Sant Gervasi,23,Sarrià,5008,1565,853,712
2014,5,Sarrià-Sant Gervasi,23,Sarrià,5009,1756,976,780
2014,5,Sarrià-Sant Gervasi,23,Sarrià,5010,1581,849,732
2014,5,Sarrià-Sant Gervasi,23,Sarrià,5011,1404,763,641
2014,5,Sarrià-Sant Gervasi,23,Sarrià,5012,1392,760,632
2014,5,Sarrià-Sant Gervasi,23,Sarrià,5013,1710,904,806
2014,5,Sarrià-Sant Gervasi,23,Sarrià,5014,1628,855,773
2014,5,Sarrià-Sant Gervasi,23,Sarrià,5015,1572,845,727
2014,5,Sarrià-Sant Gervasi,23,Sarrià,5016,1785,963,822
2014,5,Sarrià-Sant Gervasi,23,Sarrià,5017,1634,867,767
2014,5,Sarrià-Sant Gervasi,23,Sarrià,5018,1232,676,556
2014,5,Sarrià-Sant Gervasi,23,Sarrià,5019,1671,891,780
2014,5,Sarrià-Sant Gervasi,24,les Tres Torres,5020,1081,601,480
2014,5,Sarrià-Sant Gervasi,24,les Tres Torres,5021,1300,697,603
2014,5,Sarrià-Sant Gervasi,24,les Tres Torres,5022,1749,991,758
2014,5,Sarrià-Sant Gervasi,24,les Tres Torres,5023,1457,809,648
2014,5,Sarrià-Sant Gervasi,24,les Tres Torres,5024,1841,996,845
2014,5,Sarrià-Sant Gervasi,24,les Tres Torres,5025,1425,749,676
2014,5,Sarrià-Sant Gervasi,24,les Tres Torres,5026,1359,713,646
2014,5,Sarrià-Sant Gervasi,24,les Tres Torres,5027,1355,699,656
2014,5,Sarrià-Sant Gervasi,24,les Tres Torres,5028,1465,764,701
2014,5,Sarrià-Sant Gervasi,24,les Tres Torres,5029,1676,867,809
2014,5,Sarrià-Sant Gervasi,24,les Tres Torres,5030,1457,770,687
2014,5,Sarrià-Sant Gervasi,25,Sant Gervasi - la Bonanova,5031,1608,868,740
2014,5,Sarrià-Sant Gervasi,25,Sant Gervasi - la Bonanova,5032,1647,900,747
2014,5,Sarrià-Sant Gervasi,25,Sant Gervasi - la Bonanova,5033,1335,729,606
2014,5,Sarrià-Sant Gervasi,25,Sant Gervasi - la Bonanova,5034,1155,656,499
2014,5,Sarrià-Sant Gervasi,25,Sant Gervasi - la Bonanova,5035,1097,563,534
2014,5,Sarrià-Sant Gervasi,25,Sant Gervasi - la Bonanova,5036,1666,889,777
2014,5,Sarrià-Sant Gervasi,25,Sant Gervasi - la Bonanova,5037,1371,773,598
2014,5,Sarrià-Sant Gervasi,25,Sant Gervasi - la Bonanova,5038,1277,686,591
2014,5,Sarrià-Sant Gervasi,25,Sant Gervasi - la Bonanova,5039,1575,859,716
2014,5,Sarrià-Sant Gervasi,25,Sant Gervasi - la Bonanova,5040,1382,747,635
2014,5,Sarrià-Sant Gervasi,25,Sant Gervasi - la Bonanova,5041,2000,981,1019
2014,5,Sarrià-Sant Gervasi,25,Sant Gervasi - la Bonanova,5042,1227,655,572
2014,5,Sarrià-Sant Gervasi,25,Sant Gervasi - la Bonanova,5043,1405,755,650
2014,5,Sarrià-Sant Gervasi,25,Sant Gervasi - la Bonanova,5044,1271,705,566
2014,5,Sarrià-Sant Gervasi,25,Sant Gervasi - la Bonanova,5045,1565,861,704
2014,5,Sarrià-Sant Gervasi,25,Sant Gervasi - la Bonanova,5046,1145,648,497
2014,5,Sarrià-Sant Gervasi,25,Sant Gervasi - la Bonanova,5047,1271,687,584
2014,5,Sarrià-Sant Gervasi,25,Sant Gervasi - la Bonanova,5048,1276,708,568
2014,5,Sarrià-Sant Gervasi,26,Sant Gervasi - Galvany,5049,1630,876,754
2014,5,Sarrià-Sant Gervasi,26,Sant Gervasi - Galvany,5050,1592,856,736
2014,5,Sarrià-Sant Gervasi,26,Sant Gervasi - Galvany,5051,1566,827,739
2014,5,Sarrià-Sant Gervasi,26,Sant Gervasi - Galvany,5052,1494,837,657
2014,5,Sarrià-Sant Gervasi,26,Sant Gervasi - Galvany,5053,1471,794,677
2014,5,Sarrià-Sant Gervasi,26,Sant Gervasi - Galvany,5054,1067,592,475
2014,5,Sarrià-Sant Gervasi,26,Sant Gervasi - Galvany,5055,1454,764,690
2014,5,Sarrià-Sant Gervasi,26,Sant Gervasi - Galvany,5056,1232,716,516
2014,5,Sarrià-Sant Gervasi,26,Sant Gervasi - Galvany,5057,1708,905,803
2014,5,Sarrià-Sant Gervasi,26,Sant Gervasi - Galvany,5058,1561,857,704
2014,5,Sarrià-Sant Gervasi,26,Sant Gervasi - Galvany,5059,1544,871,673
2014,5,Sarrià-Sant Gervasi,26,Sant Gervasi - Galvany,5060,1134,634,500
2014,5,Sarrià-Sant Gervasi,26,Sant Gervasi - Galvany,5061,1447,781,666
2014,5,Sarrià-Sant Gervasi,26,Sant Gervasi - Galvany,5062,1596,884,712
2014,5,Sarrià-Sant Gervasi,26,Sant Gervasi - Galvany,5063,1584,879,705
2014,5,Sarrià-Sant Gervasi,26,Sant Gervasi - Galvany,5064,1613,893,720
2014,5,Sarrià-Sant Gervasi,26,Sant Gervasi - Galvany,5065,1625,909,716
2014,5,Sarrià-Sant Gervasi,26,Sant Gervasi - Galvany,5066,1203,675,528
2014,5,Sarrià-Sant Gervasi,26,Sant Gervasi - Galvany,5067,1252,683,569
2014,5,Sarrià-Sant Gervasi,26,Sant Gervasi - Galvany,5068,1516,825,691
2014,5,Sarrià-Sant Gervasi,26,Sant Gervasi - Galvany,5069,1684,927,757
2014,5,Sarrià-Sant Gervasi,26,Sant Gervasi - Galvany,5070,1442,799,643
2014,5,Sarrià-Sant Gervasi,26,Sant Gervasi - Galvany,5071,1552,847,705
2014,5,Sarrià-Sant Gervasi,26,Sant Gervasi - Galvany,5072,1613,928,685
2014,5,Sarrià-Sant Gervasi,26,Sant Gervasi - Galvany,5073,1595,881,714
2014,5,Sarrià-Sant Gervasi,26,Sant Gervasi - Galvany,5074,1666,897,769
2014,5,Sarrià-Sant Gervasi,26,Sant Gervasi - Galvany,5075,1672,951,721
2014,5,Sarrià-Sant Gervasi,26,Sant Gervasi - Galvany,5076,1317,717,600
2014,5,Sarrià-Sant Gervasi,26,Sant Gervasi - Galvany,5077,1393,781,612
2014,5,Sarrià-Sant Gervasi,26,Sant Gervasi - Galvany,5078,2030,1089,941
2014,5,Sarrià-Sant Gervasi,26,Sant Gervasi - Galvany,5079,1208,666,542
2014,5,Sarrià-Sant Gervasi,27,el Putget i Farró,5080,1302,739,563
2014,5,Sarrià-Sant Gervasi,27,el Putget i Farró,5081,1527,852,675
2014,5,Sarrià-Sant Gervasi,27,el Putget i Farró,5082,1592,866,726
2014,5,Sarrià-Sant Gervasi,27,el Putget i Farró,5083,1292,696,596
2014,5,Sarrià-Sant Gervasi,27,el Putget i Farró,5084,1366,768,598
2014,5,Sarrià-Sant Gervasi,27,el Putget i Farró,5085,1271,669,602
2014,5,Sarrià-Sant Gervasi,27,el Putget i Farró,5086,1302,710,592
2014,5,Sarrià-Sant Gervasi,27,el Putget i Farró,5087,1520,853,667
2014,5,Sarrià-Sant Gervasi,27,el Putget i Farró,5088,1751,896,855
2014,5,Sarrià-Sant Gervasi,27,el Putget i Farró,5089,1648,893,755
2014,5,Sarrià-Sant Gervasi,27,el Putget i Farró,5090,1858,984,874
2014,5,Sarrià-Sant Gervasi,27,el Putget i Farró,5091,1503,864,639
2014,5,Sarrià-Sant Gervasi,27,el Putget i Farró,5092,1518,848,670
2014,5,Sarrià-Sant Gervasi,27,el Putget i Farró,5093,1096,605,491
2014,5,Sarrià-Sant Gervasi,27,el Putget i Farró,5094,2536,1414,1122
2014,5,Sarrià-Sant Gervasi,27,el Putget i Farró,5095,1568,881,687
2014,5,Sarrià-Sant Gervasi,27,el Putget i Farró,5096,1072,591,481
2014,5,Sarrià-Sant Gervasi,27,el Putget i Farró,5097,1626,842,784
2014,5,Sarrià-Sant Gervasi,27,el Putget i Farró,5098,1479,805,674
2014,6,Gràcia,28,Vallcarca i els Penitents,6001,1156,657,499
2014,6,Gràcia,28,Vallcarca i els Penitents,6002,1425,783,642
2014,6,Gràcia,28,Vallcarca i els Penitents,6003,2217,1157,1060
2014,6,Gràcia,28,Vallcarca i els Penitents,6004,1439,754,685
2014,6,Gràcia,28,Vallcarca i els Penitents,6006,1016,546,470
2014,6,Gràcia,28,Vallcarca i els Penitents,6007,1778,959,819
2014,6,Gràcia,28,Vallcarca i els Penitents,6008,1850,1037,813
2014,6,Gràcia,28,Vallcarca i els Penitents,6009,1239,644,595
2014,6,Gràcia,28,Vallcarca i els Penitents,6010,992,531,461
2014,6,Gràcia,28,Vallcarca i els Penitents,6011,1243,669,574
2014,6,Gràcia,28,Vallcarca i els Penitents,6012,1087,592,495
2014,6,Gràcia,29,el Coll,6013,1654,866,788
2014,6,Gràcia,29,el Coll,6014,1325,699,626
2014,6,Gràcia,29,el Coll,6015,1343,725,618
2014,6,Gràcia,29,el Coll,6016,1571,833,738
2014,6,Gràcia,29,el Coll,6017,1308,701,607
2014,6,Gràcia,30,la Salut,6018,1241,669,572
2014,6,Gràcia,30,la Salut,6019,1508,792,716
2014,6,Gràcia,30,la Salut,6020,1125,612,513
2014,6,Gràcia,30,la Salut,6021,1360,731,629
2014,6,Gràcia,30,la Salut,6022,1415,728,687
2014,6,Gràcia,30,la Salut,6023,1334,714,620
2014,6,Gràcia,30,la Salut,6024,1608,908,700
2014,6,Gràcia,30,la Salut,6025,1371,766,605
2014,6,Gràcia,30,la Salut,6026,989,551,438
2014,6,Gràcia,30,la Salut,6027,1208,683,525
2014,6,Gràcia,31,Vila de Gràcia,6028,1303,691,612
2014,6,Gràcia,31,Vila de Gràcia,6029,1227,685,542
2014,6,Gràcia,31,Vila de Gràcia,6030,1367,753,614
2014,6,Gràcia,31,Vila de Gràcia,6031,1099,611,488
2014,6,Gràcia,31,Vila de Gràcia,6032,1124,594,530
2014,6,Gràcia,31,Vila de Gràcia,6033,1286,703,583
2014,6,Gràcia,31,Vila de Gràcia,6034,1277,722,555
2014,6,Gràcia,31,Vila de Gràcia,6035,1003,548,455
2014,6,Gràcia,31,Vila de Gràcia,6036,1369,779,590
2014,6,Gràcia,31,Vila de Gràcia,6037,1102,600,502
2014,6,Gràcia,31,Vila de Gràcia,6038,1441,838,603
2014,6,Gràcia,31,Vila de Gràcia,6039,1596,883,713
2014,6,Gràcia,31,Vila de Gràcia,6040,1618,923,695
2014,6,Gràcia,31,Vila de Gràcia,6041,1674,933,741
2014,6,Gràcia,31,Vila de Gràcia,6042,1672,887,785
2014,6,Gràcia,31,Vila de Gràcia,6043,1211,668,543
2014,6,Gràcia,31,Vila de Gràcia,6044,1425,772,653
2014,6,Gràcia,31,Vila de Gràcia,6045,1208,660,548
2014,6,Gràcia,31,Vila de Gràcia,6046,1047,576,471
2014,6,Gràcia,31,Vila de Gràcia,6047,1825,868,957
2014,6,Gràcia,31,Vila de Gràcia,6048,1366,747,619
2014,6,Gràcia,31,Vila de Gràcia,6049,1122,612,510
2014,6,Gràcia,31,Vila de Gràcia,6050,1241,677,564
2014,6,Gràcia,31,Vila de Gràcia,6051,1343,759,584
2014,6,Gràcia,31,Vila de Gràcia,6052,1553,838,715
2014,6,Gràcia,31,Vila de Gràcia,6053,1536,845,691
2014,6,Gràcia,31,Vila de Gràcia,6054,1670,886,784
2014,6,Gràcia,31,Vila de Gràcia,6055,1402,785,617
2014,6,Gràcia,31,Vila de Gràcia,6056,1552,839,713
2014,6,Gràcia,31,Vila de Gràcia,6057,1557,865,692
2014,6,Gràcia,31,Vila de Gràcia,6058,1683,948,735
2014,6,Gràcia,31,Vila de Gràcia,6059,1515,814,701
2014,6,Gràcia,31,Vila de Gràcia,6060,1829,980,849
2014,6,Gràcia,31,Vila de Gràcia,6061,1322,717,605
2014,6,Gràcia,31,Vila de Gràcia,6062,1319,706,613
2014,6,Gràcia,31,Vila de Gràcia,6063,1556,836,720
2014,6,Gràcia,32,el Camp d'en Grassot i Gràcia Nova,6064,1903,1041,862
2014,6,Gràcia,32,el Camp d'en Grassot i Gràcia Nova,6065,1143,613,530
2014,6,Gràcia,32,el Camp d'en Grassot i Gràcia Nova,6066,990,562,428
2014,6,Gràcia,32,el Camp d'en Grassot i Gràcia Nova,6067,1791,961,830
2014,6,Gràcia,32,el Camp d'en Grassot i Gràcia Nova,6068,1503,848,655
2014,6,Gràcia,32,el Camp d'en Grassot i Gràcia Nova,6069,1161,618,543
2014,6,Gràcia,32,el Camp d'en Grassot i Gràcia Nova,6070,1844,1032,812
2014,6,Gràcia,32,el Camp d'en Grassot i Gràcia Nova,6071,1084,582,502
2014,6,Gràcia,32,el Camp d'en Grassot i Gràcia Nova,6072,1583,873,710
2014,6,Gràcia,32,el Camp d'en Grassot i Gràcia Nova,6073,1409,752,657
2014,6,Gràcia,32,el Camp d'en Grassot i Gràcia Nova,6074,1064,569,495
2014,6,Gràcia,32,el Camp d'en Grassot i Gràcia Nova,6075,1064,567,497
2014,6,Gràcia,32,el Camp d'en Grassot i Gràcia Nova,6076,1298,654,644
2014,6,Gràcia,32,el Camp d'en Grassot i Gràcia Nova,6077,1240,693,547
2014,6,Gràcia,32,el Camp d'en Grassot i Gràcia Nova,6078,1305,705,600
2014,6,Gràcia,32,el Camp d'en Grassot i Gràcia Nova,6079,1067,573,494
2014,6,Gràcia,32,el Camp d'en Grassot i Gràcia Nova,6080,1158,619,539
2014,6,Gràcia,32,el Camp d'en Grassot i Gràcia Nova,6081,1301,699,602
2014,6,Gràcia,32,el Camp d'en Grassot i Gràcia Nova,6082,1742,965,777
2014,6,Gràcia,32,el Camp d'en Grassot i Gràcia Nova,6083,1736,915,821
2014,6,Gràcia,32,el Camp d'en Grassot i Gràcia Nova,6084,1436,784,652
2014,6,Gràcia,32,el Camp d'en Grassot i Gràcia Nova,6085,1198,664,534
2014,6,Gràcia,32,el Camp d'en Grassot i Gràcia Nova,6086,945,508,437
2014,6,Gràcia,32,el Camp d'en Grassot i Gràcia Nova,6087,1878,1020,858
2014,6,Gràcia,32,el Camp d'en Grassot i Gràcia Nova,6088,1198,662,536
2014,7,Horta-Guinardó,33,el Baix Guinardó,7001,1614,914,700
2014,7,Horta-Guinardó,33,el Baix Guinardó,7002,1132,603,529
2014,7,Horta-Guinardó,33,el Baix Guinardó,7003,1297,695,602
2014,7,Horta-Guinardó,33,el Baix Guinardó,7004,1477,803,674
2014,7,Horta-Guinardó,33,el Baix Guinardó,7005,1508,798,710
2014,7,Horta-Guinardó,33,el Baix Guinardó,7006,955,525,430
2014,7,Horta-Guinardó,33,el Baix Guinardó,7007,1382,781,601
2014,7,Horta-Guinardó,33,el Baix Guinardó,7008,1466,759,707
2014,7,Horta-Guinardó,33,el Baix Guinardó,7009,1157,625,532
2014,7,Horta-Guinardó,33,el Baix Guinardó,7010,1316,699,617
2014,7,Horta-Guinardó,33,el Baix Guinardó,7011,1146,636,510
2014,7,Horta-Guinardó,33,el Baix Guinardó,7012,1553,849,704
2014,7,Horta-Guinardó,33,el Baix Guinardó,7013,1249,660,589
2014,7,Horta-Guinardó,33,el Baix Guinardó,7014,895,473,422
2014,7,Horta-Guinardó,33,el Baix Guinardó,7015,1406,745,661
2014,7,Horta-Guinardó,33,el Baix Guinardó,7016,1310,657,653
2014,7,Horta-Guinardó,33,el Baix Guinardó,7017,1631,900,731
2014,7,Horta-Guinardó,33,el Baix Guinardó,7018,1555,862,693
2014,7,Horta-Guinardó,33,el Baix Guinardó,7019,1487,791,696
2014,7,Horta-Guinardó,34,Can Baró,7020,1550,846,704
2014,7,Horta-Guinardó,34,Can Baró,7021,1053,545,508
2014,7,Horta-Guinardó,34,Can Baró,7022,1090,576,514
2014,7,Horta-Guinardó,34,Can Baró,7023,1282,655,627
2014,7,Horta-Guinardó,34,Can Baró,7024,1432,772,660
2014,7,Horta-Guinardó,34,Can Baró,7025,1394,731,663
2014,7,Horta-Guinardó,34,Can Baró,7026,1059,570,489
2014,7,Horta-Guinardó,35,el Guinardó,7027,1968,1043,925
2014,7,Horta-Guinardó,35,el Guinardó,7028,1436,748,688
2014,7,Horta-Guinardó,35,el Guinardó,7029,1286,653,633
2014,7,Horta-Guinardó,35,el Guinardó,7030,1288,708,580
2014,7,Horta-Guinardó,35,el Guinardó,7031,1518,796,722
2014,7,Horta-Guinardó,35,el Guinardó,7032,1230,619,611
2014,7,Horta-Guinardó,35,el Guinardó,7033,1363,723,640
2014,7,Horta-Guinardó,35,el Guinardó,7034,1452,773,679
2014,7,Horta-Guinardó,35,el Guinardó,7035,1757,974,783
2014,7,Horta-Guinardó,35,el Guinardó,7036,1379,759,620
2014,7,Horta-Guinardó,35,el Guinardó,7037,1473,827,646
2014,7,Horta-Guinardó,35,el Guinardó,7038,1310,700,610
2014,7,Horta-Guinardó,35,el Guinardó,7039,1517,802,715
2014,7,Horta-Guinardó,35,el Guinardó,7040,1473,799,674
2014,7,Horta-Guinardó,35,el Guinardó,7041,1349,760,589
2014,7,Horta-Guinardó,35,el Guinardó,7042,1541,836,705
2014,7,Horta-Guinardó,35,el Guinardó,7043,1365,732,633
2014,7,Horta-Guinardó,35,el Guinardó,7044,1274,687,587
2014,7,Horta-Guinardó,35,el Guinardó,7045,1483,786,697
2014,7,Horta-Guinardó,35,el Guinardó,7046,1404,768,636
2014,7,Horta-Guinardó,35,el Guinardó,7047,1383,743,640
2014,7,Horta-Guinardó,35,el Guinardó,7048,1217,672,545
2014,7,Horta-Guinardó,35,el Guinardó,7049,1200,641,559
2014,7,Horta-Guinardó,35,el Guinardó,7050,1123,592,531
2014,7,Horta-Guinardó,35,el Guinardó,7051,1750,961,789
2014,7,Horta-Guinardó,36,la Font d'en Fargues,7052,1263,687,576
2014,7,Horta-Guinardó,36,la Font d'en Fargues,7053,1478,769,709
2014,7,Horta-Guinardó,36,la Font d'en Fargues,7054,1555,811,744
2014,7,Horta-Guinardó,36,la Font d'en Fargues,7055,1160,612,548
2014,7,Horta-Guinardó,36,la Font d'en Fargues,7056,1189,609,580
2014,7,Horta-Guinardó,36,la Font d'en Fargues,7057,1438,756,682
2014,7,Horta-Guinardó,36,la Font d'en Fargues,7058,1354,696,658
2014,7,Horta-Guinardó,37,el Carmel,7059,1299,673,626
2014,7,Horta-Guinardó,37,el Carmel,7060,1834,927,907
2014,7,Horta-Guinardó,37,el Carmel,7061,1239,607,632
2014,7,Horta-Guinardó,37,el Carmel,7062,1283,671,612
2014,7,Horta-Guinardó,37,el Carmel,7063,1478,739,739
2014,7,Horta-Guinardó,37,el Carmel,7064,1640,869,771
2014,7,Horta-Guinardó,37,el Carmel,7065,1670,844,826
2014,7,Horta-Guinardó,37,el Carmel,7066,1796,943,853
2014,7,Horta-Guinardó,37,el Carmel,7067,1542,821,721
2014,7,Horta-Guinardó,37,el Carmel,7068,1195,637,558
2014,7,Horta-Guinardó,37,el Carmel,7069,1420,713,707
2014,7,Horta-Guinardó,37,el Carmel,7070,1362,711,651
2014,7,Horta-Guinardó,37,el Carmel,7071,1381,732,649
2014,7,Horta-Guinardó,37,el Carmel,7072,1329,693,636
2014,7,Horta-Guinardó,37,el Carmel,7073,1043,579,464
2014,7,Horta-Guinardó,37,el Carmel,7074,1739,905,834
2014,7,Horta-Guinardó,37,el Carmel,7075,1236,629,607
2014,7,Horta-Guinardó,37,el Carmel,7076,1311,681,630
2014,7,Horta-Guinardó,37,el Carmel,7077,1304,678,626
2014,7,Horta-Guinardó,37,el Carmel,7078,1364,692,672
2014,7,Horta-Guinardó,37,el Carmel,7079,1412,740,672
2014,7,Horta-Guinardó,37,el Carmel,7080,1778,938,840
2014,7,Horta-Guinardó,38,la Teixonera,7081,1980,1021,959
2014,7,Horta-Guinardó,38,la Teixonera,7082,1275,653,622
2014,7,Horta-Guinardó,38,la Teixonera,7083,1245,635,610
2014,7,Horta-Guinardó,38,la Teixonera,7084,1308,667,641
2014,7,Horta-Guinardó,38,la Teixonera,7085,1332,695,637
2014,7,Horta-Guinardó,38,la Teixonera,7086,1477,773,704
2014,7,Horta-Guinardó,38,la Teixonera,7087,1579,837,742
2014,7,Horta-Guinardó,38,la Teixonera,7088,1239,630,609
2014,7,Horta-Guinardó,39,Sant Genís dels Agudells,7089,1304,706,598
2014,7,Horta-Guinardó,39,Sant Genís dels Agudells,7090,1413,714,699
2014,7,Horta-Guinardó,39,Sant Genís dels Agudells,7091,1165,609,556
2014,7,Horta-Guinardó,39,Sant Genís dels Agudells,7092,1414,770,644
2014,7,Horta-Guinardó,39,Sant Genís dels Agudells,7093,1558,823,735
2014,7,Horta-Guinardó,40,Montbau,7094,1188,671,517
2014,7,Horta-Guinardó,40,Montbau,7095,1517,838,679
2014,7,Horta-Guinardó,40,Montbau,7096,1410,758,652
2014,7,Horta-Guinardó,40,Montbau,7097,930,537,393
2014,7,Horta-Guinardó,41,la Vall d'Hebron,7098,1809,949,860
2014,7,Horta-Guinardó,41,la Vall d'Hebron,7099,1081,558,523
2014,7,Horta-Guinardó,41,la Vall d'Hebron,7100,1187,638,549
2014,7,Horta-Guinardó,41,la Vall d'Hebron,7101,1413,734,679
2014,7,Horta-Guinardó,42,la Clota,7102,521,260,261
2014,7,Horta-Guinardó,43,Horta,7103,1504,814,690
2014,7,Horta-Guinardó,43,Horta,7104,1595,848,747
2014,7,Horta-Guinardó,43,Horta,7105,1080,563,517
2014,7,Horta-Guinardó,43,Horta,7106,1110,585,525
2014,7,Horta-Guinardó,43,Horta,7107,1251,639,612
2014,7,Horta-Guinardó,43,Horta,7108,1237,643,594
2014,7,Horta-Guinardó,43,Horta,7109,1657,889,768
2014,7,Horta-Guinardó,43,Horta,7110,1010,582,428
2014,7,Horta-Guinardó,43,Horta,7111,881,486,395
2014,7,Horta-Guinardó,43,Horta,7112,1249,653,596
2014,7,Horta-Guinardó,43,Horta,7113,1181,602,579
2014,7,Horta-Guinardó,43,Horta,7114,1159,628,531
2014,7,Horta-Guinardó,43,Horta,7115,1095,560,535
2014,7,Horta-Guinardó,43,Horta,7116,1495,791,704
2014,7,Horta-Guinardó,43,Horta,7117,1598,707,891
2014,7,Horta-Guinardó,43,Horta,7118,1202,673,529
2014,7,Horta-Guinardó,43,Horta,7119,1187,644,543
2014,7,Horta-Guinardó,43,Horta,7120,1228,674,554
2014,7,Horta-Guinardó,43,Horta,7121,1161,639,522
2014,7,Horta-Guinardó,43,Horta,7122,1304,718,586
2014,7,Horta-Guinardó,43,Horta,7123,1368,720,648
2014,8,Nou Barris,44,Vilapicina i la Torre Llobeta,8001,1263,664,599
2014,8,Nou Barris,44,Vilapicina i la Torre Llobeta,8002,1261,667,594
2014,8,Nou Barris,44,Vilapicina i la Torre Llobeta,8003,1222,642,580
2014,8,Nou Barris,44,Vilapicina i la Torre Llobeta,8004,1377,751,626
2014,8,Nou Barris,44,Vilapicina i la Torre Llobeta,8005,1155,611,544
2014,8,Nou Barris,44,Vilapicina i la Torre Llobeta,8006,1450,779,671
2014,8,Nou Barris,44,Vilapicina i la Torre Llobeta,8007,1223,698,525
2014,8,Nou Barris,44,Vilapicina i la Torre Llobeta,8008,1567,830,737
2014,8,Nou Barris,44,Vilapicina i la Torre Llobeta,8009,1650,890,760
2014,8,Nou Barris,44,Vilapicina i la Torre Llobeta,8010,1089,590,499
2014,8,Nou Barris,44,Vilapicina i la Torre Llobeta,8011,1186,646,540
2014,8,Nou Barris,44,Vilapicina i la Torre Llobeta,8012,1344,738,606
2014,8,Nou Barris,44,Vilapicina i la Torre Llobeta,8013,1230,666,564
2014,8,Nou Barris,44,Vilapicina i la Torre Llobeta,8014,1179,631,548
2014,8,Nou Barris,44,Vilapicina i la Torre Llobeta,8015,1379,772,607
2014,8,Nou Barris,44,Vilapicina i la Torre Llobeta,8016,1147,640,507
2014,8,Nou Barris,44,Vilapicina i la Torre Llobeta,8017,1352,715,637
2014,8,Nou Barris,44,Vilapicina i la Torre Llobeta,8018,1516,822,694
2014,8,Nou Barris,44,Vilapicina i la Torre Llobeta,8019,1742,946,796
2014,8,Nou Barris,45,Porta,8020,1265,684,581
2014,8,Nou Barris,45,Porta,8021,1433,788,645
2014,8,Nou Barris,45,Porta,8022,1226,671,555
2014,8,Nou Barris,45,Porta,8023,1369,734,635
2014,8,Nou Barris,45,Porta,8024,1391,751,640
2014,8,Nou Barris,45,Porta,8025,1186,657,529
2014,8,Nou Barris,45,Porta,8026,1311,714,597
2014,8,Nou Barris,45,Porta,8027,1285,647,638
2014,8,Nou Barris,45,Porta,8028,1069,567,502
2014,8,Nou Barris,45,Porta,8029,1469,783,686
2014,8,Nou Barris,45,Porta,8030,1422,733,689
2014,8,Nou Barris,45,Porta,8031,1298,674,624
2014,8,Nou Barris,45,Porta,8032,1307,702,605
2014,8,Nou Barris,45,Porta,8033,1392,727,665
2014,8,Nou Barris,45,Porta,8034,1164,646,518
2014,8,Nou Barris,45,Porta,8035,1784,824,960
2014,8,Nou Barris,45,Porta,8036,1493,789,704
2014,8,Nou Barris,45,Porta,8037,1472,803,669
2014,8,Nou Barris,46,el Turó de la Peira,8038,1445,804,641
2014,8,Nou Barris,46,el Turó de la Peira,8039,1532,837,695
2014,8,Nou Barris,46,el Turó de la Peira,8040,1610,866,744
2014,8,Nou Barris,46,el Turó de la Peira,8041,2364,1218,1146
2014,8,Nou Barris,46,el Turó de la Peira,8042,1273,696,577
2014,8,Nou Barris,46,el Turó de la Peira,8043,1150,654,496
2014,8,Nou Barris,46,el Turó de la Peira,8044,1362,720,642
2014,8,Nou Barris,46,el Turó de la Peira,8045,1694,908,786
2014,8,Nou Barris,46,el Turó de la Peira,8046,1398,766,632
2014,8,Nou Barris,46,el Turó de la Peira,8047,1522,815,707
2014,8,Nou Barris,47,Can Peguera,8048,1042,561,481
2014,8,Nou Barris,47,Can Peguera,8049,1219,623,596
2014,8,Nou Barris,48,la Guineueta,8050,1407,746,661
2014,8,Nou Barris,48,la Guineueta,8051,1356,715,641
2014,8,Nou Barris,48,la Guineueta,8052,861,472,389
2014,8,Nou Barris,48,la Guineueta,8053,1131,589,542
2014,8,Nou Barris,48,la Guineueta,8054,1655,915,740
2014,8,Nou Barris,48,la Guineueta,8055,1855,975,880
2014,8,Nou Barris,48,la Guineueta,8056,1447,765,682
2014,8,Nou Barris,48,la Guineueta,8057,1320,719,601
2014,8,Nou Barris,48,la Guineueta,8058,1621,886,735
2014,8,Nou Barris,48,la Guineueta,8059,994,512,482
2014,8,Nou Barris,48,la Guineueta,8215,1410,767,643
2014,8,Nou Barris,49,Canyelles,8060,1195,627,568
2014,8,Nou Barris,49,Canyelles,8061,1675,847,828
2014,8,Nou Barris,49,Canyelles,8062,1235,637,598
2014,8,Nou Barris,49,Canyelles,8063,1160,610,550
2014,8,Nou Barris,49,Canyelles,8064,1715,904,811
2014,8,Nou Barris,50,les Roquetes,8065,1664,826,838
2014,8,Nou Barris,50,les Roquetes,8066,1661,829,832
2014,8,Nou Barris,50,les Roquetes,8067,1575,805,770
2014,8,Nou Barris,50,les Roquetes,8068,1803,931,872
2014,8,Nou Barris,50,les Roquetes,8069,1467,757,710
2014,8,Nou Barris,50,les Roquetes,8070,1438,759,679
2014,8,Nou Barris,50,les Roquetes,8071,1630,845,785
2014,8,Nou Barris,50,les Roquetes,8072,1177,607,570
2014,8,Nou Barris,50,les Roquetes,8073,1692,892,800
2014,8,Nou Barris,50,les Roquetes,8074,1458,756,702
2014,8,Nou Barris,51,Verdun,8075,1836,973,863
2014,8,Nou Barris,51,Verdun,8076,1530,827,703
2014,8,Nou Barris,51,Verdun,8077,1414,743,671
2014,8,Nou Barris,51,Verdun,8078,1515,812,703
2014,8,Nou Barris,51,Verdun,8079,1387,725,662
2014,8,Nou Barris,51,Verdun,8080,1418,763,655
2014,8,Nou Barris,51,Verdun,8081,1484,804,680
2014,8,Nou Barris,51,Verdun,8082,1536,841,695
2014,8,Nou Barris,52,la Prosperitat,8083,1291,679,612
2014,8,Nou Barris,52,la Prosperitat,8084,1161,621,540
2014,8,Nou Barris,52,la Prosperitat,8085,1466,753,713
2014,8,Nou Barris,52,la Prosperitat,8086,1627,883,744
2014,8,Nou Barris,52,la Prosperitat,8087,1259,676,583
2014,8,Nou Barris,52,la Prosperitat,8088,1260,654,606
2014,8,Nou Barris,52,la Prosperitat,8089,1239,654,585
2014,8,Nou Barris,52,la Prosperitat,8090,1192,628,564
2014,8,Nou Barris,52,la Prosperitat,8091,1154,567,587
2014,8,Nou Barris,52,la Prosperitat,8092,991,504,487
2014,8,Nou Barris,52,la Prosperitat,8093,1250,639,611
2014,8,Nou Barris,52,la Prosperitat,8094,1491,789,702
2014,8,Nou Barris,52,la Prosperitat,8095,1091,567,524
2014,8,Nou Barris,52,la Prosperitat,8096,1458,752,706
2014,8,Nou Barris,52,la Prosperitat,8097,1319,683,636
2014,8,Nou Barris,52,la Prosperitat,8098,1221,640,581
2014,8,Nou Barris,52,la Prosperitat,8099,1350,700,650
2014,8,Nou Barris,52,la Prosperitat,8100,1244,667,577
2014,8,Nou Barris,52,la Prosperitat,8101,1669,894,775
2014,8,Nou Barris,52,la Prosperitat,8102,1351,721,630
2014,8,Nou Barris,53,la Trinitat Nova,8103,1484,756,728
2014,8,Nou Barris,53,la Trinitat Nova,8104,1250,692,558
2014,8,Nou Barris,53,la Trinitat Nova,8105,1610,829,781
2014,8,Nou Barris,53,la Trinitat Nova,8106,1231,656,575
2014,8,Nou Barris,53,la Trinitat Nova,8107,1815,937,878
2014,8,Nou Barris,54,Torre Baró,8108,1552,792,760
2014,8,Nou Barris,54,Torre Baró,8109,1003,491,512
2014,8,Nou Barris,55,Ciutat Meridiana,8110,1827,899,928
2014,8,Nou Barris,55,Ciutat Meridiana,8111,1519,784,735
2014,8,Nou Barris,55,Ciutat Meridiana,8112,1647,818,829
2014,8,Nou Barris,55,Ciutat Meridiana,8113,1692,839,853
2014,8,Nou Barris,55,Ciutat Meridiana,8114,1878,944,934
2014,8,Nou Barris,55,Ciutat Meridiana,8115,1611,817,794
2014,8,Nou Barris,56,Vallbona,8116,1310,669,641
2014,9,Sant Andreu,57,la Trinitat Vella,9001,2666,1241,1425
2014,9,Sant Andreu,57,la Trinitat Vella,9002,2225,1033,1192
2014,9,Sant Andreu,57,la Trinitat Vella,9003,2057,1003,1054
2014,9,Sant Andreu,57,la Trinitat Vella,9004,1727,878,849
2014,9,Sant Andreu,57,la Trinitat Vella,9005,1572,782,790
2014,9,Sant Andreu,58,Baró de Viver,9006,1221,629,592
2014,9,Sant Andreu,58,Baró de Viver,9007,1258,651,607
2014,9,Sant Andreu,59,el Bon Pastor,9008,1865,928,937
2014,9,Sant Andreu,59,el Bon Pastor,9009,1427,743,684
2014,9,Sant Andreu,59,el Bon Pastor,9010,1793,919,874
2014,9,Sant Andreu,59,el Bon Pastor,9011,1884,947,937
2014,9,Sant Andreu,59,el Bon Pastor,9013,1876,966,910
2014,9,Sant Andreu,59,el Bon Pastor,9014,2024,885,1139
2014,9,Sant Andreu,59,el Bon Pastor,9015,1807,919,888
2014,9,Sant Andreu,60,Sant Andreu,9016,1402,732,670
2014,9,Sant Andreu,60,Sant Andreu,9017,1462,748,714
2014,9,Sant Andreu,60,Sant Andreu,9018,1458,742,716
2014,9,Sant Andreu,60,Sant Andreu,9019,2321,1185,1136
2014,9,Sant Andreu,60,Sant Andreu,9020,1150,619,531
2014,9,Sant Andreu,60,Sant Andreu,9021,1397,739,658
2014,9,Sant Andreu,60,Sant Andreu,9022,1224,644,580
2014,9,Sant Andreu,60,Sant Andreu,9023,1186,622,564
2014,9,Sant Andreu,60,Sant Andreu,9024,1154,617,537
2014,9,Sant Andreu,60,Sant Andreu,9025,1147,619,528
2014,9,Sant Andreu,60,Sant Andreu,9026,1552,820,732
2014,9,Sant Andreu,60,Sant Andreu,9027,1375,706,669
2014,9,Sant Andreu,60,Sant Andreu,9028,1596,819,777
2014,9,Sant Andreu,60,Sant Andreu,9029,1169,598,571
2014,9,Sant Andreu,60,Sant Andreu,9030,1472,790,682
2014,9,Sant Andreu,60,Sant Andreu,9031,1169,612,557
2014,9,Sant Andreu,60,Sant Andreu,9032,1714,899,815
2014,9,Sant Andreu,60,Sant Andreu,9033,3084,1590,1494
2014,9,Sant Andreu,60,Sant Andreu,9034,1425,749,676
2014,9,Sant Andreu,60,Sant Andreu,9035,1574,830,744
2014,9,Sant Andreu,60,Sant Andreu,9036,1468,789,679
2014,9,Sant Andreu,60,Sant Andreu,9037,1397,773,624
2014,9,Sant Andreu,60,Sant Andreu,9038,1581,840,741
2014,9,Sant Andreu,60,Sant Andreu,9039,1519,790,729
2014,9,Sant Andreu,60,Sant Andreu,9040,1508,833,675
2014,9,Sant Andreu,60,Sant Andreu,9041,1413,772,641
2014,9,Sant Andreu,60,Sant Andreu,9042,1260,671,589
2014,9,Sant Andreu,60,Sant Andreu,9043,1315,700,615
2014,9,Sant Andreu,60,Sant Andreu,9044,1461,768,693
2014,9,Sant Andreu,60,Sant Andreu,9045,1407,736,671
2014,9,Sant Andreu,60,Sant Andreu,9046,1281,678,603
2014,9,Sant Andreu,60,Sant Andreu,9047,1428,763,665
2014,9,Sant Andreu,60,Sant Andreu,9048,1353,714,639
2014,9,Sant Andreu,60,Sant Andreu,9049,1218,667,551
2014,9,Sant Andreu,60,Sant Andreu,9050,1573,837,736
2014,9,Sant Andreu,60,Sant Andreu,9051,1195,629,566
2014,9,Sant Andreu,60,Sant Andreu,9052,1208,634,574
2014,9,Sant Andreu,60,Sant Andreu,9053,1496,810,686
2014,9,Sant Andreu,60,Sant Andreu,9054,1151,612,539
2014,9,Sant Andreu,61,la Sagrera,9055,1757,907,850
2014,9,Sant Andreu,61,la Sagrera,9056,1193,637,556
2014,9,Sant Andreu,61,la Sagrera,9057,1536,827,709
2014,9,Sant Andreu,61,la Sagrera,9058,1411,755,656
2014,9,Sant Andreu,61,la Sagrera,9059,1342,686,656
2014,9,Sant Andreu,61,la Sagrera,9060,1350,722,628
2014,9,Sant Andreu,61,la Sagrera,9061,1667,874,793
2014,9,Sant Andreu,61,la Sagrera,9062,1076,543,533
2014,9,Sant Andreu,61,la Sagrera,9063,1156,595,561
2014,9,Sant Andreu,61,la Sagrera,9064,1209,649,560
2014,9,Sant Andreu,61,la Sagrera,9065,2004,1083,921
2014,9,Sant Andreu,61,la Sagrera,9066,1341,710,631
2014,9,Sant Andreu,61,la Sagrera,9067,1380,757,623
2014,9,Sant Andreu,61,la Sagrera,9068,1521,784,737
2014,9,Sant Andreu,61,la Sagrera,9069,936,534,402
2014,9,Sant Andreu,61,la Sagrera,9070,1796,962,834
2014,9,Sant Andreu,61,la Sagrera,9071,1752,946,806
2014,9,Sant Andreu,61,la Sagrera,9072,1467,804,663
2014,9,Sant Andreu,61,la Sagrera,9073,1528,812,716
2014,9,Sant Andreu,61,la Sagrera,9156,1249,667,582
2014,9,Sant Andreu,62,el Congrés i els Indians,9074,1571,869,702
2014,9,Sant Andreu,62,el Congrés i els Indians,9075,1507,838,669
2014,9,Sant Andreu,62,el Congrés i els Indians,9076,1362,765,597
2014,9,Sant Andreu,62,el Congrés i els Indians,9077,1532,859,673
2014,9,Sant Andreu,62,el Congrés i els Indians,9078,1478,779,699
2014,9,Sant Andreu,62,el Congrés i els Indians,9079,1561,835,726
2014,9,Sant Andreu,62,el Congrés i els Indians,9080,1338,697,641
2014,9,Sant Andreu,62,el Congrés i els Indians,9081,1739,950,789
2014,9,Sant Andreu,62,el Congrés i els Indians,9082,1835,992,843
2014,9,Sant Andreu,63,Navas,9083,1562,836,726
2014,9,Sant Andreu,63,Navas,9084,1665,880,785
2014,9,Sant Andreu,63,Navas,9085,1600,867,733
2014,9,Sant Andreu,63,Navas,9086,1406,767,639
2014,9,Sant Andreu,63,Navas,9087,1243,667,576
2014,9,Sant Andreu,63,Navas,9088,1867,1009,858
2014,9,Sant Andreu,63,Navas,9089,1482,831,651
2014,9,Sant Andreu,63,Navas,9090,1614,861,753
2014,9,Sant Andreu,63,Navas,9091,1841,974,867
2014,9,Sant Andreu,63,Navas,9092,1945,1023,922
2014,9,Sant Andreu,63,Navas,9093,1374,722,652
2014,9,Sant Andreu,63,Navas,9094,2031,1065,966
2014,9,Sant Andreu,63,Navas,9095,2109,1126,983
2014,10,Sant Martí,64,Camp de l'Arpa del Clot,10001,1621,846,775
2014,10,Sant Martí,64,Camp de l'Arpa del Clot,10002,1694,895,799
2014,10,Sant Martí,64,Camp de l'Arpa del Clot,10003,1536,794,742
2014,10,Sant Martí,64,Camp de l'Arpa del Clot,10004,1476,805,671
2014,10,Sant Martí,64,Camp de l'Arpa del Clot,10005,1613,861,752
2014,10,Sant Martí,64,Camp de l'Arpa del Clot,10006,1718,942,776
2014,10,Sant Martí,64,Camp de l'Arpa del Clot,10007,1318,678,640
2014,10,Sant Martí,64,Camp de l'Arpa del Clot,10008,1661,897,764
2014,10,Sant Martí,64,Camp de l'Arpa del Clot,10009,1606,865,741
2014,10,Sant Martí,64,Camp de l'Arpa del Clot,10010,1687,921,766
2014,10,Sant Martí,64,Camp de l'Arpa del Clot,10011,1224,668,556
2014,10,Sant Martí,64,Camp de l'Arpa del Clot,10012,1818,942,876
2014,10,Sant Martí,64,Camp de l'Arpa del Clot,10013,1372,736,636
2014,10,Sant Martí,64,Camp de l'Arpa del Clot,10014,1399,754,645
2014,10,Sant Martí,64,Camp de l'Arpa del Clot,10015,1769,930,839
2014,10,Sant Martí,64,Camp de l'Arpa del Clot,10016,1303,690,613
2014,10,Sant Martí,64,Camp de l'Arpa del Clot,10017,1677,904,773
2014,10,Sant Martí,64,Camp de l'Arpa del Clot,10018,1378,706,672
2014,10,Sant Martí,64,Camp de l'Arpa del Clot,10019,1601,865,736
2014,10,Sant Martí,64,Camp de l'Arpa del Clot,10020,1486,791,695
2014,10,Sant Martí,64,Camp de l'Arpa del Clot,10021,1331,679,652
2014,10,Sant Martí,64,Camp de l'Arpa del Clot,10022,1297,685,612
2014,10,Sant Martí,64,Camp de l'Arpa del Clot,10023,1426,755,671
2014,10,Sant Martí,64,Camp de l'Arpa del Clot,10024,1446,768,678
2014,10,Sant Martí,64,Camp de l'Arpa del Clot,10025,1339,719,620
2014,10,Sant Martí,65,el Clot,10026,1550,823,727
2014,10,Sant Martí,65,el Clot,10027,1532,800,732
2014,10,Sant Martí,65,el Clot,10028,1776,913,863
2014,10,Sant Martí,65,el Clot,10029,1481,759,722
2014,10,Sant Martí,65,el Clot,10030,1728,917,811
2014,10,Sant Martí,65,el Clot,10031,1549,802,747
2014,10,Sant Martí,65,el Clot,10032,1477,760,717
2014,10,Sant Martí,65,el Clot,10033,915,509,406
2014,10,Sant Martí,65,el Clot,10034,1715,861,854
2014,10,Sant Martí,65,el Clot,10035,2043,1032,1011
2014,10,Sant Martí,65,el Clot,10036,1457,721,736
2014,10,Sant Martí,65,el Clot,10037,1064,538,526
2014,10,Sant Martí,65,el Clot,10038,1664,849,815
2014,10,Sant Martí,65,el Clot,10039,1765,937,828
2014,10,Sant Martí,65,el Clot,10040,1842,971,871
2014,10,Sant Martí,65,el Clot,10041,1539,781,758
2014,10,Sant Martí,65,el Clot,10234,1938,1037,901
2014,10,Sant Martí,66,el Parc i la Llacuna del Poblenou,10042,2292,1191,1101
2014,10,Sant Martí,66,el Parc i la Llacuna del Poblenou,10043,1784,883,901
2014,10,Sant Martí,66,el Parc i la Llacuna del Poblenou,10044,1505,772,733
2014,10,Sant Martí,66,el Parc i la Llacuna del Poblenou,10045,1277,692,585
2014,10,Sant Martí,66,el Parc i la Llacuna del Poblenou,10046,1240,639,601
2014,10,Sant Martí,66,el Parc i la Llacuna del Poblenou,10047,1857,942,915
2014,10,Sant Martí,66,el Parc i la Llacuna del Poblenou,10048,1655,866,789
2014,10,Sant Martí,66,el Parc i la Llacuna del Poblenou,10049,1321,688,633
2014,10,Sant Martí,66,el Parc i la Llacuna del Poblenou,10050,1686,904,782
2014,10,Sant Martí,67,la Vila Olímpica del Poblenou,10051,1595,830,765
2014,10,Sant Martí,67,la Vila Olímpica del Poblenou,10052,2354,1193,1161
2014,10,Sant Martí,67,la Vila Olímpica del Poblenou,10053,1832,927,905
2014,10,Sant Martí,67,la Vila Olímpica del Poblenou,10054,989,520,469
2014,10,Sant Martí,67,la Vila Olímpica del Poblenou,10055,2597,1316,1281
2014,10,Sant Martí,68,el Poblenou,10056,1811,892,919
2014,10,Sant Martí,68,el Poblenou,10057,1325,661,664
2014,10,Sant Martí,68,el Poblenou,10058,1103,569,534
2014,10,Sant Martí,68,el Poblenou,10059,1599,822,777
2014,10,Sant Martí,68,el Poblenou,10060,1634,808,826
2014,10,Sant Martí,68,el Poblenou,10061,1687,886,801
2014,10,Sant Martí,68,el Poblenou,10062,1546,788,758
2014,10,Sant Martí,68,el Poblenou,10063,1238,637,601
2014,10,Sant Martí,68,el Poblenou,10064,1612,825,787
2014,10,Sant Martí,68,el Poblenou,10065,1557,793,764
2014,10,Sant Martí,68,el Poblenou,10066,2083,1074,1009
2014,10,Sant Martí,68,el Poblenou,10067,1945,1024,921
2014,10,Sant Martí,68,el Poblenou,10068,1564,793,771
2014,10,Sant Martí,68,el Poblenou,10069,2106,1111,995
2014,10,Sant Martí,68,el Poblenou,10070,1647,877,770
2014,10,Sant Martí,68,el Poblenou,10071,1811,925,886
2014,10,Sant Martí,68,el Poblenou,10072,2044,1046,998
2014,10,Sant Martí,68,el Poblenou,10073,1536,801,735
2014,10,Sant Martí,68,el Poblenou,10074,1695,888,807
2014,10,Sant Martí,68,el Poblenou,10075,1476,753,723
2014,10,Sant Martí,69,Diagonal Mar i el Front Marítim del Poblenou,10076,1935,1010,925
2014,10,Sant Martí,69,Diagonal Mar i el Front Marítim del Poblenou,10077,1849,935,914
2014,10,Sant Martí,69,Diagonal Mar i el Front Marítim del Poblenou,10078,2176,1115,1061
2014,10,Sant Martí,69,Diagonal Mar i el Front Marítim del Poblenou,10079,1789,924,865
2014,10,Sant Martí,69,Diagonal Mar i el Front Marítim del Poblenou,10080,2427,1175,1252
2014,10,Sant Martí,69,Diagonal Mar i el Front Marítim del Poblenou,10235,1328,710,618
2014,10,Sant Martí,69,Diagonal Mar i el Front Marítim del Poblenou,10236,1664,875,789
2014,10,Sant Martí,70,el Besòs i el Maresme,10081,1837,925,912
2014,10,Sant Martí,70,el Besòs i el Maresme,10082,2013,925,1088
2014,10,Sant Martí,70,el Besòs i el Maresme,10083,2068,881,1187
2014,10,Sant Martí,70,el Besòs i el Maresme,10084,1642,838,804
2014,10,Sant Martí,70,el Besòs i el Maresme,10085,1992,959,1033
2014,10,Sant Martí,70,el Besòs i el Maresme,10086,1909,954,955
2014,10,Sant Martí,70,el Besòs i el Maresme,10087,1732,901,831
2014,10,Sant Martí,70,el Besòs i el Maresme,10088,1590,825,765
2014,10,Sant Martí,70,el Besòs i el Maresme,10089,2079,927,1152
2014,10,Sant Martí,70,el Besòs i el Maresme,10090,1368,699,669
2014,10,Sant Martí,70,el Besòs i el Maresme,10091,1983,1017,966
2014,10,Sant Martí,70,el Besòs i el Maresme,10092,1529,803,726
2014,10,Sant Martí,70,el Besòs i el Maresme,10093,1098,547,551
2014,10,Sant Martí,71,Provençals del Poblenou,10094,2636,1320,1316
2014,10,Sant Martí,71,Provençals del Poblenou,10095,1253,634,619
2014,10,Sant Martí,71,Provençals del Poblenou,10096,1592,847,745
2014,10,Sant Martí,71,Provençals del Poblenou,10097,1535,808,727
2014,10,Sant Martí,71,Provençals del Poblenou,10098,1891,969,922
2014,10,Sant Martí,71,Provençals del Poblenou,10099,1087,574,513
2014,10,Sant Martí,71,Provençals del Poblenou,10100,1597,842,755
2014,10,Sant Martí,71,Provençals del Poblenou,10101,1255,634,621
2014,10,Sant Martí,71,Provençals del Poblenou,10102,2573,1328,1245
2014,10,Sant Martí,71,Provençals del Poblenou,10103,2189,1143,1046
2014,10,Sant Martí,71,Provençals del Poblenou,10104,1707,872,835
2014,10,Sant Martí,71,Provençals del Poblenou,10237,783,433,350
2014,10,Sant Martí,72,Sant Martí de Provençals,10105,2220,1179,1041
2014,10,Sant Martí,72,Sant Martí de Provençals,10106,1027,529,498
2014,10,Sant Martí,72,Sant Martí de Provençals,10107,1512,788,724
2014,10,Sant Martí,72,Sant Martí de Provençals,10108,1376,730,646
2014,10,Sant Martí,72,Sant Martí de Provençals,10109,1526,838,688
2014,10,Sant Martí,72,Sant Martí de Provençals,10110,1604,895,709
2014,10,Sant Martí,72,Sant Martí de Provençals,10111,1316,673,643
2014,10,Sant Martí,72,Sant Martí de Provençals,10112,1588,808,780
2014,10,Sant Martí,72,Sant Martí de Provençals,10113,1174,618,556
2014,10,Sant Martí,72,Sant Martí de Provençals,10114,1350,728,622
2014,10,Sant Martí,72,Sant Martí de Provençals,10115,1440,742,698
2014,10,Sant Martí,72,Sant Martí de Provençals,10116,1854,973,881
2014,10,Sant Martí,72,Sant Martí de Provençals,10117,1301,693,608
2014,10,Sant Martí,72,Sant Martí de Provençals,10118,1001,533,468
2014,10,Sant Martí,72,Sant Martí de Provençals,10119,1135,609,526
2014,10,Sant Martí,72,Sant Martí de Provençals,10120,1408,801,607
2014,10,Sant Martí,72,Sant Martí de Provençals,10121,1542,819,723
2014,10,Sant Martí,72,Sant Martí de Provençals,10122,1543,796,747
2014,10,Sant Martí,73,la Verneda i la Pau,10123,1404,723,681
2014,10,Sant Martí,73,la Verneda i la Pau,10124,1130,576,554
2014,10,Sant Martí,73,la Verneda i la Pau,10125,1112,565,547
2014,10,Sant Martí,73,la Verneda i la Pau,10126,1111,582,529
2014,10,Sant Martí,73,la Verneda i la Pau,10127,998,514,484
2014,10,Sant Martí,73,la Verneda i la Pau,10128,1645,876,769
2014,10,Sant Martí,73,la Verneda i la Pau,10129,1214,615,599
2014,10,Sant Martí,73,la Verneda i la Pau,10130,1172,622,550
2014,10,Sant Martí,73,la Verneda i la Pau,10131,1168,630,538
2014,10,Sant Martí,73,la Verneda i la Pau,10132,1231,649,582
2014,10,Sant Martí,73,la Verneda i la Pau,10133,1726,906,820
2014,10,Sant Martí,73,la Verneda i la Pau,10134,1532,825,707
2014,10,Sant Martí,73,la Verneda i la Pau,10135,1212,640,572
2014,10,Sant Martí,73,la Verneda i la Pau,10136,1373,704,669
2014,10,Sant Martí,73,la Verneda i la Pau,10137,1599,831,768
2014,10,Sant Martí,73,la Verneda i la Pau,10138,1541,798,743
2014,10,Sant Martí,73,la Verneda i la Pau,10139,1614,823,791
2014,10,Sant Martí,73,la Verneda i la Pau,10140,1609,860,749
2014,10,Sant Martí,73,la Verneda i la Pau,10141,1112,591,521
2014,10,Sant Martí,73,la Verneda i la Pau,10142,1601,849,752
2014,10,Sant Martí,73,la Verneda i la Pau,10143,1704,880,824
2015,1,Ciutat Vella,1,el Raval,1001,1321,573,748
2015,1,Ciutat Vella,1,el Raval,1002,1528,683,845
2015,1,Ciutat Vella,1,el Raval,1003,3340,1540,1800
2015,1,Ciutat Vella,1,el Raval,1004,2785,1241,1544
2015,1,Ciutat Vella,1,el Raval,1005,2460,1057,1403
2015,1,Ciutat Vella,1,el Raval,1006,1560,673,887
2015,1,Ciutat Vella,1,el Raval,1007,2044,783,1261
2015,1,Ciutat Vella,1,el Raval,1008,3414,1330,2084
2015,1,Ciutat Vella,1,el Raval,1009,2175,977,1198
2015,1,Ciutat Vella,1,el Raval,1010,2359,1005,1354
2015,1,Ciutat Vella,1,el Raval,1011,3378,1440,1938
2015,1,Ciutat Vella,1,el Raval,1012,1883,915,968
2015,1,Ciutat Vella,1,el Raval,1013,1356,694,662
2015,1,Ciutat Vella,1,el Raval,1014,1986,936,1050
2015,1,Ciutat Vella,1,el Raval,1015,2303,1128,1175
2015,1,Ciutat Vella,1,el Raval,1016,2173,1079,1094
2015,1,Ciutat Vella,1,el Raval,1017,2677,1295,1382
2015,1,Ciutat Vella,1,el Raval,1018,1562,747,815
2015,1,Ciutat Vella,1,el Raval,1019,2785,1249,1536
2015,1,Ciutat Vella,1,el Raval,1020,2069,1095,974
2015,1,Ciutat Vella,1,el Raval,1021,1992,990,1002
2015,1,Ciutat Vella,2,el Barri Gòtic,1022,1184,621,563
2015,1,Ciutat Vella,2,el Barri Gòtic,1023,1949,1036,913
2015,1,Ciutat Vella,2,el Barri Gòtic,1025,1282,632,650
2015,1,Ciutat Vella,2,el Barri Gòtic,1026,2124,892,1232
2015,1,Ciutat Vella,2,el Barri Gòtic,1027,1623,769,854
2015,1,Ciutat Vella,2,el Barri Gòtic,1028,1938,922,1016
2015,1,Ciutat Vella,2,el Barri Gòtic,1029,1365,665,700
2015,1,Ciutat Vella,2,el Barri Gòtic,1030,2402,1112,1290
2015,1,Ciutat Vella,2,el Barri Gòtic,1031,1647,714,933
2015,1,Ciutat Vella,3,la Barceloneta,1032,1806,893,913
2015,1,Ciutat Vella,3,la Barceloneta,1033,1094,507,587
2015,1,Ciutat Vella,3,la Barceloneta,1034,1030,511,519
2015,1,Ciutat Vella,3,la Barceloneta,1035,1328,654,674
2015,1,Ciutat Vella,3,la Barceloneta,1036,1183,642,541
2015,1,Ciutat Vella,3,la Barceloneta,1037,1464,772,692
2015,1,Ciutat Vella,3,la Barceloneta,1038,1492,714,778
2015,1,Ciutat Vella,3,la Barceloneta,1039,1299,644,655
2015,1,Ciutat Vella,3,la Barceloneta,1040,1101,548,553
2015,1,Ciutat Vella,3,la Barceloneta,1041,1467,710,757
2015,1,Ciutat Vella,3,la Barceloneta,1042,1773,942,831
2015,1,Ciutat Vella,4,"Sant Pere, Santa Caterina i la Ribera",1043,1290,625,665
2015,1,Ciutat Vella,4,"Sant Pere, Santa Caterina i la Ribera",1044,1480,764,716
2015,1,Ciutat Vella,4,"Sant Pere, Santa Caterina i la Ribera",1045,2016,1002,1014
2015,1,Ciutat Vella,4,"Sant Pere, Santa Caterina i la Ribera",1046,1711,856,855
2015,1,Ciutat Vella,4,"Sant Pere, Santa Caterina i la Ribera",1047,1828,968,860
2015,1,Ciutat Vella,4,"Sant Pere, Santa Caterina i la Ribera",1048,2218,1068,1150
2015,1,Ciutat Vella,4,"Sant Pere, Santa Caterina i la Ribera",1049,1453,758,695
2015,1,Ciutat Vella,4,"Sant Pere, Santa Caterina i la Ribera",1050,1620,775,845
2015,1,Ciutat Vella,4,"Sant Pere, Santa Caterina i la Ribera",1051,1809,906,903
2015,1,Ciutat Vella,4,"Sant Pere, Santa Caterina i la Ribera",1052,2409,1148,1261
2015,1,Ciutat Vella,4,"Sant Pere, Santa Caterina i la Ribera",1053,2004,1020,984
2015,1,Ciutat Vella,4,"Sant Pere, Santa Caterina i la Ribera",1054,1337,663,674
2015,1,Ciutat Vella,4,"Sant Pere, Santa Caterina i la Ribera",1055,1293,685,608
2015,2,Eixample,5,el Fort Pienc,2001,1290,679,611
2015,2,Eixample,5,el Fort Pienc,2002,2202,1031,1171
2015,2,Eixample,5,el Fort Pienc,2003,1278,724,554
2015,2,Eixample,5,el Fort Pienc,2004,1492,759,733
2015,2,Eixample,5,el Fort Pienc,2005,2108,1125,983
2015,2,Eixample,5,el Fort Pienc,2006,1612,841,771
2015,2,Eixample,5,el Fort Pienc,2007,1225,708,517
2015,2,Eixample,5,el Fort Pienc,2008,1875,1011,864
2015,2,Eixample,5,el Fort Pienc,2009,1752,951,801
2015,2,Eixample,5,el Fort Pienc,2010,1167,625,542
2015,2,Eixample,5,el Fort Pienc,2011,1084,563,521
2015,2,Eixample,5,el Fort Pienc,2012,1558,784,774
2015,2,Eixample,5,el Fort Pienc,2013,1127,594,533
2015,2,Eixample,5,el Fort Pienc,2014,1317,675,642
2015,2,Eixample,5,el Fort Pienc,2015,1559,838,721
2015,2,Eixample,5,el Fort Pienc,2016,1811,996,815
2015,2,Eixample,5,el Fort Pienc,2017,1926,1038,888
2015,2,Eixample,5,el Fort Pienc,2018,1833,989,844
2015,2,Eixample,5,el Fort Pienc,2019,1939,1037,902
2015,2,Eixample,5,el Fort Pienc,2020,1393,755,638
2015,2,Eixample,6,la Sagrada Família,2021,1432,769,663
2015,2,Eixample,6,la Sagrada Família,2022,1261,651,610
2015,2,Eixample,6,la Sagrada Família,2023,1094,569,525
2015,2,Eixample,6,la Sagrada Família,2024,1129,625,504
2015,2,Eixample,6,la Sagrada Família,2025,1179,629,550
2015,2,Eixample,6,la Sagrada Família,2026,2157,1159,998
2015,2,Eixample,6,la Sagrada Família,2027,2008,1092,916
2015,2,Eixample,6,la Sagrada Família,2028,2070,1126,944
2015,2,Eixample,6,la Sagrada Família,2029,1145,615,530
2015,2,Eixample,6,la Sagrada Família,2030,1219,638,581
2015,2,Eixample,6,la Sagrada Família,2031,1085,565,520
2015,2,Eixample,6,la Sagrada Família,2032,1185,697,488
2015,2,Eixample,6,la Sagrada Família,2033,1183,651,532
2015,2,Eixample,6,la Sagrada Família,2034,1171,632,539
2015,2,Eixample,6,la Sagrada Família,2035,1265,684,581
2015,2,Eixample,6,la Sagrada Família,2036,1227,661,566
2015,2,Eixample,6,la Sagrada Família,2037,1215,624,591
2015,2,Eixample,6,la Sagrada Família,2038,1596,854,742
2015,2,Eixample,6,la Sagrada Família,2039,1726,968,758
2015,2,Eixample,6,la Sagrada Família,2040,1649,880,769
2015,2,Eixample,6,la Sagrada Família,2041,1582,872,710
2015,2,Eixample,6,la Sagrada Família,2042,1661,879,782
2015,2,Eixample,6,la Sagrada Família,2043,1447,773,674
2015,2,Eixample,6,la Sagrada Família,2044,1274,725,549
2015,2,Eixample,6,la Sagrada Família,2045,1181,639,542
2015,2,Eixample,6,la Sagrada Família,2046,1880,1028,852
2015,2,Eixample,6,la Sagrada Família,2047,1878,1010,868
2015,2,Eixample,6,la Sagrada Família,2048,1224,667,557
2015,2,Eixample,6,la Sagrada Família,2049,2044,1113,931
2015,2,Eixample,6,la Sagrada Família,2050,1559,849,710
2015,2,Eixample,6,la Sagrada Família,2051,1900,1045,855
2015,2,Eixample,6,la Sagrada Família,2052,1816,994,822
2015,2,Eixample,6,la Sagrada Família,2053,1805,974,831
2015,2,Eixample,6,la Sagrada Família,2054,1847,997,850
2015,2,Eixample,7,la Dreta de l'Eixample,2055,1858,1002,856
2015,2,Eixample,7,la Dreta de l'Eixample,2056,1504,868,636
2015,2,Eixample,7,la Dreta de l'Eixample,2057,1241,657,584
2015,2,Eixample,7,la Dreta de l'Eixample,2058,1397,767,630
2015,2,Eixample,7,la Dreta de l'Eixample,2059,1695,908,787
2015,2,Eixample,7,la Dreta de l'Eixample,2060,1675,906,769
2015,2,Eixample,7,la Dreta de l'Eixample,2061,1330,744,586
2015,2,Eixample,7,la Dreta de l'Eixample,2062,1551,836,715
2015,2,Eixample,7,la Dreta de l'Eixample,2063,1183,719,464
2015,2,Eixample,7,la Dreta de l'Eixample,2064,1367,713,654
2015,2,Eixample,7,la Dreta de l'Eixample,2065,1882,1019,863
2015,2,Eixample,7,la Dreta de l'Eixample,2066,1840,981,859
2015,2,Eixample,7,la Dreta de l'Eixample,2067,1659,907,752
2015,2,Eixample,7,la Dreta de l'Eixample,2068,1699,922,777
2015,2,Eixample,7,la Dreta de l'Eixample,2069,1380,725,655
2015,2,Eixample,7,la Dreta de l'Eixample,2070,1358,734,624
2015,2,Eixample,7,la Dreta de l'Eixample,2071,1735,889,846
2015,2,Eixample,7,la Dreta de l'Eixample,2072,1198,619,579
2015,2,Eixample,7,la Dreta de l'Eixample,2073,1641,855,786
2015,2,Eixample,7,la Dreta de l'Eixample,2074,1197,602,595
2015,2,Eixample,7,la Dreta de l'Eixample,2075,1229,661,568
2015,2,Eixample,7,la Dreta de l'Eixample,2076,1658,876,782
2015,2,Eixample,7,la Dreta de l'Eixample,2077,1484,750,734
2015,2,Eixample,7,la Dreta de l'Eixample,2078,1380,775,605
2015,2,Eixample,7,la Dreta de l'Eixample,2079,1239,662,577
2015,2,Eixample,7,la Dreta de l'Eixample,2080,1440,765,675
2015,2,Eixample,7,la Dreta de l'Eixample,2081,2097,1141,956
2015,2,Eixample,7,la Dreta de l'Eixample,2082,935,515,420
2015,2,Eixample,7,la Dreta de l'Eixample,2083,1706,954,752
2015,2,Eixample,8,l'Antiga Esquerra de l'Eixample,2084,1992,1099,893
2015,2,Eixample,8,l'Antiga Esquerra de l'Eixample,2085,1489,818,671
2015,2,Eixample,8,l'Antiga Esquerra de l'Eixample,2086,1418,785,633
2015,2,Eixample,8,l'Antiga Esquerra de l'Eixample,2087,1432,804,628
2015,2,Eixample,8,l'Antiga Esquerra de l'Eixample,2088,1645,905,740
2015,2,Eixample,8,l'Antiga Esquerra de l'Eixample,2089,1936,1025,911
2015,2,Eixample,8,l'Antiga Esquerra de l'Eixample,2090,1629,860,769
2015,2,Eixample,8,l'Antiga Esquerra de l'Eixample,2091,1818,903,915
2015,2,Eixample,8,l'Antiga Esquerra de l'Eixample,2092,1734,888,846
2015,2,Eixample,8,l'Antiga Esquerra de l'Eixample,2093,1672,839,833
2015,2,Eixample,8,l'Antiga Esquerra de l'Eixample,2094,1475,766,709
2015,2,Eixample,8,l'Antiga Esquerra de l'Eixample,2095,1515,801,714
2015,2,Eixample,8,l'Antiga Esquerra de l'Eixample,2096,1363,741,622
2015,2,Eixample,8,l'Antiga Esquerra de l'Eixample,2097,1146,612,534
2015,2,Eixample,8,l'Antiga Esquerra de l'Eixample,2098,1521,856,665
2015,2,Eixample,8,l'Antiga Esquerra de l'Eixample,2099,1485,780,705
2015,2,Eixample,8,l'Antiga Esquerra de l'Eixample,2100,1374,742,632
2015,2,Eixample,8,l'Antiga Esquerra de l'Eixample,2101,2143,1148,995
2015,2,Eixample,8,l'Antiga Esquerra de l'Eixample,2102,1390,771,619
2015,2,Eixample,8,l'Antiga Esquerra de l'Eixample,2103,1747,953,794
2015,2,Eixample,8,l'Antiga Esquerra de l'Eixample,2104,1097,596,501
2015,2,Eixample,8,l'Antiga Esquerra de l'Eixample,2105,2035,1145,890
2015,2,Eixample,8,l'Antiga Esquerra de l'Eixample,2106,1432,746,686
2015,2,Eixample,8,l'Antiga Esquerra de l'Eixample,2107,1646,909,737
2015,2,Eixample,8,l'Antiga Esquerra de l'Eixample,2108,1577,883,694
2015,2,Eixample,8,l'Antiga Esquerra de l'Eixample,2109,1951,1075,876
2015,2,Eixample,9,la Nova Esquerra de l'Eixample,2110,1873,999,874
2015,2,Eixample,9,la Nova Esquerra de l'Eixample,2111,1743,966,777
2015,2,Eixample,9,la Nova Esquerra de l'Eixample,2112,1317,716,601
2015,2,Eixample,9,la Nova Esquerra de l'Eixample,2113,1993,1050,943
2015,2,Eixample,9,la Nova Esquerra de l'Eixample,2114,1698,940,758
2015,2,Eixample,9,la Nova Esquerra de l'Eixample,2115,1370,749,621
2015,2,Eixample,9,la Nova Esquerra de l'Eixample,2116,1048,568,480
2015,2,Eixample,9,la Nova Esquerra de l'Eixample,2117,1177,629,548
2015,2,Eixample,9,la Nova Esquerra de l'Eixample,2118,1500,819,681
2015,2,Eixample,9,la Nova Esquerra de l'Eixample,2119,1297,705,592
2015,2,Eixample,9,la Nova Esquerra de l'Eixample,2120,1188,635,553
2015,2,Eixample,9,la Nova Esquerra de l'Eixample,2121,1232,663,569
2015,2,Eixample,9,la Nova Esquerra de l'Eixample,2122,1063,593,470
2015,2,Eixample,9,la Nova Esquerra de l'Eixample,2123,1128,581,547
2015,2,Eixample,9,la Nova Esquerra de l'Eixample,2124,1112,602,510
2015,2,Eixample,9,la Nova Esquerra de l'Eixample,2125,1692,944,748
2015,2,Eixample,9,la Nova Esquerra de l'Eixample,2126,1542,854,688
2015,2,Eixample,9,la Nova Esquerra de l'Eixample,2127,1108,590,518
2015,2,Eixample,9,la Nova Esquerra de l'Eixample,2128,1275,670,605
2015,2,Eixample,9,la Nova Esquerra de l'Eixample,2129,1540,823,717
2015,2,Eixample,9,la Nova Esquerra de l'Eixample,2130,1099,561,538
2015,2,Eixample,9,la Nova Esquerra de l'Eixample,2131,1212,654,558
2015,2,Eixample,9,la Nova Esquerra de l'Eixample,2132,1222,624,598
2015,2,Eixample,9,la Nova Esquerra de l'Eixample,2133,870,475,395
2015,2,Eixample,9,la Nova Esquerra de l'Eixample,2134,1412,762,650
2015,2,Eixample,9,la Nova Esquerra de l'Eixample,2135,2071,1108,963
2015,2,Eixample,9,la Nova Esquerra de l'Eixample,2136,876,475,401
2015,2,Eixample,9,la Nova Esquerra de l'Eixample,2137,1412,744,668
2015,2,Eixample,9,la Nova Esquerra de l'Eixample,2138,1905,991,914
2015,2,Eixample,9,la Nova Esquerra de l'Eixample,2139,1675,912,763
2015,2,Eixample,9,la Nova Esquerra de l'Eixample,2140,1929,1019,910
2015,2,Eixample,9,la Nova Esquerra de l'Eixample,2141,1279,705,574
2015,2,Eixample,9,la Nova Esquerra de l'Eixample,2142,2022,1085,937
2015,2,Eixample,9,la Nova Esquerra de l'Eixample,2143,1246,640,606
2015,2,Eixample,9,la Nova Esquerra de l'Eixample,2144,1484,808,676
2015,2,Eixample,9,la Nova Esquerra de l'Eixample,2145,1295,660,635
2015,2,Eixample,9,la Nova Esquerra de l'Eixample,2146,1159,618,541
2015,2,Eixample,9,la Nova Esquerra de l'Eixample,2147,2209,1201,1008
2015,2,Eixample,9,la Nova Esquerra de l'Eixample,2148,1564,839,725
2015,2,Eixample,9,la Nova Esquerra de l'Eixample,2149,1827,965,862
2015,2,Eixample,10,Sant Antoni,2150,1500,796,704
2015,2,Eixample,10,Sant Antoni,2151,1439,763,676
2015,2,Eixample,10,Sant Antoni,2152,1248,695,553
2015,2,Eixample,10,Sant Antoni,2153,1341,742,599
2015,2,Eixample,10,Sant Antoni,2154,1028,551,477
2015,2,Eixample,10,Sant Antoni,2155,1904,1037,867
2015,2,Eixample,10,Sant Antoni,2156,1276,667,609
2015,2,Eixample,10,Sant Antoni,2157,1200,634,566
2015,2,Eixample,10,Sant Antoni,2158,1631,853,778
2015,2,Eixample,10,Sant Antoni,2159,1824,957,867
2015,2,Eixample,10,Sant Antoni,2160,1987,1061,926
2015,2,Eixample,10,Sant Antoni,2161,1138,602,536
2015,2,Eixample,10,Sant Antoni,2162,1364,713,651
2015,2,Eixample,10,Sant Antoni,2163,1800,948,852
2015,2,Eixample,10,Sant Antoni,2164,1389,738,651
2015,2,Eixample,10,Sant Antoni,2165,1618,857,761
2015,2,Eixample,10,Sant Antoni,2166,2111,1114,997
2015,2,Eixample,10,Sant Antoni,2167,2086,1095,991
2015,2,Eixample,10,Sant Antoni,2168,2225,1182,1043
2015,2,Eixample,10,Sant Antoni,2169,1568,821,747
2015,2,Eixample,10,Sant Antoni,2170,1583,806,777
2015,2,Eixample,10,Sant Antoni,2171,1609,850,759
2015,2,Eixample,10,Sant Antoni,2172,1579,791,788
2015,2,Eixample,10,Sant Antoni,2173,1583,838,745
2015,3,Sants-Montjuïc,11,el Poble-sec,3001,1653,883,770
2015,3,Sants-Montjuïc,11,el Poble-sec,3002,2047,1062,985
2015,3,Sants-Montjuïc,11,el Poble-sec,3003,1708,886,822
2015,3,Sants-Montjuïc,11,el Poble-sec,3004,1552,817,735
2015,3,Sants-Montjuïc,11,el Poble-sec,3005,1232,648,584
2015,3,Sants-Montjuïc,11,el Poble-sec,3006,1375,686,689
2015,3,Sants-Montjuïc,11,el Poble-sec,3007,1728,884,844
2015,3,Sants-Montjuïc,11,el Poble-sec,3008,1234,636,598
2015,3,Sants-Montjuïc,11,el Poble-sec,3009,1227,658,569
2015,3,Sants-Montjuïc,11,el Poble-sec,3010,1822,915,907
2015,3,Sants-Montjuïc,11,el Poble-sec,3011,1815,914,901
2015,3,Sants-Montjuïc,11,el Poble-sec,3012,2175,1134,1041
2015,3,Sants-Montjuïc,11,el Poble-sec,3013,1910,920,990
2015,3,Sants-Montjuïc,11,el Poble-sec,3014,1831,873,958
2015,3,Sants-Montjuïc,11,el Poble-sec,3015,3021,1530,1491
2015,3,Sants-Montjuïc,11,el Poble-sec,3016,1248,626,622
2015,3,Sants-Montjuïc,11,el Poble-sec,3017,1696,814,882
2015,3,Sants-Montjuïc,11,el Poble-sec,3018,1716,871,845
2015,3,Sants-Montjuïc,11,el Poble-sec,3019,1453,763,690
2015,3,Sants-Montjuïc,11,el Poble-sec,3020,1207,592,615
2015,3,Sants-Montjuïc,11,el Poble-sec,3021,1151,620,531
2015,3,Sants-Montjuïc,11,el Poble-sec,3022,1441,729,712
2015,3,Sants-Montjuïc,11,el Poble-sec,3023,1984,960,1024
2015,3,Sants-Montjuïc,11,el Poble-sec,3024,1996,1004,992
2015,3,Sants-Montjuïc,12,la Marina del Prat Vermell,3025,1122,554,568
2015,3,Sants-Montjuïc,13,la Marina de Port,3026,1006,509,497
2015,3,Sants-Montjuïc,13,la Marina de Port,3027,1769,913,856
2015,3,Sants-Montjuïc,13,la Marina de Port,3028,2283,1179,1104
2015,3,Sants-Montjuïc,13,la Marina de Port,3029,1251,672,579
2015,3,Sants-Montjuïc,13,la Marina de Port,3030,1569,841,728
2015,3,Sants-Montjuïc,13,la Marina de Port,3031,2457,1281,1176
2015,3,Sants-Montjuïc,13,la Marina de Port,3032,1556,805,751
2015,3,Sants-Montjuïc,13,la Marina de Port,3033,1409,705,704
2015,3,Sants-Montjuïc,13,la Marina de Port,3034,1551,800,751
2015,3,Sants-Montjuïc,13,la Marina de Port,3035,2301,1190,1111
2015,3,Sants-Montjuïc,13,la Marina de Port,3036,2369,1223,1146
2015,3,Sants-Montjuïc,13,la Marina de Port,3037,1108,571,537
2015,3,Sants-Montjuïc,13,la Marina de Port,3038,1014,531,483
2015,3,Sants-Montjuïc,13,la Marina de Port,3039,2391,1209,1182
2015,3,Sants-Montjuïc,13,la Marina de Port,3211,1421,718,703
2015,3,Sants-Montjuïc,13,la Marina de Port,3212,2440,1313,1127
2015,3,Sants-Montjuïc,13,la Marina de Port,3213,2342,1186,1156
2015,3,Sants-Montjuïc,14,la Font de la Guatlla,3040,1522,797,725
2015,3,Sants-Montjuïc,14,la Font de la Guatlla,3041,1335,719,616
2015,3,Sants-Montjuïc,14,la Font de la Guatlla,3042,1394,719,675
2015,3,Sants-Montjuïc,14,la Font de la Guatlla,3043,1660,894,766
2015,3,Sants-Montjuïc,14,la Font de la Guatlla,3044,1928,1018,910
2015,3,Sants-Montjuïc,14,la Font de la Guatlla,3045,1079,555,524
2015,3,Sants-Montjuïc,14,la Font de la Guatlla,3046,1453,779,674
2015,3,Sants-Montjuïc,15,Hostafrancs,3047,1801,941,860
2015,3,Sants-Montjuïc,15,Hostafrancs,3048,1376,725,651
2015,3,Sants-Montjuïc,15,Hostafrancs,3049,1679,888,791
2015,3,Sants-Montjuïc,15,Hostafrancs,3050,1577,825,752
2015,3,Sants-Montjuïc,15,Hostafrancs,3051,1800,926,874
2015,3,Sants-Montjuïc,15,Hostafrancs,3052,1259,639,620
2015,3,Sants-Montjuïc,15,Hostafrancs,3053,2067,1058,1009
2015,3,Sants-Montjuïc,15,Hostafrancs,3054,1814,952,862
2015,3,Sants-Montjuïc,15,Hostafrancs,3055,1555,811,744
2015,3,Sants-Montjuïc,15,Hostafrancs,3056,830,454,376
2015,3,Sants-Montjuïc,16,la Bordeta,3057,1517,824,693
2015,3,Sants-Montjuïc,16,la Bordeta,3058,1336,764,572
2015,3,Sants-Montjuïc,16,la Bordeta,3059,1180,600,580
2015,3,Sants-Montjuïc,16,la Bordeta,3060,1331,703,628
2015,3,Sants-Montjuïc,16,la Bordeta,3061,1093,583,510
2015,3,Sants-Montjuïc,16,la Bordeta,3062,1648,876,772
2015,3,Sants-Montjuïc,16,la Bordeta,3063,1298,668,630
2015,3,Sants-Montjuïc,16,la Bordeta,3064,1254,670,584
2015,3,Sants-Montjuïc,16,la Bordeta,3065,1390,706,684
2015,3,Sants-Montjuïc,16,la Bordeta,3066,2310,1191,1119
2015,3,Sants-Montjuïc,16,la Bordeta,3067,1690,892,798
2015,3,Sants-Montjuïc,16,la Bordeta,3068,1164,616,548
2015,3,Sants-Montjuïc,16,la Bordeta,3069,1173,606,567
2015,3,Sants-Montjuïc,17,Sants - Badal,3070,1290,659,631
2015,3,Sants-Montjuïc,17,Sants - Badal,3071,1306,688,618
2015,3,Sants-Montjuïc,17,Sants - Badal,3072,1399,764,635
2015,3,Sants-Montjuïc,17,Sants - Badal,3073,1563,836,727
2015,3,Sants-Montjuïc,17,Sants - Badal,3074,1783,961,822
2015,3,Sants-Montjuïc,17,Sants - Badal,3075,1625,863,762
2015,3,Sants-Montjuïc,17,Sants - Badal,3076,985,500,485
2015,3,Sants-Montjuïc,17,Sants - Badal,3077,1336,721,615
2015,3,Sants-Montjuïc,17,Sants - Badal,3078,1646,843,803
2015,3,Sants-Montjuïc,17,Sants - Badal,3079,1810,939,871
2015,3,Sants-Montjuïc,17,Sants - Badal,3080,1523,832,691
2015,3,Sants-Montjuïc,17,Sants - Badal,3081,1878,1010,868
2015,3,Sants-Montjuïc,17,Sants - Badal,3082,1836,970,866
2015,3,Sants-Montjuïc,17,Sants - Badal,3083,1407,754,653
2015,3,Sants-Montjuïc,17,Sants - Badal,3084,1441,772,669
2015,3,Sants-Montjuïc,17,Sants - Badal,3085,1188,626,562
2015,3,Sants-Montjuïc,18,Sants,3086,1257,650,607
2015,3,Sants-Montjuïc,18,Sants,3087,1461,794,667
2015,3,Sants-Montjuïc,18,Sants,3088,1442,765,677
2015,3,Sants-Montjuïc,18,Sants,3089,1203,646,557
2015,3,Sants-Montjuïc,18,Sants,3090,1055,563,492
2015,3,Sants-Montjuïc,18,Sants,3091,1442,759,683
2015,3,Sants-Montjuïc,18,Sants,3092,1295,661,634
2015,3,Sants-Montjuïc,18,Sants,3093,1570,813,757
2015,3,Sants-Montjuïc,18,Sants,3094,1168,639,529
2015,3,Sants-Montjuïc,18,Sants,3095,1640,896,744
2015,3,Sants-Montjuïc,18,Sants,3096,1532,796,736
2015,3,Sants-Montjuïc,18,Sants,3097,1600,830,770
2015,3,Sants-Montjuïc,18,Sants,3098,1357,697,660
2015,3,Sants-Montjuïc,18,Sants,3099,1030,564,466
2015,3,Sants-Montjuïc,18,Sants,3100,1255,653,602
2015,3,Sants-Montjuïc,18,Sants,3101,1770,830,940
2015,3,Sants-Montjuïc,18,Sants,3102,1327,696,631
2015,3,Sants-Montjuïc,18,Sants,3103,1195,638,557
2015,3,Sants-Montjuïc,18,Sants,3104,1431,748,683
2015,3,Sants-Montjuïc,18,Sants,3105,1138,597,541
2015,3,Sants-Montjuïc,18,Sants,3106,1275,703,572
2015,3,Sants-Montjuïc,18,Sants,3107,1525,776,749
2015,3,Sants-Montjuïc,18,Sants,3108,1592,857,735
2015,3,Sants-Montjuïc,18,Sants,3109,1459,764,695
2015,3,Sants-Montjuïc,18,Sants,3110,1495,796,699
2015,3,Sants-Montjuïc,18,Sants,3111,1303,699,604
2015,3,Sants-Montjuïc,18,Sants,3112,1862,998,864
2015,3,Sants-Montjuïc,18,Sants,3113,1612,854,758
2015,3,Sants-Montjuïc,18,Sants,3114,1412,771,641
2015,4,Les Corts,19,les Corts,4001,1222,655,567
2015,4,Les Corts,19,les Corts,4002,1879,974,905
2015,4,Les Corts,19,les Corts,4003,1083,550,533
2015,4,Les Corts,19,les Corts,4004,1022,554,468
2015,4,Les Corts,19,les Corts,4005,1223,649,574
2015,4,Les Corts,19,les Corts,4006,1161,625,536
2015,4,Les Corts,19,les Corts,4007,1065,609,456
2015,4,Les Corts,19,les Corts,4008,1028,550,478
2015,4,Les Corts,19,les Corts,4009,1410,765,645
2015,4,Les Corts,19,les Corts,4010,948,503,445
2015,4,Les Corts,19,les Corts,4011,1669,881,788
2015,4,Les Corts,19,les Corts,4012,1408,766,642
2015,4,Les Corts,19,les Corts,4013,1243,680,563
2015,4,Les Corts,19,les Corts,4014,764,420,344
2015,4,Les Corts,19,les Corts,4015,1894,1026,868
2015,4,Les Corts,19,les Corts,4016,1115,589,526
2015,4,Les Corts,19,les Corts,4017,1103,606,497
2015,4,Les Corts,19,les Corts,4018,1574,871,703
2015,4,Les Corts,19,les Corts,4019,1297,710,587
2015,4,Les Corts,19,les Corts,4020,1419,776,643
2015,4,Les Corts,19,les Corts,4021,1252,689,563
2015,4,Les Corts,19,les Corts,4022,1524,806,718
2015,4,Les Corts,19,les Corts,4023,1093,579,514
2015,4,Les Corts,19,les Corts,4024,1070,558,512
2015,4,Les Corts,19,les Corts,4025,1198,633,565
2015,4,Les Corts,19,les Corts,4026,1341,729,612
2015,4,Les Corts,19,les Corts,4027,1227,668,559
2015,4,Les Corts,19,les Corts,4028,1347,709,638
2015,4,Les Corts,19,les Corts,4029,1164,625,539
2015,4,Les Corts,19,les Corts,4030,1795,963,832
2015,4,Les Corts,19,les Corts,4031,1830,860,970
2015,4,Les Corts,19,les Corts,4032,1545,848,697
2015,4,Les Corts,19,les Corts,4033,1181,636,545
2015,4,Les Corts,19,les Corts,4034,1491,796,695
2015,4,Les Corts,19,les Corts,4035,1418,775,643
2015,4,Les Corts,20,la Maternitat i Sant Ramon,4036,1722,957,765
2015,4,Les Corts,20,la Maternitat i Sant Ramon,4037,2109,1135,974
2015,4,Les Corts,20,la Maternitat i Sant Ramon,4038,1279,688,591
2015,4,Les Corts,20,la Maternitat i Sant Ramon,4039,1205,646,559
2015,4,Les Corts,20,la Maternitat i Sant Ramon,4040,1594,850,744
2015,4,Les Corts,20,la Maternitat i Sant Ramon,4041,1315,708,607
2015,4,Les Corts,20,la Maternitat i Sant Ramon,4042,1722,917,805
2015,4,Les Corts,20,la Maternitat i Sant Ramon,4043,1657,901,756
2015,4,Les Corts,20,la Maternitat i Sant Ramon,4044,1602,829,773
2015,4,Les Corts,20,la Maternitat i Sant Ramon,4045,1409,747,662
2015,4,Les Corts,20,la Maternitat i Sant Ramon,4046,2437,1242,1195
2015,4,Les Corts,20,la Maternitat i Sant Ramon,4047,1664,870,794
2015,4,Les Corts,20,la Maternitat i Sant Ramon,4048,1561,835,726
2015,4,Les Corts,20,la Maternitat i Sant Ramon,4049,1155,617,538
2015,4,Les Corts,20,la Maternitat i Sant Ramon,4084,1379,745,634
2015,4,Les Corts,21,Pedralbes,4050,2038,1096,942
2015,4,Les Corts,21,Pedralbes,4051,1594,861,733
2015,4,Les Corts,21,Pedralbes,4052,2174,1175,999
2015,4,Les Corts,21,Pedralbes,4053,1555,816,739
2015,4,Les Corts,21,Pedralbes,4054,1088,569,519
2015,4,Les Corts,21,Pedralbes,4055,1545,796,749
2015,4,Les Corts,21,Pedralbes,4056,1722,928,794
2015,5,Sarrià-Sant Gervasi,22,"Vallvidrera, el Tibidabo i les Planes",5001,1634,824,810
2015,5,Sarrià-Sant Gervasi,22,"Vallvidrera, el Tibidabo i les Planes",5002,1597,836,761
2015,5,Sarrià-Sant Gervasi,22,"Vallvidrera, el Tibidabo i les Planes",5003,1373,695,678
2015,5,Sarrià-Sant Gervasi,23,Sarrià,5004,1116,645,471
2015,5,Sarrià-Sant Gervasi,23,Sarrià,5005,1084,554,530
2015,5,Sarrià-Sant Gervasi,23,Sarrià,5006,1779,891,888
2015,5,Sarrià-Sant Gervasi,23,Sarrià,5007,1603,831,772
2015,5,Sarrià-Sant Gervasi,23,Sarrià,5008,1587,854,733
2015,5,Sarrià-Sant Gervasi,23,Sarrià,5009,1747,955,792
2015,5,Sarrià-Sant Gervasi,23,Sarrià,5010,1617,877,740
2015,5,Sarrià-Sant Gervasi,23,Sarrià,5011,1395,761,634
2015,5,Sarrià-Sant Gervasi,23,Sarrià,5012,1430,788,642
2015,5,Sarrià-Sant Gervasi,23,Sarrià,5013,1719,898,821
2015,5,Sarrià-Sant Gervasi,23,Sarrià,5014,1659,876,783
2015,5,Sarrià-Sant Gervasi,23,Sarrià,5015,1573,847,726
2015,5,Sarrià-Sant Gervasi,23,Sarrià,5016,1869,1003,866
2015,5,Sarrià-Sant Gervasi,23,Sarrià,5017,1600,851,749
2015,5,Sarrià-Sant Gervasi,23,Sarrià,5018,1206,653,553
2015,5,Sarrià-Sant Gervasi,23,Sarrià,5019,1656,878,778
2015,5,Sarrià-Sant Gervasi,24,les Tres Torres,5020,1086,597,489
2015,5,Sarrià-Sant Gervasi,24,les Tres Torres,5021,1275,681,594
2015,5,Sarrià-Sant Gervasi,24,les Tres Torres,5022,1722,969,753
2015,5,Sarrià-Sant Gervasi,24,les Tres Torres,5023,1494,820,674
2015,5,Sarrià-Sant Gervasi,24,les Tres Torres,5024,1899,1032,867
2015,5,Sarrià-Sant Gervasi,24,les Tres Torres,5025,1566,809,757
2015,5,Sarrià-Sant Gervasi,24,les Tres Torres,5026,1410,736,674
2015,5,Sarrià-Sant Gervasi,24,les Tres Torres,5027,1349,695,654
2015,5,Sarrià-Sant Gervasi,24,les Tres Torres,5028,1550,798,752
2015,5,Sarrià-Sant Gervasi,24,les Tres Torres,5029,1714,888,826
2015,5,Sarrià-Sant Gervasi,24,les Tres Torres,5030,1436,762,674
2015,5,Sarrià-Sant Gervasi,25,Sant Gervasi - la Bonanova,5031,1612,870,742
2015,5,Sarrià-Sant Gervasi,25,Sant Gervasi - la Bonanova,5032,1728,950,778
2015,5,Sarrià-Sant Gervasi,25,Sant Gervasi - la Bonanova,5033,1375,742,633
2015,5,Sarrià-Sant Gervasi,25,Sant Gervasi - la Bonanova,5034,1164,663,501
2015,5,Sarrià-Sant Gervasi,25,Sant Gervasi - la Bonanova,5035,1089,556,533
2015,5,Sarrià-Sant Gervasi,25,Sant Gervasi - la Bonanova,5036,1680,884,796
2015,5,Sarrià-Sant Gervasi,25,Sant Gervasi - la Bonanova,5037,1399,788,611
2015,5,Sarrià-Sant Gervasi,25,Sant Gervasi - la Bonanova,5038,1233,662,571
2015,5,Sarrià-Sant Gervasi,25,Sant Gervasi - la Bonanova,5039,1538,836,702
2015,5,Sarrià-Sant Gervasi,25,Sant Gervasi - la Bonanova,5040,1428,774,654
2015,5,Sarrià-Sant Gervasi,25,Sant Gervasi - la Bonanova,5041,1916,970,946
2015,5,Sarrià-Sant Gervasi,25,Sant Gervasi - la Bonanova,5042,1264,670,594
2015,5,Sarrià-Sant Gervasi,25,Sant Gervasi - la Bonanova,5043,1397,746,651
2015,5,Sarrià-Sant Gervasi,25,Sant Gervasi - la Bonanova,5044,1288,704,584
2015,5,Sarrià-Sant Gervasi,25,Sant Gervasi - la Bonanova,5045,1529,840,689
2015,5,Sarrià-Sant Gervasi,25,Sant Gervasi - la Bonanova,5046,1165,649,516
2015,5,Sarrià-Sant Gervasi,25,Sant Gervasi - la Bonanova,5047,1284,693,591
2015,5,Sarrià-Sant Gervasi,25,Sant Gervasi - la Bonanova,5048,1279,705,574
2015,5,Sarrià-Sant Gervasi,26,Sant Gervasi - Galvany,5049,1627,884,743
2015,5,Sarrià-Sant Gervasi,26,Sant Gervasi - Galvany,5050,1628,880,748
2015,5,Sarrià-Sant Gervasi,26,Sant Gervasi - Galvany,5051,1626,852,774
2015,5,Sarrià-Sant Gervasi,26,Sant Gervasi - Galvany,5052,1524,846,678
2015,5,Sarrià-Sant Gervasi,26,Sant Gervasi - Galvany,5053,1467,789,678
2015,5,Sarrià-Sant Gervasi,26,Sant Gervasi - Galvany,5054,1032,575,457
2015,5,Sarrià-Sant Gervasi,26,Sant Gervasi - Galvany,5055,1440,756,684
2015,5,Sarrià-Sant Gervasi,26,Sant Gervasi - Galvany,5056,1213,715,498
2015,5,Sarrià-Sant Gervasi,26,Sant Gervasi - Galvany,5057,1716,911,805
2015,5,Sarrià-Sant Gervasi,26,Sant Gervasi - Galvany,5058,1584,858,726
2015,5,Sarrià-Sant Gervasi,26,Sant Gervasi - Galvany,5059,1588,894,694
2015,5,Sarrià-Sant Gervasi,26,Sant Gervasi - Galvany,5060,1092,602,490
2015,5,Sarrià-Sant Gervasi,26,Sant Gervasi - Galvany,5061,1427,788,639
2015,5,Sarrià-Sant Gervasi,26,Sant Gervasi - Galvany,5062,1594,891,703
2015,5,Sarrià-Sant Gervasi,26,Sant Gervasi - Galvany,5063,1567,865,702
2015,5,Sarrià-Sant Gervasi,26,Sant Gervasi - Galvany,5064,1601,888,713
2015,5,Sarrià-Sant Gervasi,26,Sant Gervasi - Galvany,5065,1658,926,732
2015,5,Sarrià-Sant Gervasi,26,Sant Gervasi - Galvany,5066,1191,667,524
2015,5,Sarrià-Sant Gervasi,26,Sant Gervasi - Galvany,5067,1291,705,586
2015,5,Sarrià-Sant Gervasi,26,Sant Gervasi - Galvany,5068,1457,783,674
2015,5,Sarrià-Sant Gervasi,26,Sant Gervasi - Galvany,5069,1714,936,778
2015,5,Sarrià-Sant Gervasi,26,Sant Gervasi - Galvany,5070,1458,816,642
2015,5,Sarrià-Sant Gervasi,26,Sant Gervasi - Galvany,5071,1573,856,717
2015,5,Sarrià-Sant Gervasi,26,Sant Gervasi - Galvany,5072,1634,921,713
2015,5,Sarrià-Sant Gervasi,26,Sant Gervasi - Galvany,5073,1628,892,736
2015,5,Sarrià-Sant Gervasi,26,Sant Gervasi - Galvany,5074,1714,924,790
2015,5,Sarrià-Sant Gervasi,26,Sant Gervasi - Galvany,5075,1689,961,728
2015,5,Sarrià-Sant Gervasi,26,Sant Gervasi - Galvany,5076,1328,720,608
2015,5,Sarrià-Sant Gervasi,26,Sant Gervasi - Galvany,5077,1405,787,618
2015,5,Sarrià-Sant Gervasi,26,Sant Gervasi - Galvany,5078,2010,1079,931
2015,5,Sarrià-Sant Gervasi,26,Sant Gervasi - Galvany,5079,1235,691,544
2015,5,Sarrià-Sant Gervasi,27,el Putget i Farró,5080,1324,748,576
2015,5,Sarrià-Sant Gervasi,27,el Putget i Farró,5081,1515,852,663
2015,5,Sarrià-Sant Gervasi,27,el Putget i Farró,5082,1645,894,751
2015,5,Sarrià-Sant Gervasi,27,el Putget i Farró,5083,1304,700,604
2015,5,Sarrià-Sant Gervasi,27,el Putget i Farró,5084,1381,779,602
2015,5,Sarrià-Sant Gervasi,27,el Putget i Farró,5085,1313,689,624
2015,5,Sarrià-Sant Gervasi,27,el Putget i Farró,5086,1331,726,605
2015,5,Sarrià-Sant Gervasi,27,el Putget i Farró,5087,1514,847,667
2015,5,Sarrià-Sant Gervasi,27,el Putget i Farró,5088,1764,902,862
2015,5,Sarrià-Sant Gervasi,27,el Putget i Farró,5089,1666,887,779
2015,5,Sarrià-Sant Gervasi,27,el Putget i Farró,5090,1842,969,873
2015,5,Sarrià-Sant Gervasi,27,el Putget i Farró,5091,1515,860,655
2015,5,Sarrià-Sant Gervasi,27,el Putget i Farró,5092,1504,840,664
2015,5,Sarrià-Sant Gervasi,27,el Putget i Farró,5093,1137,631,506
2015,5,Sarrià-Sant Gervasi,27,el Putget i Farró,5094,2533,1406,1127
2015,5,Sarrià-Sant Gervasi,27,el Putget i Farró,5095,1602,900,702
2015,5,Sarrià-Sant Gervasi,27,el Putget i Farró,5096,1069,584,485
2015,5,Sarrià-Sant Gervasi,27,el Putget i Farró,5097,1593,836,757
2015,5,Sarrià-Sant Gervasi,27,el Putget i Farró,5098,1472,805,667
2015,6,Gràcia,28,Vallcarca i els Penitents,6001,1127,626,501
2015,6,Gràcia,28,Vallcarca i els Penitents,6002,1443,786,657
2015,6,Gràcia,28,Vallcarca i els Penitents,6003,2245,1168,1077
2015,6,Gràcia,28,Vallcarca i els Penitents,6004,1460,762,698
2015,6,Gràcia,28,Vallcarca i els Penitents,6006,1018,545,473
2015,6,Gràcia,28,Vallcarca i els Penitents,6007,1794,954,840
2015,6,Gràcia,28,Vallcarca i els Penitents,6008,1862,1037,825
2015,6,Gràcia,28,Vallcarca i els Penitents,6009,1239,655,584
2015,6,Gràcia,28,Vallcarca i els Penitents,6010,1014,536,478
2015,6,Gràcia,28,Vallcarca i els Penitents,6011,1232,658,574
2015,6,Gràcia,28,Vallcarca i els Penitents,6012,1086,587,499
2015,6,Gràcia,29,el Coll,6013,1721,899,822
2015,6,Gràcia,29,el Coll,6014,1351,715,636
2015,6,Gràcia,29,el Coll,6015,1351,717,634
2015,6,Gràcia,29,el Coll,6016,1593,848,745
2015,6,Gràcia,29,el Coll,6017,1335,715,620
2015,6,Gràcia,30,la Salut,6018,1281,675,606
2015,6,Gràcia,30,la Salut,6019,1528,812,716
2015,6,Gràcia,30,la Salut,6020,1127,603,524
2015,6,Gràcia,30,la Salut,6021,1363,738,625
2015,6,Gràcia,30,la Salut,6022,1386,714,672
2015,6,Gràcia,30,la Salut,6023,1326,698,628
2015,6,Gràcia,30,la Salut,6024,1594,907,687
2015,6,Gràcia,30,la Salut,6025,1400,783,617
2015,6,Gràcia,30,la Salut,6026,1021,570,451
2015,6,Gràcia,30,la Salut,6027,1194,666,528
2015,6,Gràcia,31,Vila de Gràcia,6028,1320,711,609
2015,6,Gràcia,31,Vila de Gràcia,6029,1225,676,549
2015,6,Gràcia,31,Vila de Gràcia,6030,1354,728,626
2015,6,Gràcia,31,Vila de Gràcia,6031,1088,615,473
2015,6,Gràcia,31,Vila de Gràcia,6032,1142,602,540
2015,6,Gràcia,31,Vila de Gràcia,6033,1320,723,597
2015,6,Gràcia,31,Vila de Gràcia,6034,1250,704,546
2015,6,Gràcia,31,Vila de Gràcia,6035,1016,555,461
2015,6,Gràcia,31,Vila de Gràcia,6036,1385,789,596
2015,6,Gràcia,31,Vila de Gràcia,6037,1091,592,499
2015,6,Gràcia,31,Vila de Gràcia,6038,1475,845,630
2015,6,Gràcia,31,Vila de Gràcia,6039,1573,880,693
2015,6,Gràcia,31,Vila de Gràcia,6040,1617,940,677
2015,6,Gràcia,31,Vila de Gràcia,6041,1693,936,757
2015,6,Gràcia,31,Vila de Gràcia,6042,1703,908,795
2015,6,Gràcia,31,Vila de Gràcia,6043,1215,675,540
2015,6,Gràcia,31,Vila de Gràcia,6044,1459,781,678
2015,6,Gràcia,31,Vila de Gràcia,6045,1303,700,603
2015,6,Gràcia,31,Vila de Gràcia,6046,1075,584,491
2015,6,Gràcia,31,Vila de Gràcia,6047,1775,869,906
2015,6,Gràcia,31,Vila de Gràcia,6048,1400,764,636
2015,6,Gràcia,31,Vila de Gràcia,6049,1111,615,496
2015,6,Gràcia,31,Vila de Gràcia,6050,1229,667,562
2015,6,Gràcia,31,Vila de Gràcia,6051,1306,750,556
2015,6,Gràcia,31,Vila de Gràcia,6052,1602,865,737
2015,6,Gràcia,31,Vila de Gràcia,6053,1493,805,688
2015,6,Gràcia,31,Vila de Gràcia,6054,1593,853,740
2015,6,Gràcia,31,Vila de Gràcia,6055,1430,813,617
2015,6,Gràcia,31,Vila de Gràcia,6056,1524,813,711
2015,6,Gràcia,31,Vila de Gràcia,6057,1498,848,650
2015,6,Gràcia,31,Vila de Gràcia,6058,1692,945,747
2015,6,Gràcia,31,Vila de Gràcia,6059,1503,793,710
2015,6,Gràcia,31,Vila de Gràcia,6060,1788,969,819
2015,6,Gràcia,31,Vila de Gràcia,6061,1343,717,626
2015,6,Gràcia,31,Vila de Gràcia,6062,1354,715,639
2015,6,Gràcia,31,Vila de Gràcia,6063,1496,807,689
2015,6,Gràcia,32,el Camp d'en Grassot i Gràcia Nova,6064,1896,1037,859
2015,6,Gràcia,32,el Camp d'en Grassot i Gràcia Nova,6065,1175,633,542
2015,6,Gràcia,32,el Camp d'en Grassot i Gràcia Nova,6066,959,535,424
2015,6,Gràcia,32,el Camp d'en Grassot i Gràcia Nova,6067,1757,950,807
2015,6,Gràcia,32,el Camp d'en Grassot i Gràcia Nova,6068,1474,827,647
2015,6,Gràcia,32,el Camp d'en Grassot i Gràcia Nova,6069,1117,585,532
2015,6,Gràcia,32,el Camp d'en Grassot i Gràcia Nova,6070,1813,1019,794
2015,6,Gràcia,32,el Camp d'en Grassot i Gràcia Nova,6071,1083,579,504
2015,6,Gràcia,32,el Camp d'en Grassot i Gràcia Nova,6072,1605,887,718
2015,6,Gràcia,32,el Camp d'en Grassot i Gràcia Nova,6073,1396,738,658
2015,6,Gràcia,32,el Camp d'en Grassot i Gràcia Nova,6074,1080,562,518
2015,6,Gràcia,32,el Camp d'en Grassot i Gràcia Nova,6075,1084,569,515
2015,6,Gràcia,32,el Camp d'en Grassot i Gràcia Nova,6076,1267,640,627
2015,6,Gràcia,32,el Camp d'en Grassot i Gràcia Nova,6077,1214,686,528
2015,6,Gràcia,32,el Camp d'en Grassot i Gràcia Nova,6078,1275,685,590
2015,6,Gràcia,32,el Camp d'en Grassot i Gràcia Nova,6079,1114,595,519
2015,6,Gràcia,32,el Camp d'en Grassot i Gràcia Nova,6080,1169,622,547
2015,6,Gràcia,32,el Camp d'en Grassot i Gràcia Nova,6081,1268,677,591
2015,6,Gràcia,32,el Camp d'en Grassot i Gràcia Nova,6082,1776,993,783
2015,6,Gràcia,32,el Camp d'en Grassot i Gràcia Nova,6083,1716,900,816
2015,6,Gràcia,32,el Camp d'en Grassot i Gràcia Nova,6084,1454,782,672
2015,6,Gràcia,32,el Camp d'en Grassot i Gràcia Nova,6085,1202,666,536
2015,6,Gràcia,32,el Camp d'en Grassot i Gràcia Nova,6086,950,512,438
2015,6,Gràcia,32,el Camp d'en Grassot i Gràcia Nova,6087,1860,1009,851
2015,6,Gràcia,32,el Camp d'en Grassot i Gràcia Nova,6088,1209,673,536
2015,7,Horta-Guinardó,33,el Baix Guinardó,7001,1555,877,678
2015,7,Horta-Guinardó,33,el Baix Guinardó,7002,1126,594,532
2015,7,Horta-Guinardó,33,el Baix Guinardó,7003,1294,698,596
2015,7,Horta-Guinardó,33,el Baix Guinardó,7004,1507,809,698
2015,7,Horta-Guinardó,33,el Baix Guinardó,7005,1501,804,697
2015,7,Horta-Guinardó,33,el Baix Guinardó,7006,955,519,436
2015,7,Horta-Guinardó,33,el Baix Guinardó,7007,1397,781,616
2015,7,Horta-Guinardó,33,el Baix Guinardó,7008,1423,725,698
2015,7,Horta-Guinardó,33,el Baix Guinardó,7009,1176,634,542
2015,7,Horta-Guinardó,33,el Baix Guinardó,7010,1326,700,626
2015,7,Horta-Guinardó,33,el Baix Guinardó,7011,1125,626,499
2015,7,Horta-Guinardó,33,el Baix Guinardó,7012,1543,845,698
2015,7,Horta-Guinardó,33,el Baix Guinardó,7013,1229,647,582
2015,7,Horta-Guinardó,33,el Baix Guinardó,7014,908,479,429
2015,7,Horta-Guinardó,33,el Baix Guinardó,7015,1397,741,656
2015,7,Horta-Guinardó,33,el Baix Guinardó,7016,1333,674,659
2015,7,Horta-Guinardó,33,el Baix Guinardó,7017,1640,913,727
2015,7,Horta-Guinardó,33,el Baix Guinardó,7018,1587,879,708
2015,7,Horta-Guinardó,33,el Baix Guinardó,7019,1452,781,671
2015,7,Horta-Guinardó,34,Can Baró,7020,1553,849,704
2015,7,Horta-Guinardó,34,Can Baró,7021,1044,534,510
2015,7,Horta-Guinardó,34,Can Baró,7022,1116,587,529
2015,7,Horta-Guinardó,34,Can Baró,7023,1276,652,624
2015,7,Horta-Guinardó,34,Can Baró,7024,1407,760,647
2015,7,Horta-Guinardó,34,Can Baró,7025,1373,730,643
2015,7,Horta-Guinardó,34,Can Baró,7026,1055,570,485
2015,7,Horta-Guinardó,35,el Guinardó,7027,1946,1045,901
2015,7,Horta-Guinardó,35,el Guinardó,7028,1446,760,686
2015,7,Horta-Guinardó,35,el Guinardó,7029,1263,643,620
2015,7,Horta-Guinardó,35,el Guinardó,7030,1328,721,607
2015,7,Horta-Guinardó,35,el Guinardó,7031,1558,811,747
2015,7,Horta-Guinardó,35,el Guinardó,7032,1293,661,632
2015,7,Horta-Guinardó,35,el Guinardó,7033,1377,732,645
2015,7,Horta-Guinardó,35,el Guinardó,7034,1553,820,733
2015,7,Horta-Guinardó,35,el Guinardó,7035,1760,977,783
2015,7,Horta-Guinardó,35,el Guinardó,7036,1346,746,600
2015,7,Horta-Guinardó,35,el Guinardó,7037,1480,824,656
2015,7,Horta-Guinardó,35,el Guinardó,7038,1317,713,604
2015,7,Horta-Guinardó,35,el Guinardó,7039,1545,819,726
2015,7,Horta-Guinardó,35,el Guinardó,7040,1468,790,678
2015,7,Horta-Guinardó,35,el Guinardó,7041,1377,761,616
2015,7,Horta-Guinardó,35,el Guinardó,7042,1530,829,701
2015,7,Horta-Guinardó,35,el Guinardó,7043,1371,738,633
2015,7,Horta-Guinardó,35,el Guinardó,7044,1278,677,601
2015,7,Horta-Guinardó,35,el Guinardó,7045,1478,782,696
2015,7,Horta-Guinardó,35,el Guinardó,7046,1396,759,637
2015,7,Horta-Guinardó,35,el Guinardó,7047,1423,752,671
2015,7,Horta-Guinardó,35,el Guinardó,7048,1191,655,536
2015,7,Horta-Guinardó,35,el Guinardó,7049,1216,640,576
2015,7,Horta-Guinardó,35,el Guinardó,7050,1128,592,536
2015,7,Horta-Guinardó,35,el Guinardó,7051,1716,946,770
2015,7,Horta-Guinardó,36,la Font d'en Fargues,7052,1240,669,571
2015,7,Horta-Guinardó,36,la Font d'en Fargues,7053,1469,765,704
2015,7,Horta-Guinardó,36,la Font d'en Fargues,7054,1532,808,724
2015,7,Horta-Guinardó,36,la Font d'en Fargues,7055,1158,613,545
2015,7,Horta-Guinardó,36,la Font d'en Fargues,7056,1174,610,564
2015,7,Horta-Guinardó,36,la Font d'en Fargues,7057,1436,761,675
2015,7,Horta-Guinardó,36,la Font d'en Fargues,7058,1390,714,676
2015,7,Horta-Guinardó,37,el Carmel,7059,1307,676,631
2015,7,Horta-Guinardó,37,el Carmel,7060,1816,919,897
2015,7,Horta-Guinardó,37,el Carmel,7061,1250,615,635
2015,7,Horta-Guinardó,37,el Carmel,7062,1260,655,605
2015,7,Horta-Guinardó,37,el Carmel,7063,1451,738,713
2015,7,Horta-Guinardó,37,el Carmel,7064,1667,874,793
2015,7,Horta-Guinardó,37,el Carmel,7065,1626,834,792
2015,7,Horta-Guinardó,37,el Carmel,7066,1752,929,823
2015,7,Horta-Guinardó,37,el Carmel,7067,1515,805,710
2015,7,Horta-Guinardó,37,el Carmel,7068,1189,632,557
2015,7,Horta-Guinardó,37,el Carmel,7069,1444,728,716
2015,7,Horta-Guinardó,37,el Carmel,7070,1382,737,645
2015,7,Horta-Guinardó,37,el Carmel,7071,1351,710,641
2015,7,Horta-Guinardó,37,el Carmel,7072,1337,709,628
2015,7,Horta-Guinardó,37,el Carmel,7073,1062,576,486
2015,7,Horta-Guinardó,37,el Carmel,7074,1716,903,813
2015,7,Horta-Guinardó,37,el Carmel,7075,1249,646,603
2015,7,Horta-Guinardó,37,el Carmel,7076,1334,691,643
2015,7,Horta-Guinardó,37,el Carmel,7077,1283,675,608
2015,7,Horta-Guinardó,37,el Carmel,7078,1309,663,646
2015,7,Horta-Guinardó,37,el Carmel,7079,1366,715,651
2015,7,Horta-Guinardó,37,el Carmel,7080,1783,953,830
2015,7,Horta-Guinardó,38,la Teixonera,7081,1966,1024,942
2015,7,Horta-Guinardó,38,la Teixonera,7082,1290,654,636
2015,7,Horta-Guinardó,38,la Teixonera,7083,1238,629,609
2015,7,Horta-Guinardó,38,la Teixonera,7084,1316,673,643
2015,7,Horta-Guinardó,38,la Teixonera,7085,1287,665,622
2015,7,Horta-Guinardó,38,la Teixonera,7086,1442,744,698
2015,7,Horta-Guinardó,38,la Teixonera,7087,1569,819,750
2015,7,Horta-Guinardó,38,la Teixonera,7088,1252,641,611
2015,7,Horta-Guinardó,39,Sant Genís dels Agudells,7089,1283,717,566
2015,7,Horta-Guinardó,39,Sant Genís dels Agudells,7090,1413,712,701
2015,7,Horta-Guinardó,39,Sant Genís dels Agudells,7091,1124,584,540
2015,7,Horta-Guinardó,39,Sant Genís dels Agudells,7092,1344,736,608
2015,7,Horta-Guinardó,39,Sant Genís dels Agudells,7093,1557,832,725
2015,7,Horta-Guinardó,40,Montbau,7094,1205,686,519
2015,7,Horta-Guinardó,40,Montbau,7095,1536,850,686
2015,7,Horta-Guinardó,40,Montbau,7096,1385,754,631
2015,7,Horta-Guinardó,40,Montbau,7097,915,523,392
2015,7,Horta-Guinardó,41,la Vall d'Hebron,7098,1871,997,874
2015,7,Horta-Guinardó,41,la Vall d'Hebron,7099,1069,553,516
2015,7,Horta-Guinardó,41,la Vall d'Hebron,7100,1160,630,530
2015,7,Horta-Guinardó,41,la Vall d'Hebron,7101,1367,710,657
2015,7,Horta-Guinardó,42,la Clota,7102,542,266,276
2015,7,Horta-Guinardó,43,Horta,7103,1479,801,678
2015,7,Horta-Guinardó,43,Horta,7104,1577,839,738
2015,7,Horta-Guinardó,43,Horta,7105,1052,545,507
2015,7,Horta-Guinardó,43,Horta,7106,1110,586,524
2015,7,Horta-Guinardó,43,Horta,7107,1246,645,601
2015,7,Horta-Guinardó,43,Horta,7108,1244,640,604
2015,7,Horta-Guinardó,43,Horta,7109,1630,862,768
2015,7,Horta-Guinardó,43,Horta,7110,1011,583,428
2015,7,Horta-Guinardó,43,Horta,7111,888,493,395
2015,7,Horta-Guinardó,43,Horta,7112,1256,657,599
2015,7,Horta-Guinardó,43,Horta,7113,1164,602,562
2015,7,Horta-Guinardó,43,Horta,7114,1170,639,531
2015,7,Horta-Guinardó,43,Horta,7115,1136,564,572
2015,7,Horta-Guinardó,43,Horta,7116,1474,775,699
2015,7,Horta-Guinardó,43,Horta,7117,1565,693,872
2015,7,Horta-Guinardó,43,Horta,7118,1216,677,539
2015,7,Horta-Guinardó,43,Horta,7119,1181,641,540
2015,7,Horta-Guinardó,43,Horta,7120,1209,664,545
2015,7,Horta-Guinardó,43,Horta,7121,1190,653,537
2015,7,Horta-Guinardó,43,Horta,7122,1304,727,577
2015,7,Horta-Guinardó,43,Horta,7123,1367,715,652
2015,8,Nou Barris,44,Vilapicina i la Torre Llobeta,8001,1249,661,588
2015,8,Nou Barris,44,Vilapicina i la Torre Llobeta,8002,1277,676,601
2015,8,Nou Barris,44,Vilapicina i la Torre Llobeta,8003,1214,638,576
2015,8,Nou Barris,44,Vilapicina i la Torre Llobeta,8004,1403,764,639
2015,8,Nou Barris,44,Vilapicina i la Torre Llobeta,8005,1150,607,543
2015,8,Nou Barris,44,Vilapicina i la Torre Llobeta,8006,1468,788,680
2015,8,Nou Barris,44,Vilapicina i la Torre Llobeta,8007,1194,666,528
2015,8,Nou Barris,44,Vilapicina i la Torre Llobeta,8008,1628,871,757
2015,8,Nou Barris,44,Vilapicina i la Torre Llobeta,8009,1663,894,769
2015,8,Nou Barris,44,Vilapicina i la Torre Llobeta,8010,1111,601,510
2015,8,Nou Barris,44,Vilapicina i la Torre Llobeta,8011,1168,647,521
2015,8,Nou Barris,44,Vilapicina i la Torre Llobeta,8012,1357,749,608
2015,8,Nou Barris,44,Vilapicina i la Torre Llobeta,8013,1209,663,546
2015,8,Nou Barris,44,Vilapicina i la Torre Llobeta,8014,1192,634,558
2015,8,Nou Barris,44,Vilapicina i la Torre Llobeta,8015,1357,764,593
2015,8,Nou Barris,44,Vilapicina i la Torre Llobeta,8016,1179,644,535
2015,8,Nou Barris,44,Vilapicina i la Torre Llobeta,8017,1322,699,623
2015,8,Nou Barris,44,Vilapicina i la Torre Llobeta,8018,1553,843,710
2015,8,Nou Barris,44,Vilapicina i la Torre Llobeta,8019,1750,958,792
2015,8,Nou Barris,45,Porta,8020,1249,686,563
2015,8,Nou Barris,45,Porta,8021,1452,793,659
2015,8,Nou Barris,45,Porta,8022,1212,664,548
2015,8,Nou Barris,45,Porta,8023,1350,709,641
2015,8,Nou Barris,45,Porta,8024,1384,750,634
2015,8,Nou Barris,45,Porta,8025,1179,653,526
2015,8,Nou Barris,45,Porta,8026,1334,733,601
2015,8,Nou Barris,45,Porta,8027,1265,642,623
2015,8,Nou Barris,45,Porta,8028,1085,589,496
2015,8,Nou Barris,45,Porta,8029,1496,798,698
2015,8,Nou Barris,45,Porta,8030,1436,755,681
2015,8,Nou Barris,45,Porta,8031,1293,659,634
2015,8,Nou Barris,45,Porta,8032,1317,708,609
2015,8,Nou Barris,45,Porta,8033,1418,742,676
2015,8,Nou Barris,45,Porta,8034,1146,632,514
2015,8,Nou Barris,45,Porta,8035,1726,822,904
2015,8,Nou Barris,45,Porta,8036,1466,773,693
2015,8,Nou Barris,45,Porta,8037,1491,813,678
2015,8,Nou Barris,46,el Turó de la Peira,8038,1443,811,632
2015,8,Nou Barris,46,el Turó de la Peira,8039,1525,840,685
2015,8,Nou Barris,46,el Turó de la Peira,8040,1624,881,743
2015,8,Nou Barris,46,el Turó de la Peira,8041,2346,1222,1124
2015,8,Nou Barris,46,el Turó de la Peira,8042,1291,701,590
2015,8,Nou Barris,46,el Turó de la Peira,8043,1143,646,497
2015,8,Nou Barris,46,el Turó de la Peira,8044,1348,711,637
2015,8,Nou Barris,46,el Turó de la Peira,8045,1693,906,787
2015,8,Nou Barris,46,el Turó de la Peira,8046,1367,753,614
2015,8,Nou Barris,46,el Turó de la Peira,8047,1548,823,725
2015,8,Nou Barris,47,Can Peguera,8048,1037,555,482
2015,8,Nou Barris,47,Can Peguera,8049,1238,631,607
2015,8,Nou Barris,48,la Guineueta,8050,1431,758,673
2015,8,Nou Barris,48,la Guineueta,8051,1350,705,645
2015,8,Nou Barris,48,la Guineueta,8052,850,467,383
2015,8,Nou Barris,48,la Guineueta,8053,1139,599,540
2015,8,Nou Barris,48,la Guineueta,8054,1670,926,744
2015,8,Nou Barris,48,la Guineueta,8055,1857,980,877
2015,8,Nou Barris,48,la Guineueta,8056,1441,766,675
2015,8,Nou Barris,48,la Guineueta,8057,1308,690,618
2015,8,Nou Barris,48,la Guineueta,8058,1620,875,745
2015,8,Nou Barris,48,la Guineueta,8059,998,513,485
2015,8,Nou Barris,48,la Guineueta,8215,1433,789,644
2015,8,Nou Barris,49,Canyelles,8060,1198,633,565
2015,8,Nou Barris,49,Canyelles,8061,1667,843,824
2015,8,Nou Barris,49,Canyelles,8062,1215,632,583
2015,8,Nou Barris,49,Canyelles,8063,1147,605,542
2015,8,Nou Barris,49,Canyelles,8064,1725,906,819
2015,8,Nou Barris,50,les Roquetes,8065,1690,837,853
2015,8,Nou Barris,50,les Roquetes,8066,1598,795,803
2015,8,Nou Barris,50,les Roquetes,8067,1601,811,790
2015,8,Nou Barris,50,les Roquetes,8068,1824,975,849
2015,8,Nou Barris,50,les Roquetes,8069,1454,734,720
2015,8,Nou Barris,50,les Roquetes,8070,1406,744,662
2015,8,Nou Barris,50,les Roquetes,8071,1613,849,764
2015,8,Nou Barris,50,les Roquetes,8072,1178,614,564
2015,8,Nou Barris,50,les Roquetes,8073,1605,854,751
2015,8,Nou Barris,50,les Roquetes,8074,1431,743,688
2015,8,Nou Barris,51,Verdun,8075,1824,968,856
2015,8,Nou Barris,51,Verdun,8076,1568,830,738
2015,8,Nou Barris,51,Verdun,8077,1430,759,671
2015,8,Nou Barris,51,Verdun,8078,1470,786,684
2015,8,Nou Barris,51,Verdun,8079,1405,741,664
2015,8,Nou Barris,51,Verdun,8080,1448,795,653
2015,8,Nou Barris,51,Verdun,8081,1535,830,705
2015,8,Nou Barris,51,Verdun,8082,1546,858,688
2015,8,Nou Barris,52,la Prosperitat,8083,1255,662,593
2015,8,Nou Barris,52,la Prosperitat,8084,1151,612,539
2015,8,Nou Barris,52,la Prosperitat,8085,1433,734,699
2015,8,Nou Barris,52,la Prosperitat,8086,1660,903,757
2015,8,Nou Barris,52,la Prosperitat,8087,1250,668,582
2015,8,Nou Barris,52,la Prosperitat,8088,1244,647,597
2015,8,Nou Barris,52,la Prosperitat,8089,1233,652,581
2015,8,Nou Barris,52,la Prosperitat,8090,1195,634,561
2015,8,Nou Barris,52,la Prosperitat,8091,1157,568,589
2015,8,Nou Barris,52,la Prosperitat,8092,1004,511,493
2015,8,Nou Barris,52,la Prosperitat,8093,1240,630,610
2015,8,Nou Barris,52,la Prosperitat,8094,1480,775,705
2015,8,Nou Barris,52,la Prosperitat,8095,1076,560,516
2015,8,Nou Barris,52,la Prosperitat,8096,1446,742,704
2015,8,Nou Barris,52,la Prosperitat,8097,1337,701,636
2015,8,Nou Barris,52,la Prosperitat,8098,1240,643,597
2015,8,Nou Barris,52,la Prosperitat,8099,1308,672,636
2015,8,Nou Barris,52,la Prosperitat,8100,1215,663,552
2015,8,Nou Barris,52,la Prosperitat,8101,1690,917,773
2015,8,Nou Barris,52,la Prosperitat,8102,1360,722,638
2015,8,Nou Barris,53,la Trinitat Nova,8103,1494,742,752
2015,8,Nou Barris,53,la Trinitat Nova,8104,1214,676,538
2015,8,Nou Barris,53,la Trinitat Nova,8105,1619,836,783
2015,8,Nou Barris,53,la Trinitat Nova,8106,1236,654,582
2015,8,Nou Barris,53,la Trinitat Nova,8107,1772,915,857
2015,8,Nou Barris,54,Torre Baró,8108,1722,872,850
2015,8,Nou Barris,54,Torre Baró,8109,1012,486,526
2015,8,Nou Barris,55,Ciutat Meridiana,8110,1863,921,942
2015,8,Nou Barris,55,Ciutat Meridiana,8111,1566,821,745
2015,8,Nou Barris,55,Ciutat Meridiana,8112,1641,828,813
2015,8,Nou Barris,55,Ciutat Meridiana,8113,1706,842,864
2015,8,Nou Barris,55,Ciutat Meridiana,8114,1854,929,925
2015,8,Nou Barris,55,Ciutat Meridiana,8115,1609,812,797
2015,8,Nou Barris,56,Vallbona,8116,1334,678,656
2015,9,Sant Andreu,57,la Trinitat Vella,9001,2580,1197,1383
2015,9,Sant Andreu,57,la Trinitat Vella,9002,2178,1016,1162
2015,9,Sant Andreu,57,la Trinitat Vella,9003,2060,987,1073
2015,9,Sant Andreu,57,la Trinitat Vella,9004,1706,865,841
2015,9,Sant Andreu,57,la Trinitat Vella,9005,1544,766,778
2015,9,Sant Andreu,58,Baró de Viver,9006,1227,626,601
2015,9,Sant Andreu,58,Baró de Viver,9007,1255,647,608
2015,9,Sant Andreu,59,el Bon Pastor,9008,1894,942,952
2015,9,Sant Andreu,59,el Bon Pastor,9009,1416,729,687
2015,9,Sant Andreu,59,el Bon Pastor,9010,1780,916,864
2015,9,Sant Andreu,59,el Bon Pastor,9011,1880,948,932
2015,9,Sant Andreu,59,el Bon Pastor,9013,1874,967,907
2015,9,Sant Andreu,59,el Bon Pastor,9014,1935,874,1061
2015,9,Sant Andreu,59,el Bon Pastor,9015,1781,897,884
2015,9,Sant Andreu,60,Sant Andreu,9016,1404,741,663
2015,9,Sant Andreu,60,Sant Andreu,9017,1461,749,712
2015,9,Sant Andreu,60,Sant Andreu,9018,1462,751,711
2015,9,Sant Andreu,60,Sant Andreu,9019,2361,1206,1155
2015,9,Sant Andreu,60,Sant Andreu,9020,1139,617,522
2015,9,Sant Andreu,60,Sant Andreu,9021,1359,719,640
2015,9,Sant Andreu,60,Sant Andreu,9022,1206,640,566
2015,9,Sant Andreu,60,Sant Andreu,9023,1212,627,585
2015,9,Sant Andreu,60,Sant Andreu,9024,1137,618,519
2015,9,Sant Andreu,60,Sant Andreu,9025,1164,628,536
2015,9,Sant Andreu,60,Sant Andreu,9026,1529,810,719
2015,9,Sant Andreu,60,Sant Andreu,9027,1375,711,664
2015,9,Sant Andreu,60,Sant Andreu,9028,1602,824,778
2015,9,Sant Andreu,60,Sant Andreu,9029,1179,615,564
2015,9,Sant Andreu,60,Sant Andreu,9030,1446,779,667
2015,9,Sant Andreu,60,Sant Andreu,9031,1168,612,556
2015,9,Sant Andreu,60,Sant Andreu,9032,1891,1009,882
2015,9,Sant Andreu,60,Sant Andreu,9033,3091,1601,1490
2015,9,Sant Andreu,60,Sant Andreu,9034,1401,738,663
2015,9,Sant Andreu,60,Sant Andreu,9035,1574,830,744
2015,9,Sant Andreu,60,Sant Andreu,9036,1436,770,666
2015,9,Sant Andreu,60,Sant Andreu,9037,1360,746,614
2015,9,Sant Andreu,60,Sant Andreu,9038,1593,838,755
2015,9,Sant Andreu,60,Sant Andreu,9039,1567,827,740
2015,9,Sant Andreu,60,Sant Andreu,9040,1500,820,680
2015,9,Sant Andreu,60,Sant Andreu,9041,1416,774,642
2015,9,Sant Andreu,60,Sant Andreu,9042,1238,650,588
2015,9,Sant Andreu,60,Sant Andreu,9043,1325,703,622
2015,9,Sant Andreu,60,Sant Andreu,9044,1470,769,701
2015,9,Sant Andreu,60,Sant Andreu,9045,1427,751,676
2015,9,Sant Andreu,60,Sant Andreu,9046,1286,677,609
2015,9,Sant Andreu,60,Sant Andreu,9047,1477,796,681
2015,9,Sant Andreu,60,Sant Andreu,9048,1361,709,652
2015,9,Sant Andreu,60,Sant Andreu,9049,1288,714,574
2015,9,Sant Andreu,60,Sant Andreu,9050,1567,834,733
2015,9,Sant Andreu,60,Sant Andreu,9051,1206,642,564
2015,9,Sant Andreu,60,Sant Andreu,9052,1151,601,550
2015,9,Sant Andreu,60,Sant Andreu,9053,1507,831,676
2015,9,Sant Andreu,60,Sant Andreu,9054,1155,616,539
2015,9,Sant Andreu,61,la Sagrera,9055,1701,901,800
2015,9,Sant Andreu,61,la Sagrera,9056,1183,640,543
2015,9,Sant Andreu,61,la Sagrera,9057,1535,828,707
2015,9,Sant Andreu,61,la Sagrera,9058,1433,763,670
2015,9,Sant Andreu,61,la Sagrera,9059,1351,684,667
2015,9,Sant Andreu,61,la Sagrera,9060,1353,729,624
2015,9,Sant Andreu,61,la Sagrera,9061,1673,876,797
2015,9,Sant Andreu,61,la Sagrera,9062,1119,579,540
2015,9,Sant Andreu,61,la Sagrera,9063,1156,591,565
2015,9,Sant Andreu,61,la Sagrera,9064,1201,643,558
2015,9,Sant Andreu,61,la Sagrera,9065,2010,1091,919
2015,9,Sant Andreu,61,la Sagrera,9066,1403,731,672
2015,9,Sant Andreu,61,la Sagrera,9067,1388,767,621
2015,9,Sant Andreu,61,la Sagrera,9068,1539,799,740
2015,9,Sant Andreu,61,la Sagrera,9069,959,543,416
2015,9,Sant Andreu,61,la Sagrera,9070,1795,956,839
2015,9,Sant Andreu,61,la Sagrera,9071,1797,967,830
2015,9,Sant Andreu,61,la Sagrera,9072,1503,831,672
2015,9,Sant Andreu,61,la Sagrera,9073,1545,815,730
2015,9,Sant Andreu,61,la Sagrera,9156,1255,663,592
2015,9,Sant Andreu,62,el Congrés i els Indians,9074,1581,868,713
2015,9,Sant Andreu,62,el Congrés i els Indians,9075,1449,813,636
2015,9,Sant Andreu,62,el Congrés i els Indians,9076,1411,784,627
2015,9,Sant Andreu,62,el Congrés i els Indians,9077,1527,862,665
2015,9,Sant Andreu,62,el Congrés i els Indians,9078,1486,792,694
2015,9,Sant Andreu,62,el Congrés i els Indians,9079,1560,844,716
2015,9,Sant Andreu,62,el Congrés i els Indians,9080,1332,681,651
2015,9,Sant Andreu,62,el Congrés i els Indians,9081,1786,966,820
2015,9,Sant Andreu,62,el Congrés i els Indians,9082,1914,1042,872
2015,9,Sant Andreu,63,Navas,9083,1594,859,735
2015,9,Sant Andreu,63,Navas,9084,1690,895,795
2015,9,Sant Andreu,63,Navas,9085,1655,900,755
2015,9,Sant Andreu,63,Navas,9086,1413,775,638
2015,9,Sant Andreu,63,Navas,9087,1254,674,580
2015,9,Sant Andreu,63,Navas,9088,1932,1046,886
2015,9,Sant Andreu,63,Navas,9089,1457,807,650
2015,9,Sant Andreu,63,Navas,9090,1609,872,737
2015,9,Sant Andreu,63,Navas,9091,1863,987,876
2015,9,Sant Andreu,63,Navas,9092,1986,1049,937
2015,9,Sant Andreu,63,Navas,9093,1360,715,645
2015,9,Sant Andreu,63,Navas,9094,2028,1071,957
2015,9,Sant Andreu,63,Navas,9095,2125,1127,998
2015,10,Sant Martí,64,Camp de l'Arpa del Clot,10001,1615,853,762
2015,10,Sant Martí,64,Camp de l'Arpa del Clot,10002,1714,897,817
2015,10,Sant Martí,64,Camp de l'Arpa del Clot,10003,1556,793,763
2015,10,Sant Martí,64,Camp de l'Arpa del Clot,10004,1488,805,683
2015,10,Sant Martí,64,Camp de l'Arpa del Clot,10005,1612,873,739
2015,10,Sant Martí,64,Camp de l'Arpa del Clot,10006,1759,961,798
2015,10,Sant Martí,64,Camp de l'Arpa del Clot,10007,1349,690,659
2015,10,Sant Martí,64,Camp de l'Arpa del Clot,10008,1707,923,784
2015,10,Sant Martí,64,Camp de l'Arpa del Clot,10009,1606,859,747
2015,10,Sant Martí,64,Camp de l'Arpa del Clot,10010,1703,930,773
2015,10,Sant Martí,64,Camp de l'Arpa del Clot,10011,1227,664,563
2015,10,Sant Martí,64,Camp de l'Arpa del Clot,10012,1804,942,862
2015,10,Sant Martí,64,Camp de l'Arpa del Clot,10013,1374,748,626
2015,10,Sant Martí,64,Camp de l'Arpa del Clot,10014,1466,791,675
2015,10,Sant Martí,64,Camp de l'Arpa del Clot,10015,1793,934,859
2015,10,Sant Martí,64,Camp de l'Arpa del Clot,10016,1277,666,611
2015,10,Sant Martí,64,Camp de l'Arpa del Clot,10017,1694,909,785
2015,10,Sant Martí,64,Camp de l'Arpa del Clot,10018,1378,725,653
2015,10,Sant Martí,64,Camp de l'Arpa del Clot,10019,1635,876,759
2015,10,Sant Martí,64,Camp de l'Arpa del Clot,10020,1466,774,692
2015,10,Sant Martí,64,Camp de l'Arpa del Clot,10021,1338,686,652
2015,10,Sant Martí,64,Camp de l'Arpa del Clot,10022,1297,680,617
2015,10,Sant Martí,64,Camp de l'Arpa del Clot,10023,1437,758,679
2015,10,Sant Martí,64,Camp de l'Arpa del Clot,10024,1481,781,700
2015,10,Sant Martí,64,Camp de l'Arpa del Clot,10025,1392,747,645
2015,10,Sant Martí,65,el Clot,10026,1534,802,732
2015,10,Sant Martí,65,el Clot,10027,1497,787,710
2015,10,Sant Martí,65,el Clot,10028,1808,924,884
2015,10,Sant Martí,65,el Clot,10029,1466,762,704
2015,10,Sant Martí,65,el Clot,10030,1698,902,796
2015,10,Sant Martí,65,el Clot,10031,1540,800,740
2015,10,Sant Martí,65,el Clot,10032,1465,757,708
2015,10,Sant Martí,65,el Clot,10033,897,493,404
2015,10,Sant Martí,65,el Clot,10034,1746,886,860
2015,10,Sant Martí,65,el Clot,10035,2065,1050,1015
2015,10,Sant Martí,65,el Clot,10036,1449,722,727
2015,10,Sant Martí,65,el Clot,10037,1043,545,498
2015,10,Sant Martí,65,el Clot,10038,1679,872,807
2015,10,Sant Martí,65,el Clot,10039,1743,944,799
2015,10,Sant Martí,65,el Clot,10040,1843,960,883
2015,10,Sant Martí,65,el Clot,10041,1565,784,781
2015,10,Sant Martí,65,el Clot,10234,1894,1006,888
2015,10,Sant Martí,66,el Parc i la Llacuna del Poblenou,10042,2418,1247,1171
2015,10,Sant Martí,66,el Parc i la Llacuna del Poblenou,10043,1851,928,923
2015,10,Sant Martí,66,el Parc i la Llacuna del Poblenou,10044,1499,759,740
2015,10,Sant Martí,66,el Parc i la Llacuna del Poblenou,10045,1281,694,587
2015,10,Sant Martí,66,el Parc i la Llacuna del Poblenou,10046,1282,662,620
2015,10,Sant Martí,66,el Parc i la Llacuna del Poblenou,10047,1858,935,923
2015,10,Sant Martí,66,el Parc i la Llacuna del Poblenou,10048,1611,833,778
2015,10,Sant Martí,66,el Parc i la Llacuna del Poblenou,10049,1298,673,625
2015,10,Sant Martí,66,el Parc i la Llacuna del Poblenou,10050,1615,864,751
2015,10,Sant Martí,67,la Vila Olímpica del Poblenou,10051,1569,816,753
2015,10,Sant Martí,67,la Vila Olímpica del Poblenou,10052,2330,1161,1169
2015,10,Sant Martí,67,la Vila Olímpica del Poblenou,10053,1812,918,894
2015,10,Sant Martí,67,la Vila Olímpica del Poblenou,10054,1009,526,483
2015,10,Sant Martí,67,la Vila Olímpica del Poblenou,10055,2611,1336,1275
2015,10,Sant Martí,68,el Poblenou,10056,1839,916,923
2015,10,Sant Martí,68,el Poblenou,10057,1335,660,675
2015,10,Sant Martí,68,el Poblenou,10058,1118,583,535
2015,10,Sant Martí,68,el Poblenou,10059,1618,834,784
2015,10,Sant Martí,68,el Poblenou,10060,1597,791,806
2015,10,Sant Martí,68,el Poblenou,10061,1777,924,853
2015,10,Sant Martí,68,el Poblenou,10062,1591,805,786
2015,10,Sant Martí,68,el Poblenou,10063,1258,657,601
2015,10,Sant Martí,68,el Poblenou,10064,1687,870,817
2015,10,Sant Martí,68,el Poblenou,10065,1590,808,782
2015,10,Sant Martí,68,el Poblenou,10066,2119,1077,1042
2015,10,Sant Martí,68,el Poblenou,10067,1942,1025,917
2015,10,Sant Martí,68,el Poblenou,10068,1578,792,786
2015,10,Sant Martí,68,el Poblenou,10069,2175,1155,1020
2015,10,Sant Martí,68,el Poblenou,10070,1645,883,762
2015,10,Sant Martí,68,el Poblenou,10071,1799,912,887
2015,10,Sant Martí,68,el Poblenou,10072,2047,1039,1008
2015,10,Sant Martí,68,el Poblenou,10073,1507,791,716
2015,10,Sant Martí,68,el Poblenou,10074,1717,892,825
2015,10,Sant Martí,68,el Poblenou,10075,1498,764,734
2015,10,Sant Martí,69,Diagonal Mar i el Front Marítim del Poblenou,10076,2036,1064,972
2015,10,Sant Martí,69,Diagonal Mar i el Front Marítim del Poblenou,10077,1863,917,946
2015,10,Sant Martí,69,Diagonal Mar i el Front Marítim del Poblenou,10078,2230,1128,1102
2015,10,Sant Martí,69,Diagonal Mar i el Front Marítim del Poblenou,10079,1803,931,872
2015,10,Sant Martí,69,Diagonal Mar i el Front Marítim del Poblenou,10080,2455,1220,1235
2015,10,Sant Martí,69,Diagonal Mar i el Front Marítim del Poblenou,10235,1329,710,619
2015,10,Sant Martí,69,Diagonal Mar i el Front Marítim del Poblenou,10236,1658,876,782
2015,10,Sant Martí,70,el Besòs i el Maresme,10081,1891,950,941
2015,10,Sant Martí,70,el Besòs i el Maresme,10082,1983,909,1074
2015,10,Sant Martí,70,el Besòs i el Maresme,10083,2227,943,1284
2015,10,Sant Martí,70,el Besòs i el Maresme,10084,1587,792,795
2015,10,Sant Martí,70,el Besòs i el Maresme,10085,2008,968,1040
2015,10,Sant Martí,70,el Besòs i el Maresme,10086,1960,981,979
2015,10,Sant Martí,70,el Besòs i el Maresme,10087,1746,894,852
2015,10,Sant Martí,70,el Besòs i el Maresme,10088,1595,818,777
2015,10,Sant Martí,70,el Besòs i el Maresme,10089,1875,895,980
2015,10,Sant Martí,70,el Besòs i el Maresme,10090,1349,715,634
2015,10,Sant Martí,70,el Besòs i el Maresme,10091,1999,1023,976
2015,10,Sant Martí,70,el Besòs i el Maresme,10092,1522,806,716
2015,10,Sant Martí,70,el Besòs i el Maresme,10093,1102,555,547
2015,10,Sant Martí,71,Provençals del Poblenou,10094,2621,1310,1311
2015,10,Sant Martí,71,Provençals del Poblenou,10095,1279,640,639
2015,10,Sant Martí,71,Provençals del Poblenou,10096,1567,826,741
2015,10,Sant Martí,71,Provençals del Poblenou,10097,1569,821,748
2015,10,Sant Martí,71,Provençals del Poblenou,10098,1881,972,909
2015,10,Sant Martí,71,Provençals del Poblenou,10099,1094,564,530
2015,10,Sant Martí,71,Provençals del Poblenou,10100,1588,841,747
2015,10,Sant Martí,71,Provençals del Poblenou,10101,1349,662,687
2015,10,Sant Martí,71,Provençals del Poblenou,10102,2570,1343,1227
2015,10,Sant Martí,71,Provençals del Poblenou,10103,2200,1151,1049
2015,10,Sant Martí,71,Provençals del Poblenou,10104,1680,872,808
2015,10,Sant Martí,71,Provençals del Poblenou,10237,765,418,347
2015,10,Sant Martí,72,Sant Martí de Provençals,10105,2234,1199,1035
2015,10,Sant Martí,72,Sant Martí de Provençals,10106,1021,537,484
2015,10,Sant Martí,72,Sant Martí de Provençals,10107,1518,796,722
2015,10,Sant Martí,72,Sant Martí de Provençals,10108,1356,723,633
2015,10,Sant Martí,72,Sant Martí de Provençals,10109,1521,833,688
2015,10,Sant Martí,72,Sant Martí de Provençals,10110,1628,900,728
2015,10,Sant Martí,72,Sant Martí de Provençals,10111,1308,680,628
2015,10,Sant Martí,72,Sant Martí de Provençals,10112,1581,813,768
2015,10,Sant Martí,72,Sant Martí de Provençals,10113,1197,629,568
2015,10,Sant Martí,72,Sant Martí de Provençals,10114,1366,728,638
2015,10,Sant Martí,72,Sant Martí de Provençals,10115,1418,730,688
2015,10,Sant Martí,72,Sant Martí de Provençals,10116,1865,984,881
2015,10,Sant Martí,72,Sant Martí de Provençals,10117,1296,684,612
2015,10,Sant Martí,72,Sant Martí de Provençals,10118,1004,532,472
2015,10,Sant Martí,72,Sant Martí de Provençals,10119,1119,598,521
2015,10,Sant Martí,72,Sant Martí de Provençals,10120,1411,798,613
2015,10,Sant Martí,72,Sant Martí de Provençals,10121,1565,826,739
2015,10,Sant Martí,72,Sant Martí de Provençals,10122,1563,810,753
2015,10,Sant Martí,73,la Verneda i la Pau,10123,1402,720,682
2015,10,Sant Martí,73,la Verneda i la Pau,10124,1118,566,552
2015,10,Sant Martí,73,la Verneda i la Pau,10125,1132,585,547
2015,10,Sant Martí,73,la Verneda i la Pau,10126,1085,575,510
2015,10,Sant Martí,73,la Verneda i la Pau,10127,1000,506,494
2015,10,Sant Martí,73,la Verneda i la Pau,10128,1629,867,762
2015,10,Sant Martí,73,la Verneda i la Pau,10129,1201,617,584
2015,10,Sant Martí,73,la Verneda i la Pau,10130,1174,626,548
2015,10,Sant Martí,73,la Verneda i la Pau,10131,1179,638,541
2015,10,Sant Martí,73,la Verneda i la Pau,10132,1250,664,586
2015,10,Sant Martí,73,la Verneda i la Pau,10133,1689,890,799
2015,10,Sant Martí,73,la Verneda i la Pau,10134,1526,830,696
2015,10,Sant Martí,73,la Verneda i la Pau,10135,1208,644,564
2015,10,Sant Martí,73,la Verneda i la Pau,10136,1362,703,659
2015,10,Sant Martí,73,la Verneda i la Pau,10137,1582,818,764
2015,10,Sant Martí,73,la Verneda i la Pau,10138,1535,793,742
2015,10,Sant Martí,73,la Verneda i la Pau,10139,1613,815,798
2015,10,Sant Martí,73,la Verneda i la Pau,10140,1627,877,750
2015,10,Sant Martí,73,la Verneda i la Pau,10141,1104,584,520
2015,10,Sant Martí,73,la Verneda i la Pau,10142,1608,852,756
2015,10,Sant Martí,73,la Verneda i la Pau,10143,1703,883,820
2016,1,Ciutat Vella,1,el Raval,1001,1309,570,739
2016,1,Ciutat Vella,1,el Raval,1002,1546,681,865
2016,1,Ciutat Vella,1,el Raval,1003,3420,1546,1874
2016,1,Ciutat Vella,1,el Raval,1004,2753,1235,1518
2016,1,Ciutat Vella,1,el Raval,1005,2481,1088,1393
2016,1,Ciutat Vella,1,el Raval,1006,1549,672,877
2016,1,Ciutat Vella,1,el Raval,1007,2050,805,1245
2016,1,Ciutat Vella,1,el Raval,1008,3447,1306,2141
2016,1,Ciutat Vella,1,el Raval,1009,2151,951,1200
2016,1,Ciutat Vella,1,el Raval,1010,2482,1048,1434
2016,1,Ciutat Vella,1,el Raval,1011,3302,1423,1879
2016,1,Ciutat Vella,1,el Raval,1012,1878,900,978
2016,1,Ciutat Vella,1,el Raval,1013,1352,686,666
2016,1,Ciutat Vella,1,el Raval,1014,1936,917,1019
2016,1,Ciutat Vella,1,el Raval,1015,2270,1089,1181
2016,1,Ciutat Vella,1,el Raval,1016,2204,1084,1120
2016,1,Ciutat Vella,1,el Raval,1017,2625,1272,1353
2016,1,Ciutat Vella,1,el Raval,1018,1577,757,820
2016,1,Ciutat Vella,1,el Raval,1019,2810,1273,1537
2016,1,Ciutat Vella,1,el Raval,1020,2072,1102,970
2016,1,Ciutat Vella,1,el Raval,1021,1982,982,1000
2016,1,Ciutat Vella,2,el Barri Gòtic,1022,1209,652,557
2016,1,Ciutat Vella,2,el Barri Gòtic,1023,1943,1022,921
2016,1,Ciutat Vella,2,el Barri Gòtic,1025,1281,630,651
2016,1,Ciutat Vella,2,el Barri Gòtic,1026,2358,998,1360
2016,1,Ciutat Vella,2,el Barri Gòtic,1027,1611,772,839
2016,1,Ciutat Vella,2,el Barri Gòtic,1028,1895,959,936
2016,1,Ciutat Vella,2,el Barri Gòtic,1029,1376,666,710
2016,1,Ciutat Vella,2,el Barri Gòtic,1030,2453,1174,1279
2016,1,Ciutat Vella,2,el Barri Gòtic,1031,1603,694,909
2016,1,Ciutat Vella,3,la Barceloneta,1032,1777,877,900
2016,1,Ciutat Vella,3,la Barceloneta,1033,1138,519,619
2016,1,Ciutat Vella,3,la Barceloneta,1034,1001,515,486
2016,1,Ciutat Vella,3,la Barceloneta,1035,1326,646,680
2016,1,Ciutat Vella,3,la Barceloneta,1036,1172,624,548
2016,1,Ciutat Vella,3,la Barceloneta,1037,1474,770,704
2016,1,Ciutat Vella,3,la Barceloneta,1038,1501,717,784
2016,1,Ciutat Vella,3,la Barceloneta,1039,1295,637,658
2016,1,Ciutat Vella,3,la Barceloneta,1040,1109,549,560
2016,1,Ciutat Vella,3,la Barceloneta,1041,1474,717,757
2016,1,Ciutat Vella,3,la Barceloneta,1042,1801,976,825
2016,1,Ciutat Vella,4,"Sant Pere, Santa Caterina i la Ribera",1043,1286,638,648
2016,1,Ciutat Vella,4,"Sant Pere, Santa Caterina i la Ribera",1044,1448,759,689
2016,1,Ciutat Vella,4,"Sant Pere, Santa Caterina i la Ribera",1045,1979,974,1005
2016,1,Ciutat Vella,4,"Sant Pere, Santa Caterina i la Ribera",1046,1743,884,859
2016,1,Ciutat Vella,4,"Sant Pere, Santa Caterina i la Ribera",1047,1795,929,866
2016,1,Ciutat Vella,4,"Sant Pere, Santa Caterina i la Ribera",1048,2169,1061,1108
2016,1,Ciutat Vella,4,"Sant Pere, Santa Caterina i la Ribera",1049,1493,782,711
2016,1,Ciutat Vella,4,"Sant Pere, Santa Caterina i la Ribera",1050,1613,796,817
2016,1,Ciutat Vella,4,"Sant Pere, Santa Caterina i la Ribera",1051,1835,909,926
2016,1,Ciutat Vella,4,"Sant Pere, Santa Caterina i la Ribera",1052,2434,1163,1271
2016,1,Ciutat Vella,4,"Sant Pere, Santa Caterina i la Ribera",1053,1955,1003,952
2016,1,Ciutat Vella,4,"Sant Pere, Santa Caterina i la Ribera",1054,1343,669,674
2016,1,Ciutat Vella,4,"Sant Pere, Santa Caterina i la Ribera",1055,1287,677,610
2016,2,Eixample,5,el Fort Pienc,2001,1285,663,622
2016,2,Eixample,5,el Fort Pienc,2002,2208,1034,1174
2016,2,Eixample,5,el Fort Pienc,2003,1271,728,543
2016,2,Eixample,5,el Fort Pienc,2004,1478,754,724
2016,2,Eixample,5,el Fort Pienc,2005,2080,1126,954
2016,2,Eixample,5,el Fort Pienc,2006,1611,842,769
2016,2,Eixample,5,el Fort Pienc,2007,1260,711,549
2016,2,Eixample,5,el Fort Pienc,2008,1884,1021,863
2016,2,Eixample,5,el Fort Pienc,2009,1750,948,802
2016,2,Eixample,5,el Fort Pienc,2010,1167,627,540
2016,2,Eixample,5,el Fort Pienc,2011,1101,569,532
2016,2,Eixample,5,el Fort Pienc,2012,1555,802,753
2016,2,Eixample,5,el Fort Pienc,2013,1160,598,562
2016,2,Eixample,5,el Fort Pienc,2014,1311,659,652
2016,2,Eixample,5,el Fort Pienc,2015,1545,814,731
2016,2,Eixample,5,el Fort Pienc,2016,1873,1023,850
2016,2,Eixample,5,el Fort Pienc,2017,1971,1059,912
2016,2,Eixample,5,el Fort Pienc,2018,1846,983,863
2016,2,Eixample,5,el Fort Pienc,2019,1934,1031,903
2016,2,Eixample,5,el Fort Pienc,2020,1403,768,635
2016,2,Eixample,6,la Sagrada Família,2021,1456,777,679
2016,2,Eixample,6,la Sagrada Família,2022,1278,660,618
2016,2,Eixample,6,la Sagrada Família,2023,1086,575,511
2016,2,Eixample,6,la Sagrada Família,2024,1095,605,490
2016,2,Eixample,6,la Sagrada Família,2025,1210,642,568
2016,2,Eixample,6,la Sagrada Família,2026,2132,1157,975
2016,2,Eixample,6,la Sagrada Família,2027,1971,1080,891
2016,2,Eixample,6,la Sagrada Família,2028,2050,1101,949
2016,2,Eixample,6,la Sagrada Família,2029,1177,632,545
2016,2,Eixample,6,la Sagrada Família,2030,1246,659,587
2016,2,Eixample,6,la Sagrada Família,2031,1070,559,511
2016,2,Eixample,6,la Sagrada Família,2032,1204,713,491
2016,2,Eixample,6,la Sagrada Família,2033,1175,648,527
2016,2,Eixample,6,la Sagrada Família,2034,1194,644,550
2016,2,Eixample,6,la Sagrada Família,2035,1324,695,629
2016,2,Eixample,6,la Sagrada Família,2036,1216,657,559
2016,2,Eixample,6,la Sagrada Família,2037,1219,637,582
2016,2,Eixample,6,la Sagrada Família,2038,1608,853,755
2016,2,Eixample,6,la Sagrada Família,2039,1722,978,744
2016,2,Eixample,6,la Sagrada Família,2040,1651,887,764
2016,2,Eixample,6,la Sagrada Família,2041,1634,906,728
2016,2,Eixample,6,la Sagrada Família,2042,1663,895,768
2016,2,Eixample,6,la Sagrada Família,2043,1463,790,673
2016,2,Eixample,6,la Sagrada Família,2044,1251,706,545
2016,2,Eixample,6,la Sagrada Família,2045,1185,649,536
2016,2,Eixample,6,la Sagrada Família,2046,1850,1002,848
2016,2,Eixample,6,la Sagrada Família,2047,1919,1020,899
2016,2,Eixample,6,la Sagrada Família,2048,1240,679,561
2016,2,Eixample,6,la Sagrada Família,2049,2049,1127,922
2016,2,Eixample,6,la Sagrada Família,2050,1616,881,735
2016,2,Eixample,6,la Sagrada Família,2051,1895,1056,839
2016,2,Eixample,6,la Sagrada Família,2052,1832,999,833
2016,2,Eixample,6,la Sagrada Família,2053,1824,979,845
2016,2,Eixample,6,la Sagrada Família,2054,1849,1018,831
2016,2,Eixample,7,la Dreta de l'Eixample,2055,1862,1008,854
2016,2,Eixample,7,la Dreta de l'Eixample,2056,1471,842,629
2016,2,Eixample,7,la Dreta de l'Eixample,2057,1257,667,590
2016,2,Eixample,7,la Dreta de l'Eixample,2058,1378,753,625
2016,2,Eixample,7,la Dreta de l'Eixample,2059,1682,921,761
2016,2,Eixample,7,la Dreta de l'Eixample,2060,1704,927,777
2016,2,Eixample,7,la Dreta de l'Eixample,2061,1317,731,586
2016,2,Eixample,7,la Dreta de l'Eixample,2062,1530,824,706
2016,2,Eixample,7,la Dreta de l'Eixample,2063,1203,734,469
2016,2,Eixample,7,la Dreta de l'Eixample,2064,1345,712,633
2016,2,Eixample,7,la Dreta de l'Eixample,2065,1871,1010,861
2016,2,Eixample,7,la Dreta de l'Eixample,2066,1810,971,839
2016,2,Eixample,7,la Dreta de l'Eixample,2067,1680,910,770
2016,2,Eixample,7,la Dreta de l'Eixample,2068,1656,902,754
2016,2,Eixample,7,la Dreta de l'Eixample,2069,1374,722,652
2016,2,Eixample,7,la Dreta de l'Eixample,2070,1310,706,604
2016,2,Eixample,7,la Dreta de l'Eixample,2071,1688,871,817
2016,2,Eixample,7,la Dreta de l'Eixample,2072,1200,621,579
2016,2,Eixample,7,la Dreta de l'Eixample,2073,1683,876,807
2016,2,Eixample,7,la Dreta de l'Eixample,2074,1218,611,607
2016,2,Eixample,7,la Dreta de l'Eixample,2075,1253,665,588
2016,2,Eixample,7,la Dreta de l'Eixample,2076,1673,883,790
2016,2,Eixample,7,la Dreta de l'Eixample,2077,1523,749,774
2016,2,Eixample,7,la Dreta de l'Eixample,2078,1426,786,640
2016,2,Eixample,7,la Dreta de l'Eixample,2079,1261,660,601
2016,2,Eixample,7,la Dreta de l'Eixample,2080,1489,785,704
2016,2,Eixample,7,la Dreta de l'Eixample,2081,2135,1163,972
2016,2,Eixample,7,la Dreta de l'Eixample,2082,902,490,412
2016,2,Eixample,7,la Dreta de l'Eixample,2083,1791,987,804
2016,2,Eixample,8,l'Antiga Esquerra de l'Eixample,2084,2015,1112,903
2016,2,Eixample,8,l'Antiga Esquerra de l'Eixample,2085,1452,795,657
2016,2,Eixample,8,l'Antiga Esquerra de l'Eixample,2086,1430,786,644
2016,2,Eixample,8,l'Antiga Esquerra de l'Eixample,2087,1427,790,637
2016,2,Eixample,8,l'Antiga Esquerra de l'Eixample,2088,1646,908,738
2016,2,Eixample,8,l'Antiga Esquerra de l'Eixample,2089,1955,1031,924
2016,2,Eixample,8,l'Antiga Esquerra de l'Eixample,2090,1662,872,790
2016,2,Eixample,8,l'Antiga Esquerra de l'Eixample,2091,1836,931,905
2016,2,Eixample,8,l'Antiga Esquerra de l'Eixample,2092,1837,888,949
2016,2,Eixample,8,l'Antiga Esquerra de l'Eixample,2093,1564,802,762
2016,2,Eixample,8,l'Antiga Esquerra de l'Eixample,2094,1433,741,692
2016,2,Eixample,8,l'Antiga Esquerra de l'Eixample,2095,1525,803,722
2016,2,Eixample,8,l'Antiga Esquerra de l'Eixample,2096,1405,750,655
2016,2,Eixample,8,l'Antiga Esquerra de l'Eixample,2097,1107,594,513
2016,2,Eixample,8,l'Antiga Esquerra de l'Eixample,2098,1514,853,661
2016,2,Eixample,8,l'Antiga Esquerra de l'Eixample,2099,1494,796,698
2016,2,Eixample,8,l'Antiga Esquerra de l'Eixample,2100,1385,736,649
2016,2,Eixample,8,l'Antiga Esquerra de l'Eixample,2101,2121,1148,973
2016,2,Eixample,8,l'Antiga Esquerra de l'Eixample,2102,1447,803,644
2016,2,Eixample,8,l'Antiga Esquerra de l'Eixample,2103,1719,926,793
2016,2,Eixample,8,l'Antiga Esquerra de l'Eixample,2104,1141,621,520
2016,2,Eixample,8,l'Antiga Esquerra de l'Eixample,2105,2024,1130,894
2016,2,Eixample,8,l'Antiga Esquerra de l'Eixample,2106,1452,750,702
2016,2,Eixample,8,l'Antiga Esquerra de l'Eixample,2107,1635,904,731
2016,2,Eixample,8,l'Antiga Esquerra de l'Eixample,2108,1639,925,714
2016,2,Eixample,8,l'Antiga Esquerra de l'Eixample,2109,2030,1110,920
2016,2,Eixample,9,la Nova Esquerra de l'Eixample,2110,1885,1006,879
2016,2,Eixample,9,la Nova Esquerra de l'Eixample,2111,1751,964,787
2016,2,Eixample,9,la Nova Esquerra de l'Eixample,2112,1350,740,610
2016,2,Eixample,9,la Nova Esquerra de l'Eixample,2113,2065,1093,972
2016,2,Eixample,9,la Nova Esquerra de l'Eixample,2114,1646,907,739
2016,2,Eixample,9,la Nova Esquerra de l'Eixample,2115,1370,747,623
2016,2,Eixample,9,la Nova Esquerra de l'Eixample,2116,1069,572,497
2016,2,Eixample,9,la Nova Esquerra de l'Eixample,2117,1195,643,552
2016,2,Eixample,9,la Nova Esquerra de l'Eixample,2118,1473,792,681
2016,2,Eixample,9,la Nova Esquerra de l'Eixample,2119,1283,690,593
2016,2,Eixample,9,la Nova Esquerra de l'Eixample,2120,1203,638,565
2016,2,Eixample,9,la Nova Esquerra de l'Eixample,2121,1236,668,568
2016,2,Eixample,9,la Nova Esquerra de l'Eixample,2122,1083,611,472
2016,2,Eixample,9,la Nova Esquerra de l'Eixample,2123,1114,579,535
2016,2,Eixample,9,la Nova Esquerra de l'Eixample,2124,1130,613,517
2016,2,Eixample,9,la Nova Esquerra de l'Eixample,2125,1718,952,766
2016,2,Eixample,9,la Nova Esquerra de l'Eixample,2126,1522,823,699
2016,2,Eixample,9,la Nova Esquerra de l'Eixample,2127,1129,591,538
2016,2,Eixample,9,la Nova Esquerra de l'Eixample,2128,1298,684,614
2016,2,Eixample,9,la Nova Esquerra de l'Eixample,2129,1537,828,709
2016,2,Eixample,9,la Nova Esquerra de l'Eixample,2130,1115,570,545
2016,2,Eixample,9,la Nova Esquerra de l'Eixample,2131,1183,610,573
2016,2,Eixample,9,la Nova Esquerra de l'Eixample,2132,1207,636,571
2016,2,Eixample,9,la Nova Esquerra de l'Eixample,2133,856,469,387
2016,2,Eixample,9,la Nova Esquerra de l'Eixample,2134,1395,753,642
2016,2,Eixample,9,la Nova Esquerra de l'Eixample,2135,2081,1101,980
2016,2,Eixample,9,la Nova Esquerra de l'Eixample,2136,903,490,413
2016,2,Eixample,9,la Nova Esquerra de l'Eixample,2137,1410,762,648
2016,2,Eixample,9,la Nova Esquerra de l'Eixample,2138,1940,1017,923
2016,2,Eixample,9,la Nova Esquerra de l'Eixample,2139,1632,894,738
2016,2,Eixample,9,la Nova Esquerra de l'Eixample,2140,1922,1019,903
2016,2,Eixample,9,la Nova Esquerra de l'Eixample,2141,1247,682,565
2016,2,Eixample,9,la Nova Esquerra de l'Eixample,2142,2055,1106,949
2016,2,Eixample,9,la Nova Esquerra de l'Eixample,2143,1276,644,632
2016,2,Eixample,9,la Nova Esquerra de l'Eixample,2144,1474,784,690
2016,2,Eixample,9,la Nova Esquerra de l'Eixample,2145,1218,621,597
2016,2,Eixample,9,la Nova Esquerra de l'Eixample,2146,1141,609,532
2016,2,Eixample,9,la Nova Esquerra de l'Eixample,2147,2172,1190,982
2016,2,Eixample,9,la Nova Esquerra de l'Eixample,2148,1590,854,736
2016,2,Eixample,9,la Nova Esquerra de l'Eixample,2149,1825,966,859
2016,2,Eixample,10,Sant Antoni,2150,1508,792,716
2016,2,Eixample,10,Sant Antoni,2151,1464,778,686
2016,2,Eixample,10,Sant Antoni,2152,1238,687,551
2016,2,Eixample,10,Sant Antoni,2153,1319,721,598
2016,2,Eixample,10,Sant Antoni,2154,1045,547,498
2016,2,Eixample,10,Sant Antoni,2155,1875,1018,857
2016,2,Eixample,10,Sant Antoni,2156,1284,676,608
2016,2,Eixample,10,Sant Antoni,2157,1202,646,556
2016,2,Eixample,10,Sant Antoni,2158,1613,846,767
2016,2,Eixample,10,Sant Antoni,2159,1831,956,875
2016,2,Eixample,10,Sant Antoni,2160,2029,1049,980
2016,2,Eixample,10,Sant Antoni,2161,1123,593,530
2016,2,Eixample,10,Sant Antoni,2162,1384,730,654
2016,2,Eixample,10,Sant Antoni,2163,1814,959,855
2016,2,Eixample,10,Sant Antoni,2164,1429,755,674
2016,2,Eixample,10,Sant Antoni,2165,1649,867,782
2016,2,Eixample,10,Sant Antoni,2166,2153,1133,1020
2016,2,Eixample,10,Sant Antoni,2167,2120,1103,1017
2016,2,Eixample,10,Sant Antoni,2168,2189,1143,1046
2016,2,Eixample,10,Sant Antoni,2169,1580,804,776
2016,2,Eixample,10,Sant Antoni,2170,1575,812,763
2016,2,Eixample,10,Sant Antoni,2171,1645,869,776
2016,2,Eixample,10,Sant Antoni,2172,1596,811,785
2016,2,Eixample,10,Sant Antoni,2173,1570,841,729
2016,3,Sants-Montjuïc,11,el Poble-sec,3001,1651,885,766
2016,3,Sants-Montjuïc,11,el Poble-sec,3002,2039,1045,994
2016,3,Sants-Montjuïc,11,el Poble-sec,3003,1672,866,806
2016,3,Sants-Montjuïc,11,el Poble-sec,3004,1555,808,747
2016,3,Sants-Montjuïc,11,el Poble-sec,3005,1246,635,611
2016,3,Sants-Montjuïc,11,el Poble-sec,3006,1391,689,702
2016,3,Sants-Montjuïc,11,el Poble-sec,3007,1768,900,868
2016,3,Sants-Montjuïc,11,el Poble-sec,3008,1220,641,579
2016,3,Sants-Montjuïc,11,el Poble-sec,3009,1225,647,578
2016,3,Sants-Montjuïc,11,el Poble-sec,3010,1866,932,934
2016,3,Sants-Montjuïc,11,el Poble-sec,3011,1729,884,845
2016,3,Sants-Montjuïc,11,el Poble-sec,3012,2095,1086,1009
2016,3,Sants-Montjuïc,11,el Poble-sec,3013,1875,903,972
2016,3,Sants-Montjuïc,11,el Poble-sec,3014,1907,896,1011
2016,3,Sants-Montjuïc,11,el Poble-sec,3015,2974,1504,1470
2016,3,Sants-Montjuïc,11,el Poble-sec,3016,1202,597,605
2016,3,Sants-Montjuïc,11,el Poble-sec,3017,1659,806,853
2016,3,Sants-Montjuïc,11,el Poble-sec,3018,1708,859,849
2016,3,Sants-Montjuïc,11,el Poble-sec,3019,1498,791,707
2016,3,Sants-Montjuïc,11,el Poble-sec,3020,1206,595,611
2016,3,Sants-Montjuïc,11,el Poble-sec,3021,1147,614,533
2016,3,Sants-Montjuïc,11,el Poble-sec,3022,1442,737,705
2016,3,Sants-Montjuïc,11,el Poble-sec,3023,2031,996,1035
2016,3,Sants-Montjuïc,11,el Poble-sec,3024,2023,1016,1007
2016,3,Sants-Montjuïc,12,la Marina del Prat Vermell,3025,1146,565,581
2016,3,Sants-Montjuïc,13,la Marina de Port,3026,995,503,492
2016,3,Sants-Montjuïc,13,la Marina de Port,3027,1801,936,865
2016,3,Sants-Montjuïc,13,la Marina de Port,3028,2319,1210,1109
2016,3,Sants-Montjuïc,13,la Marina de Port,3029,1287,687,600
2016,3,Sants-Montjuïc,13,la Marina de Port,3030,1579,831,748
2016,3,Sants-Montjuïc,13,la Marina de Port,3031,2492,1286,1206
2016,3,Sants-Montjuïc,13,la Marina de Port,3032,1599,816,783
2016,3,Sants-Montjuïc,13,la Marina de Port,3033,1409,720,689
2016,3,Sants-Montjuïc,13,la Marina de Port,3034,1518,791,727
2016,3,Sants-Montjuïc,13,la Marina de Port,3035,2317,1212,1105
2016,3,Sants-Montjuïc,13,la Marina de Port,3036,2363,1226,1137
2016,3,Sants-Montjuïc,13,la Marina de Port,3037,1093,565,528
2016,3,Sants-Montjuïc,13,la Marina de Port,3038,1031,538,493
2016,3,Sants-Montjuïc,13,la Marina de Port,3039,2397,1218,1179
2016,3,Sants-Montjuïc,13,la Marina de Port,3211,1451,738,713
2016,3,Sants-Montjuïc,13,la Marina de Port,3212,2399,1274,1125
2016,3,Sants-Montjuïc,13,la Marina de Port,3213,2347,1182,1165
2016,3,Sants-Montjuïc,14,la Font de la Guatlla,3040,1518,789,729
2016,3,Sants-Montjuïc,14,la Font de la Guatlla,3041,1386,744,642
2016,3,Sants-Montjuïc,14,la Font de la Guatlla,3042,1380,705,675
2016,3,Sants-Montjuïc,14,la Font de la Guatlla,3043,1632,884,748
2016,3,Sants-Montjuïc,14,la Font de la Guatlla,3044,1912,1016,896
2016,3,Sants-Montjuïc,14,la Font de la Guatlla,3045,1048,543,505
2016,3,Sants-Montjuïc,14,la Font de la Guatlla,3046,1440,768,672
2016,3,Sants-Montjuïc,15,Hostafrancs,3047,1807,946,861
2016,3,Sants-Montjuïc,15,Hostafrancs,3048,1374,715,659
2016,3,Sants-Montjuïc,15,Hostafrancs,3049,1698,894,804
2016,3,Sants-Montjuïc,15,Hostafrancs,3050,1584,812,772
2016,3,Sants-Montjuïc,15,Hostafrancs,3051,1810,940,870
2016,3,Sants-Montjuïc,15,Hostafrancs,3052,1297,678,619
2016,3,Sants-Montjuïc,15,Hostafrancs,3053,2168,1113,1055
2016,3,Sants-Montjuïc,15,Hostafrancs,3054,1788,921,867
2016,3,Sants-Montjuïc,15,Hostafrancs,3055,1569,813,756
2016,3,Sants-Montjuïc,15,Hostafrancs,3056,820,456,364
2016,3,Sants-Montjuïc,16,la Bordeta,3057,1526,826,700
2016,3,Sants-Montjuïc,16,la Bordeta,3058,1359,777,582
2016,3,Sants-Montjuïc,16,la Bordeta,3059,1208,626,582
2016,3,Sants-Montjuïc,16,la Bordeta,3060,1327,690,637
2016,3,Sants-Montjuïc,16,la Bordeta,3061,1088,581,507
2016,3,Sants-Montjuïc,16,la Bordeta,3062,1667,895,772
2016,3,Sants-Montjuïc,16,la Bordeta,3063,1318,684,634
2016,3,Sants-Montjuïc,16,la Bordeta,3064,1231,663,568
2016,3,Sants-Montjuïc,16,la Bordeta,3065,1396,711,685
2016,3,Sants-Montjuïc,16,la Bordeta,3066,2351,1215,1136
2016,3,Sants-Montjuïc,16,la Bordeta,3067,1725,912,813
2016,3,Sants-Montjuïc,16,la Bordeta,3068,1150,620,530
2016,3,Sants-Montjuïc,16,la Bordeta,3069,1172,605,567
2016,3,Sants-Montjuïc,17,Sants - Badal,3070,1288,663,625
2016,3,Sants-Montjuïc,17,Sants - Badal,3071,1297,686,611
2016,3,Sants-Montjuïc,17,Sants - Badal,3072,1376,743,633
2016,3,Sants-Montjuïc,17,Sants - Badal,3073,1563,820,743
2016,3,Sants-Montjuïc,17,Sants - Badal,3074,1791,983,808
2016,3,Sants-Montjuïc,17,Sants - Badal,3075,1626,862,764
2016,3,Sants-Montjuïc,17,Sants - Badal,3076,1018,529,489
2016,3,Sants-Montjuïc,17,Sants - Badal,3077,1283,703,580
2016,3,Sants-Montjuïc,17,Sants - Badal,3078,1672,863,809
2016,3,Sants-Montjuïc,17,Sants - Badal,3079,1823,961,862
2016,3,Sants-Montjuïc,17,Sants - Badal,3080,1538,837,701
2016,3,Sants-Montjuïc,17,Sants - Badal,3081,1868,1012,856
2016,3,Sants-Montjuïc,17,Sants - Badal,3082,1803,957,846
2016,3,Sants-Montjuïc,17,Sants - Badal,3083,1347,725,622
2016,3,Sants-Montjuïc,17,Sants - Badal,3084,1436,777,659
2016,3,Sants-Montjuïc,17,Sants - Badal,3085,1206,643,563
2016,3,Sants-Montjuïc,18,Sants,3086,1260,663,597
2016,3,Sants-Montjuïc,18,Sants,3087,1499,805,694
2016,3,Sants-Montjuïc,18,Sants,3088,1433,774,659
2016,3,Sants-Montjuïc,18,Sants,3089,1199,645,554
2016,3,Sants-Montjuïc,18,Sants,3090,1051,562,489
2016,3,Sants-Montjuïc,18,Sants,3091,1430,747,683
2016,3,Sants-Montjuïc,18,Sants,3092,1275,655,620
2016,3,Sants-Montjuïc,18,Sants,3093,1540,805,735
2016,3,Sants-Montjuïc,18,Sants,3094,1143,612,531
2016,3,Sants-Montjuïc,18,Sants,3095,1632,886,746
2016,3,Sants-Montjuïc,18,Sants,3096,1514,798,716
2016,3,Sants-Montjuïc,18,Sants,3097,1651,853,798
2016,3,Sants-Montjuïc,18,Sants,3098,1367,708,659
2016,3,Sants-Montjuïc,18,Sants,3099,1008,550,458
2016,3,Sants-Montjuïc,18,Sants,3100,1237,649,588
2016,3,Sants-Montjuïc,18,Sants,3101,1815,888,927
2016,3,Sants-Montjuïc,18,Sants,3102,1326,699,627
2016,3,Sants-Montjuïc,18,Sants,3103,1193,629,564
2016,3,Sants-Montjuïc,18,Sants,3104,1455,771,684
2016,3,Sants-Montjuïc,18,Sants,3105,1181,639,542
2016,3,Sants-Montjuïc,18,Sants,3106,1243,677,566
2016,3,Sants-Montjuïc,18,Sants,3107,1510,763,747
2016,3,Sants-Montjuïc,18,Sants,3108,1582,861,721
2016,3,Sants-Montjuïc,18,Sants,3109,1495,805,690
2016,3,Sants-Montjuïc,18,Sants,3110,1538,816,722
2016,3,Sants-Montjuïc,18,Sants,3111,1304,706,598
2016,3,Sants-Montjuïc,18,Sants,3112,1879,1003,876
2016,3,Sants-Montjuïc,18,Sants,3113,1627,864,763
2016,3,Sants-Montjuïc,18,Sants,3114,1444,783,661
2016,4,Les Corts,19,les Corts,4001,1256,672,584
2016,4,Les Corts,19,les Corts,4002,1925,1013,912
2016,4,Les Corts,19,les Corts,4003,1096,551,545
2016,4,Les Corts,19,les Corts,4004,1012,548,464
2016,4,Les Corts,19,les Corts,4005,1240,659,581
2016,4,Les Corts,19,les Corts,4006,1144,612,532
2016,4,Les Corts,19,les Corts,4007,1066,601,465
2016,4,Les Corts,19,les Corts,4008,996,543,453
2016,4,Les Corts,19,les Corts,4009,1408,766,642
2016,4,Les Corts,19,les Corts,4010,944,512,432
2016,4,Les Corts,19,les Corts,4011,1660,869,791
2016,4,Les Corts,19,les Corts,4012,1402,754,648
2016,4,Les Corts,19,les Corts,4013,1253,688,565
2016,4,Les Corts,19,les Corts,4014,826,445,381
2016,4,Les Corts,19,les Corts,4015,1885,1010,875
2016,4,Les Corts,19,les Corts,4016,1081,575,506
2016,4,Les Corts,19,les Corts,4017,1110,601,509
2016,4,Les Corts,19,les Corts,4018,1520,834,686
2016,4,Les Corts,19,les Corts,4019,1309,708,601
2016,4,Les Corts,19,les Corts,4020,1438,769,669
2016,4,Les Corts,19,les Corts,4021,1267,688,579
2016,4,Les Corts,19,les Corts,4022,1557,835,722
2016,4,Les Corts,19,les Corts,4023,1097,581,516
2016,4,Les Corts,19,les Corts,4024,1062,560,502
2016,4,Les Corts,19,les Corts,4025,1173,625,548
2016,4,Les Corts,19,les Corts,4026,1370,752,618
2016,4,Les Corts,19,les Corts,4027,1173,624,549
2016,4,Les Corts,19,les Corts,4028,1365,718,647
2016,4,Les Corts,19,les Corts,4029,1171,633,538
2016,4,Les Corts,19,les Corts,4030,1735,938,797
2016,4,Les Corts,19,les Corts,4031,1848,865,983
2016,4,Les Corts,19,les Corts,4032,1539,844,695
2016,4,Les Corts,19,les Corts,4033,1168,632,536
2016,4,Les Corts,19,les Corts,4034,1480,786,694
2016,4,Les Corts,19,les Corts,4035,1400,756,644
2016,4,Les Corts,20,la Maternitat i Sant Ramon,4036,1716,933,783
2016,4,Les Corts,20,la Maternitat i Sant Ramon,4037,2102,1131,971
2016,4,Les Corts,20,la Maternitat i Sant Ramon,4038,1291,696,595
2016,4,Les Corts,20,la Maternitat i Sant Ramon,4039,1232,656,576
2016,4,Les Corts,20,la Maternitat i Sant Ramon,4040,1588,860,728
2016,4,Les Corts,20,la Maternitat i Sant Ramon,4041,1313,696,617
2016,4,Les Corts,20,la Maternitat i Sant Ramon,4042,1721,910,811
2016,4,Les Corts,20,la Maternitat i Sant Ramon,4043,1660,908,752
2016,4,Les Corts,20,la Maternitat i Sant Ramon,4044,1606,840,766
2016,4,Les Corts,20,la Maternitat i Sant Ramon,4045,1408,752,656
2016,4,Les Corts,20,la Maternitat i Sant Ramon,4046,2475,1264,1211
2016,4,Les Corts,20,la Maternitat i Sant Ramon,4047,1695,895,800
2016,4,Les Corts,20,la Maternitat i Sant Ramon,4048,1532,823,709
2016,4,Les Corts,20,la Maternitat i Sant Ramon,4049,1164,628,536
2016,4,Les Corts,20,la Maternitat i Sant Ramon,4084,1365,734,631
2016,4,Les Corts,21,Pedralbes,4050,2080,1108,972
2016,4,Les Corts,21,Pedralbes,4051,1612,884,728
2016,4,Les Corts,21,Pedralbes,4052,2134,1163,971
2016,4,Les Corts,21,Pedralbes,4053,1609,843,766
2016,4,Les Corts,21,Pedralbes,4054,1091,573,518
2016,4,Les Corts,21,Pedralbes,4055,1571,815,756
2016,4,Les Corts,21,Pedralbes,4056,1767,926,841
2016,5,Sarrià-Sant Gervasi,22,"Vallvidrera, el Tibidabo i les Planes",5001,1694,842,852
2016,5,Sarrià-Sant Gervasi,22,"Vallvidrera, el Tibidabo i les Planes",5002,1581,822,759
2016,5,Sarrià-Sant Gervasi,22,"Vallvidrera, el Tibidabo i les Planes",5003,1366,692,674
2016,5,Sarrià-Sant Gervasi,23,Sarrià,5004,1121,647,474
2016,5,Sarrià-Sant Gervasi,23,Sarrià,5005,1145,585,560
2016,5,Sarrià-Sant Gervasi,23,Sarrià,5006,1772,878,894
2016,5,Sarrià-Sant Gervasi,23,Sarrià,5007,1639,841,798
2016,5,Sarrià-Sant Gervasi,23,Sarrià,5008,1611,860,751
2016,5,Sarrià-Sant Gervasi,23,Sarrià,5009,1714,940,774
2016,5,Sarrià-Sant Gervasi,23,Sarrià,5010,1656,895,761
2016,5,Sarrià-Sant Gervasi,23,Sarrià,5011,1412,764,648
2016,5,Sarrià-Sant Gervasi,23,Sarrià,5012,1400,762,638
2016,5,Sarrià-Sant Gervasi,23,Sarrià,5013,1711,898,813
2016,5,Sarrià-Sant Gervasi,23,Sarrià,5014,1710,893,817
2016,5,Sarrià-Sant Gervasi,23,Sarrià,5015,1572,862,710
2016,5,Sarrià-Sant Gervasi,23,Sarrià,5016,1870,1023,847
2016,5,Sarrià-Sant Gervasi,23,Sarrià,5017,1590,847,743
2016,5,Sarrià-Sant Gervasi,23,Sarrià,5018,1198,665,533
2016,5,Sarrià-Sant Gervasi,23,Sarrià,5019,1689,903,786
2016,5,Sarrià-Sant Gervasi,24,les Tres Torres,5020,1115,618,497
2016,5,Sarrià-Sant Gervasi,24,les Tres Torres,5021,1311,708,603
2016,5,Sarrià-Sant Gervasi,24,les Tres Torres,5022,1758,994,764
2016,5,Sarrià-Sant Gervasi,24,les Tres Torres,5023,1474,822,652
2016,5,Sarrià-Sant Gervasi,24,les Tres Torres,5024,1902,1022,880
2016,5,Sarrià-Sant Gervasi,24,les Tres Torres,5025,1356,731,625
2016,5,Sarrià-Sant Gervasi,24,les Tres Torres,5026,1422,732,690
2016,5,Sarrià-Sant Gervasi,24,les Tres Torres,5027,1383,709,674
2016,5,Sarrià-Sant Gervasi,24,les Tres Torres,5028,1582,822,760
2016,5,Sarrià-Sant Gervasi,24,les Tres Torres,5029,1720,891,829
2016,5,Sarrià-Sant Gervasi,24,les Tres Torres,5030,1463,787,676
2016,5,Sarrià-Sant Gervasi,25,Sant Gervasi - la Bonanova,5031,1633,896,737
2016,5,Sarrià-Sant Gervasi,25,Sant Gervasi - la Bonanova,5032,1789,960,829
2016,5,Sarrià-Sant Gervasi,25,Sant Gervasi - la Bonanova,5033,1367,732,635
2016,5,Sarrià-Sant Gervasi,25,Sant Gervasi - la Bonanova,5034,1208,691,517
2016,5,Sarrià-Sant Gervasi,25,Sant Gervasi - la Bonanova,5035,1109,569,540
2016,5,Sarrià-Sant Gervasi,25,Sant Gervasi - la Bonanova,5036,1730,908,822
2016,5,Sarrià-Sant Gervasi,25,Sant Gervasi - la Bonanova,5037,1425,798,627
2016,5,Sarrià-Sant Gervasi,25,Sant Gervasi - la Bonanova,5038,1278,687,591
2016,5,Sarrià-Sant Gervasi,25,Sant Gervasi - la Bonanova,5039,1538,828,710
2016,5,Sarrià-Sant Gervasi,25,Sant Gervasi - la Bonanova,5040,1443,799,644
2016,5,Sarrià-Sant Gervasi,25,Sant Gervasi - la Bonanova,5041,1921,969,952
2016,5,Sarrià-Sant Gervasi,25,Sant Gervasi - la Bonanova,5042,1223,649,574
2016,5,Sarrià-Sant Gervasi,25,Sant Gervasi - la Bonanova,5043,1452,771,681
2016,5,Sarrià-Sant Gervasi,25,Sant Gervasi - la Bonanova,5044,1303,700,603
2016,5,Sarrià-Sant Gervasi,25,Sant Gervasi - la Bonanova,5045,1580,863,717
2016,5,Sarrià-Sant Gervasi,25,Sant Gervasi - la Bonanova,5046,1175,659,516
2016,5,Sarrià-Sant Gervasi,25,Sant Gervasi - la Bonanova,5047,1288,700,588
2016,5,Sarrià-Sant Gervasi,25,Sant Gervasi - la Bonanova,5048,1299,719,580
2016,5,Sarrià-Sant Gervasi,26,Sant Gervasi - Galvany,5049,1665,905,760
2016,5,Sarrià-Sant Gervasi,26,Sant Gervasi - Galvany,5050,1670,884,786
2016,5,Sarrià-Sant Gervasi,26,Sant Gervasi - Galvany,5051,1651,873,778
2016,5,Sarrià-Sant Gervasi,26,Sant Gervasi - Galvany,5052,1524,845,679
2016,5,Sarrià-Sant Gervasi,26,Sant Gervasi - Galvany,5053,1504,807,697
2016,5,Sarrià-Sant Gervasi,26,Sant Gervasi - Galvany,5054,1028,576,452
2016,5,Sarrià-Sant Gervasi,26,Sant Gervasi - Galvany,5055,1425,756,669
2016,5,Sarrià-Sant Gervasi,26,Sant Gervasi - Galvany,5056,1212,710,502
2016,5,Sarrià-Sant Gervasi,26,Sant Gervasi - Galvany,5057,1706,905,801
2016,5,Sarrià-Sant Gervasi,26,Sant Gervasi - Galvany,5058,1601,867,734
2016,5,Sarrià-Sant Gervasi,26,Sant Gervasi - Galvany,5059,1628,925,703
2016,5,Sarrià-Sant Gervasi,26,Sant Gervasi - Galvany,5060,1128,618,510
2016,5,Sarrià-Sant Gervasi,26,Sant Gervasi - Galvany,5061,1450,806,644
2016,5,Sarrià-Sant Gervasi,26,Sant Gervasi - Galvany,5062,1566,883,683
2016,5,Sarrià-Sant Gervasi,26,Sant Gervasi - Galvany,5063,1580,866,714
2016,5,Sarrià-Sant Gervasi,26,Sant Gervasi - Galvany,5064,1591,886,705
2016,5,Sarrià-Sant Gervasi,26,Sant Gervasi - Galvany,5065,1648,910,738
2016,5,Sarrià-Sant Gervasi,26,Sant Gervasi - Galvany,5066,1203,668,535
2016,5,Sarrià-Sant Gervasi,26,Sant Gervasi - Galvany,5067,1291,703,588
2016,5,Sarrià-Sant Gervasi,26,Sant Gervasi - Galvany,5068,1526,827,699
2016,5,Sarrià-Sant Gervasi,26,Sant Gervasi - Galvany,5069,1699,930,769
2016,5,Sarrià-Sant Gervasi,26,Sant Gervasi - Galvany,5070,1456,810,646
2016,5,Sarrià-Sant Gervasi,26,Sant Gervasi - Galvany,5071,1586,875,711
2016,5,Sarrià-Sant Gervasi,26,Sant Gervasi - Galvany,5072,1644,922,722
2016,5,Sarrià-Sant Gervasi,26,Sant Gervasi - Galvany,5073,1603,890,713
2016,5,Sarrià-Sant Gervasi,26,Sant Gervasi - Galvany,5074,1699,910,789
2016,5,Sarrià-Sant Gervasi,26,Sant Gervasi - Galvany,5075,1764,999,765
2016,5,Sarrià-Sant Gervasi,26,Sant Gervasi - Galvany,5076,1336,732,604
2016,5,Sarrià-Sant Gervasi,26,Sant Gervasi - Galvany,5077,1469,818,651
2016,5,Sarrià-Sant Gervasi,26,Sant Gervasi - Galvany,5078,2065,1095,970
2016,5,Sarrià-Sant Gervasi,26,Sant Gervasi - Galvany,5079,1238,690,548
2016,5,Sarrià-Sant Gervasi,27,el Putget i Farró,5080,1367,765,602
2016,5,Sarrià-Sant Gervasi,27,el Putget i Farró,5081,1605,897,708
2016,5,Sarrià-Sant Gervasi,27,el Putget i Farró,5082,1658,904,754
2016,5,Sarrià-Sant Gervasi,27,el Putget i Farró,5083,1297,701,596
2016,5,Sarrià-Sant Gervasi,27,el Putget i Farró,5084,1339,745,594
2016,5,Sarrià-Sant Gervasi,27,el Putget i Farró,5085,1309,696,613
2016,5,Sarrià-Sant Gervasi,27,el Putget i Farró,5086,1339,723,616
2016,5,Sarrià-Sant Gervasi,27,el Putget i Farró,5087,1537,859,678
2016,5,Sarrià-Sant Gervasi,27,el Putget i Farró,5088,1724,902,822
2016,5,Sarrià-Sant Gervasi,27,el Putget i Farró,5089,1708,909,799
2016,5,Sarrià-Sant Gervasi,27,el Putget i Farró,5090,1881,1002,879
2016,5,Sarrià-Sant Gervasi,27,el Putget i Farró,5091,1531,862,669
2016,5,Sarrià-Sant Gervasi,27,el Putget i Farró,5092,1495,823,672
2016,5,Sarrià-Sant Gervasi,27,el Putget i Farró,5093,1153,643,510
2016,5,Sarrià-Sant Gervasi,27,el Putget i Farró,5094,2591,1427,1164
2016,5,Sarrià-Sant Gervasi,27,el Putget i Farró,5095,1614,899,715
2016,5,Sarrià-Sant Gervasi,27,el Putget i Farró,5096,1084,596,488
2016,5,Sarrià-Sant Gervasi,27,el Putget i Farró,5097,1599,846,753
2016,5,Sarrià-Sant Gervasi,27,el Putget i Farró,5098,1487,810,677
2016,6,Gràcia,28,Vallcarca i els Penitents,6001,1147,635,512
2016,6,Gràcia,28,Vallcarca i els Penitents,6002,1455,786,669
2016,6,Gràcia,28,Vallcarca i els Penitents,6003,2228,1166,1062
2016,6,Gràcia,28,Vallcarca i els Penitents,6004,1464,749,715
2016,6,Gràcia,28,Vallcarca i els Penitents,6006,1009,545,464
2016,6,Gràcia,28,Vallcarca i els Penitents,6007,1828,971,857
2016,6,Gràcia,28,Vallcarca i els Penitents,6008,1886,1054,832
2016,6,Gràcia,28,Vallcarca i els Penitents,6009,1235,651,584
2016,6,Gràcia,28,Vallcarca i els Penitents,6010,1028,549,479
2016,6,Gràcia,28,Vallcarca i els Penitents,6011,1246,665,581
2016,6,Gràcia,28,Vallcarca i els Penitents,6012,1103,590,513
2016,6,Gràcia,29,el Coll,6013,1721,904,817
2016,6,Gràcia,29,el Coll,6014,1347,722,625
2016,6,Gràcia,29,el Coll,6015,1391,740,651
2016,6,Gràcia,29,el Coll,6016,1608,862,746
2016,6,Gràcia,29,el Coll,6017,1324,701,623
2016,6,Gràcia,30,la Salut,6018,1278,656,622
2016,6,Gràcia,30,la Salut,6019,1513,821,692
2016,6,Gràcia,30,la Salut,6020,1125,599,526
2016,6,Gràcia,30,la Salut,6021,1356,744,612
2016,6,Gràcia,30,la Salut,6022,1342,678,664
2016,6,Gràcia,30,la Salut,6023,1316,688,628
2016,6,Gràcia,30,la Salut,6024,1583,895,688
2016,6,Gràcia,30,la Salut,6025,1413,789,624
2016,6,Gràcia,30,la Salut,6026,1019,555,464
2016,6,Gràcia,30,la Salut,6027,1178,664,514
2016,6,Gràcia,31,Vila de Gràcia,6028,1327,704,623
2016,6,Gràcia,31,Vila de Gràcia,6029,1244,684,560
2016,6,Gràcia,31,Vila de Gràcia,6030,1353,735,618
2016,6,Gràcia,31,Vila de Gràcia,6031,1089,613,476
2016,6,Gràcia,31,Vila de Gràcia,6032,1168,617,551
2016,6,Gràcia,31,Vila de Gràcia,6033,1298,702,596
2016,6,Gràcia,31,Vila de Gràcia,6034,1272,711,561
2016,6,Gràcia,31,Vila de Gràcia,6035,1021,562,459
2016,6,Gràcia,31,Vila de Gràcia,6036,1384,775,609
2016,6,Gràcia,31,Vila de Gràcia,6037,1107,602,505
2016,6,Gràcia,31,Vila de Gràcia,6038,1489,850,639
2016,6,Gràcia,31,Vila de Gràcia,6039,1591,898,693
2016,6,Gràcia,31,Vila de Gràcia,6040,1648,962,686
2016,6,Gràcia,31,Vila de Gràcia,6041,1690,924,766
2016,6,Gràcia,31,Vila de Gràcia,6042,1743,940,803
2016,6,Gràcia,31,Vila de Gràcia,6043,1262,692,570
2016,6,Gràcia,31,Vila de Gràcia,6044,1440,770,670
2016,6,Gràcia,31,Vila de Gràcia,6045,1319,724,595
2016,6,Gràcia,31,Vila de Gràcia,6046,1132,620,512
2016,6,Gràcia,31,Vila de Gràcia,6047,1811,895,916
2016,6,Gràcia,31,Vila de Gràcia,6048,1421,763,658
2016,6,Gràcia,31,Vila de Gràcia,6049,1128,620,508
2016,6,Gràcia,31,Vila de Gràcia,6050,1235,652,583
2016,6,Gràcia,31,Vila de Gràcia,6051,1321,743,578
2016,6,Gràcia,31,Vila de Gràcia,6052,1566,836,730
2016,6,Gràcia,31,Vila de Gràcia,6053,1482,800,682
2016,6,Gràcia,31,Vila de Gràcia,6054,1643,878,765
2016,6,Gràcia,31,Vila de Gràcia,6055,1413,798,615
2016,6,Gràcia,31,Vila de Gràcia,6056,1559,836,723
2016,6,Gràcia,31,Vila de Gràcia,6057,1513,841,672
2016,6,Gràcia,31,Vila de Gràcia,6058,1628,907,721
2016,6,Gràcia,31,Vila de Gràcia,6059,1453,772,681
2016,6,Gràcia,31,Vila de Gràcia,6060,1784,955,829
2016,6,Gràcia,31,Vila de Gràcia,6061,1308,713,595
2016,6,Gràcia,31,Vila de Gràcia,6062,1322,706,616
2016,6,Gràcia,31,Vila de Gràcia,6063,1506,802,704
2016,6,Gràcia,32,el Camp d'en Grassot i Gràcia Nova,6064,1922,1049,873
2016,6,Gràcia,32,el Camp d'en Grassot i Gràcia Nova,6065,1187,643,544
2016,6,Gràcia,32,el Camp d'en Grassot i Gràcia Nova,6066,974,538,436
2016,6,Gràcia,32,el Camp d'en Grassot i Gràcia Nova,6067,1790,980,810
2016,6,Gràcia,32,el Camp d'en Grassot i Gràcia Nova,6068,1494,835,659
2016,6,Gràcia,32,el Camp d'en Grassot i Gràcia Nova,6069,1097,588,509
2016,6,Gràcia,32,el Camp d'en Grassot i Gràcia Nova,6070,1871,1049,822
2016,6,Gràcia,32,el Camp d'en Grassot i Gràcia Nova,6071,1076,575,501
2016,6,Gràcia,32,el Camp d'en Grassot i Gràcia Nova,6072,1600,890,710
2016,6,Gràcia,32,el Camp d'en Grassot i Gràcia Nova,6073,1403,749,654
2016,6,Gràcia,32,el Camp d'en Grassot i Gràcia Nova,6074,1131,599,532
2016,6,Gràcia,32,el Camp d'en Grassot i Gràcia Nova,6075,1082,580,502
2016,6,Gràcia,32,el Camp d'en Grassot i Gràcia Nova,6076,1282,654,628
2016,6,Gràcia,32,el Camp d'en Grassot i Gràcia Nova,6077,1189,673,516
2016,6,Gràcia,32,el Camp d'en Grassot i Gràcia Nova,6078,1303,689,614
2016,6,Gràcia,32,el Camp d'en Grassot i Gràcia Nova,6079,1146,622,524
2016,6,Gràcia,32,el Camp d'en Grassot i Gràcia Nova,6080,1163,620,543
2016,6,Gràcia,32,el Camp d'en Grassot i Gràcia Nova,6081,1274,698,576
2016,6,Gràcia,32,el Camp d'en Grassot i Gràcia Nova,6082,1784,992,792
2016,6,Gràcia,32,el Camp d'en Grassot i Gràcia Nova,6083,1732,906,826
2016,6,Gràcia,32,el Camp d'en Grassot i Gràcia Nova,6084,1465,788,677
2016,6,Gràcia,32,el Camp d'en Grassot i Gràcia Nova,6085,1240,685,555
2016,6,Gràcia,32,el Camp d'en Grassot i Gràcia Nova,6086,971,517,454
2016,6,Gràcia,32,el Camp d'en Grassot i Gràcia Nova,6087,1884,1036,848
2016,6,Gràcia,32,el Camp d'en Grassot i Gràcia Nova,6088,1215,670,545
2016,7,Horta-Guinardó,33,el Baix Guinardó,7001,1582,869,713
2016,7,Horta-Guinardó,33,el Baix Guinardó,7002,1144,614,530
2016,7,Horta-Guinardó,33,el Baix Guinardó,7003,1299,694,605
2016,7,Horta-Guinardó,33,el Baix Guinardó,7004,1521,813,708
2016,7,Horta-Guinardó,33,el Baix Guinardó,7005,1453,770,683
2016,7,Horta-Guinardó,33,el Baix Guinardó,7006,948,511,437
2016,7,Horta-Guinardó,33,el Baix Guinardó,7007,1424,789,635
2016,7,Horta-Guinardó,33,el Baix Guinardó,7008,1395,711,684
2016,7,Horta-Guinardó,33,el Baix Guinardó,7009,1178,653,525
2016,7,Horta-Guinardó,33,el Baix Guinardó,7010,1338,700,638
2016,7,Horta-Guinardó,33,el Baix Guinardó,7011,1123,615,508
2016,7,Horta-Guinardó,33,el Baix Guinardó,7012,1579,861,718
2016,7,Horta-Guinardó,33,el Baix Guinardó,7013,1205,635,570
2016,7,Horta-Guinardó,33,el Baix Guinardó,7014,907,479,428
2016,7,Horta-Guinardó,33,el Baix Guinardó,7015,1383,738,645
2016,7,Horta-Guinardó,33,el Baix Guinardó,7016,1326,672,654
2016,7,Horta-Guinardó,33,el Baix Guinardó,7017,1646,933,713
2016,7,Horta-Guinardó,33,el Baix Guinardó,7018,1646,909,737
2016,7,Horta-Guinardó,33,el Baix Guinardó,7019,1466,788,678
2016,7,Horta-Guinardó,34,Can Baró,7020,1588,854,734
2016,7,Horta-Guinardó,34,Can Baró,7021,1027,528,499
2016,7,Horta-Guinardó,34,Can Baró,7022,1142,596,546
2016,7,Horta-Guinardó,34,Can Baró,7023,1317,668,649
2016,7,Horta-Guinardó,34,Can Baró,7024,1434,759,675
2016,7,Horta-Guinardó,34,Can Baró,7025,1407,759,648
2016,7,Horta-Guinardó,34,Can Baró,7026,1054,566,488
2016,7,Horta-Guinardó,35,el Guinardó,7027,1973,1064,909
2016,7,Horta-Guinardó,35,el Guinardó,7028,1472,772,700
2016,7,Horta-Guinardó,35,el Guinardó,7029,1289,649,640
2016,7,Horta-Guinardó,35,el Guinardó,7030,1370,747,623
2016,7,Horta-Guinardó,35,el Guinardó,7031,1545,805,740
2016,7,Horta-Guinardó,35,el Guinardó,7032,1349,681,668
2016,7,Horta-Guinardó,35,el Guinardó,7033,1382,734,648
2016,7,Horta-Guinardó,35,el Guinardó,7034,1676,883,793
2016,7,Horta-Guinardó,35,el Guinardó,7035,1744,968,776
2016,7,Horta-Guinardó,35,el Guinardó,7036,1358,737,621
2016,7,Horta-Guinardó,35,el Guinardó,7037,1474,809,665
2016,7,Horta-Guinardó,35,el Guinardó,7038,1320,711,609
2016,7,Horta-Guinardó,35,el Guinardó,7039,1560,829,731
2016,7,Horta-Guinardó,35,el Guinardó,7040,1471,793,678
2016,7,Horta-Guinardó,35,el Guinardó,7041,1332,742,590
2016,7,Horta-Guinardó,35,el Guinardó,7042,1546,846,700
2016,7,Horta-Guinardó,35,el Guinardó,7043,1370,731,639
2016,7,Horta-Guinardó,35,el Guinardó,7044,1298,690,608
2016,7,Horta-Guinardó,35,el Guinardó,7045,1482,772,710
2016,7,Horta-Guinardó,35,el Guinardó,7046,1416,761,655
2016,7,Horta-Guinardó,35,el Guinardó,7047,1426,756,670
2016,7,Horta-Guinardó,35,el Guinardó,7048,1215,672,543
2016,7,Horta-Guinardó,35,el Guinardó,7049,1229,640,589
2016,7,Horta-Guinardó,35,el Guinardó,7050,1137,609,528
2016,7,Horta-Guinardó,35,el Guinardó,7051,1742,951,791
2016,7,Horta-Guinardó,36,la Font d'en Fargues,7052,1221,653,568
2016,7,Horta-Guinardó,36,la Font d'en Fargues,7053,1463,763,700
2016,7,Horta-Guinardó,36,la Font d'en Fargues,7054,1540,811,729
2016,7,Horta-Guinardó,36,la Font d'en Fargues,7055,1183,617,566
2016,7,Horta-Guinardó,36,la Font d'en Fargues,7056,1166,600,566
2016,7,Horta-Guinardó,36,la Font d'en Fargues,7057,1451,782,669
2016,7,Horta-Guinardó,36,la Font d'en Fargues,7058,1378,704,674
2016,7,Horta-Guinardó,37,el Carmel,7059,1288,678,610
2016,7,Horta-Guinardó,37,el Carmel,7060,1827,923,904
2016,7,Horta-Guinardó,37,el Carmel,7061,1205,596,609
2016,7,Horta-Guinardó,37,el Carmel,7062,1286,673,613
2016,7,Horta-Guinardó,37,el Carmel,7063,1438,729,709
2016,7,Horta-Guinardó,37,el Carmel,7064,1636,851,785
2016,7,Horta-Guinardó,37,el Carmel,7065,1605,829,776
2016,7,Horta-Guinardó,37,el Carmel,7066,1748,922,826
2016,7,Horta-Guinardó,37,el Carmel,7067,1484,794,690
2016,7,Horta-Guinardó,37,el Carmel,7068,1217,649,568
2016,7,Horta-Guinardó,37,el Carmel,7069,1452,739,713
2016,7,Horta-Guinardó,37,el Carmel,7070,1355,715,640
2016,7,Horta-Guinardó,37,el Carmel,7071,1319,704,615
2016,7,Horta-Guinardó,37,el Carmel,7072,1367,715,652
2016,7,Horta-Guinardó,37,el Carmel,7073,1071,599,472
2016,7,Horta-Guinardó,37,el Carmel,7074,1711,900,811
2016,7,Horta-Guinardó,37,el Carmel,7075,1236,638,598
2016,7,Horta-Guinardó,37,el Carmel,7076,1328,690,638
2016,7,Horta-Guinardó,37,el Carmel,7077,1324,687,637
2016,7,Horta-Guinardó,37,el Carmel,7078,1327,670,657
2016,7,Horta-Guinardó,37,el Carmel,7079,1367,707,660
2016,7,Horta-Guinardó,37,el Carmel,7080,1786,952,834
2016,7,Horta-Guinardó,38,la Teixonera,7081,1931,991,940
2016,7,Horta-Guinardó,38,la Teixonera,7082,1253,641,612
2016,7,Horta-Guinardó,38,la Teixonera,7083,1238,644,594
2016,7,Horta-Guinardó,38,la Teixonera,7084,1292,658,634
2016,7,Horta-Guinardó,38,la Teixonera,7085,1276,666,610
2016,7,Horta-Guinardó,38,la Teixonera,7086,1429,736,693
2016,7,Horta-Guinardó,38,la Teixonera,7087,1553,810,743
2016,7,Horta-Guinardó,38,la Teixonera,7088,1309,670,639
2016,7,Horta-Guinardó,39,Sant Genís dels Agudells,7089,1312,726,586
2016,7,Horta-Guinardó,39,Sant Genís dels Agudells,7090,1385,702,683
2016,7,Horta-Guinardó,39,Sant Genís dels Agudells,7091,1136,602,534
2016,7,Horta-Guinardó,39,Sant Genís dels Agudells,7092,1317,729,588
2016,7,Horta-Guinardó,39,Sant Genís dels Agudells,7093,1545,821,724
2016,7,Horta-Guinardó,40,Montbau,7094,1244,705,539
2016,7,Horta-Guinardó,40,Montbau,7095,1504,820,684
2016,7,Horta-Guinardó,40,Montbau,7096,1381,749,632
2016,7,Horta-Guinardó,40,Montbau,7097,924,528,396
2016,7,Horta-Guinardó,41,la Vall d'Hebron,7098,2064,1092,972
2016,7,Horta-Guinardó,41,la Vall d'Hebron,7099,1082,562,520
2016,7,Horta-Guinardó,41,la Vall d'Hebron,7100,1179,636,543
2016,7,Horta-Guinardó,41,la Vall d'Hebron,7101,1362,703,659
2016,7,Horta-Guinardó,42,la Clota,7102,590,282,308
2016,7,Horta-Guinardó,43,Horta,7103,1436,762,674
2016,7,Horta-Guinardó,43,Horta,7104,1572,836,736
2016,7,Horta-Guinardó,43,Horta,7105,1085,570,515
2016,7,Horta-Guinardó,43,Horta,7106,1152,612,540
2016,7,Horta-Guinardó,43,Horta,7107,1254,650,604
2016,7,Horta-Guinardó,43,Horta,7108,1211,623,588
2016,7,Horta-Guinardó,43,Horta,7109,1621,859,762
2016,7,Horta-Guinardó,43,Horta,7110,1045,599,446
2016,7,Horta-Guinardó,43,Horta,7111,879,491,388
2016,7,Horta-Guinardó,43,Horta,7112,1242,657,585
2016,7,Horta-Guinardó,43,Horta,7113,1198,610,588
2016,7,Horta-Guinardó,43,Horta,7114,1185,643,542
2016,7,Horta-Guinardó,43,Horta,7115,1162,569,593
2016,7,Horta-Guinardó,43,Horta,7116,1460,772,688
2016,7,Horta-Guinardó,43,Horta,7117,1597,718,879
2016,7,Horta-Guinardó,43,Horta,7118,1236,702,534
2016,7,Horta-Guinardó,43,Horta,7119,1170,642,528
2016,7,Horta-Guinardó,43,Horta,7120,1201,649,552
2016,7,Horta-Guinardó,43,Horta,7121,1183,646,537
2016,7,Horta-Guinardó,43,Horta,7122,1329,736,593
2016,7,Horta-Guinardó,43,Horta,7123,1379,723,656
2016,8,Nou Barris,44,Vilapicina i la Torre Llobeta,8001,1292,691,601
2016,8,Nou Barris,44,Vilapicina i la Torre Llobeta,8002,1265,674,591
2016,8,Nou Barris,44,Vilapicina i la Torre Llobeta,8003,1220,638,582
2016,8,Nou Barris,44,Vilapicina i la Torre Llobeta,8004,1407,761,646
2016,8,Nou Barris,44,Vilapicina i la Torre Llobeta,8005,1151,613,538
2016,8,Nou Barris,44,Vilapicina i la Torre Llobeta,8006,1472,782,690
2016,8,Nou Barris,44,Vilapicina i la Torre Llobeta,8007,1186,666,520
2016,8,Nou Barris,44,Vilapicina i la Torre Llobeta,8008,1579,841,738
2016,8,Nou Barris,44,Vilapicina i la Torre Llobeta,8009,1665,889,776
2016,8,Nou Barris,44,Vilapicina i la Torre Llobeta,8010,1126,602,524
2016,8,Nou Barris,44,Vilapicina i la Torre Llobeta,8011,1189,648,541
2016,8,Nou Barris,44,Vilapicina i la Torre Llobeta,8012,1327,730,597
2016,8,Nou Barris,44,Vilapicina i la Torre Llobeta,8013,1201,657,544
2016,8,Nou Barris,44,Vilapicina i la Torre Llobeta,8014,1173,630,543
2016,8,Nou Barris,44,Vilapicina i la Torre Llobeta,8015,1386,774,612
2016,8,Nou Barris,44,Vilapicina i la Torre Llobeta,8016,1149,636,513
2016,8,Nou Barris,44,Vilapicina i la Torre Llobeta,8017,1344,711,633
2016,8,Nou Barris,44,Vilapicina i la Torre Llobeta,8018,1580,858,722
2016,8,Nou Barris,44,Vilapicina i la Torre Llobeta,8019,1810,979,831
2016,8,Nou Barris,45,Porta,8020,1252,684,568
2016,8,Nou Barris,45,Porta,8021,1443,788,655
2016,8,Nou Barris,45,Porta,8022,1222,664,558
2016,8,Nou Barris,45,Porta,8023,1346,708,638
2016,8,Nou Barris,45,Porta,8024,1398,765,633
2016,8,Nou Barris,45,Porta,8025,1188,662,526
2016,8,Nou Barris,45,Porta,8026,1392,749,643
2016,8,Nou Barris,45,Porta,8027,1290,646,644
2016,8,Nou Barris,45,Porta,8028,1093,597,496
2016,8,Nou Barris,45,Porta,8029,1514,816,698
2016,8,Nou Barris,45,Porta,8030,1447,758,689
2016,8,Nou Barris,45,Porta,8031,1297,675,622
2016,8,Nou Barris,45,Porta,8032,1290,692,598
2016,8,Nou Barris,45,Porta,8033,1417,731,686
2016,8,Nou Barris,45,Porta,8034,1197,667,530
2016,8,Nou Barris,45,Porta,8035,1800,861,939
2016,8,Nou Barris,45,Porta,8036,1452,776,676
2016,8,Nou Barris,45,Porta,8037,1529,836,693
2016,8,Nou Barris,46,el Turó de la Peira,8038,1473,824,649
2016,8,Nou Barris,46,el Turó de la Peira,8039,1519,829,690
2016,8,Nou Barris,46,el Turó de la Peira,8040,1658,881,777
2016,8,Nou Barris,46,el Turó de la Peira,8041,2331,1209,1122
2016,8,Nou Barris,46,el Turó de la Peira,8042,1290,701,589
2016,8,Nou Barris,46,el Turó de la Peira,8043,1148,640,508
2016,8,Nou Barris,46,el Turó de la Peira,8044,1344,710,634
2016,8,Nou Barris,46,el Turó de la Peira,8045,1684,887,797
2016,8,Nou Barris,46,el Turó de la Peira,8046,1344,744,600
2016,8,Nou Barris,46,el Turó de la Peira,8047,1543,819,724
2016,8,Nou Barris,47,Can Peguera,8048,1024,546,478
2016,8,Nou Barris,47,Can Peguera,8049,1231,645,586
2016,8,Nou Barris,48,la Guineueta,8050,1425,754,671
2016,8,Nou Barris,48,la Guineueta,8051,1340,696,644
2016,8,Nou Barris,48,la Guineueta,8052,865,482,383
2016,8,Nou Barris,48,la Guineueta,8053,1128,590,538
2016,8,Nou Barris,48,la Guineueta,8054,1672,927,745
2016,8,Nou Barris,48,la Guineueta,8055,1884,985,899
2016,8,Nou Barris,48,la Guineueta,8056,1437,767,670
2016,8,Nou Barris,48,la Guineueta,8057,1324,693,631
2016,8,Nou Barris,48,la Guineueta,8058,1587,858,729
2016,8,Nou Barris,48,la Guineueta,8059,972,512,460
2016,8,Nou Barris,48,la Guineueta,8215,1416,785,631
2016,8,Nou Barris,49,Canyelles,8060,1181,623,558
2016,8,Nou Barris,49,Canyelles,8061,1703,861,842
2016,8,Nou Barris,49,Canyelles,8062,1184,617,567
2016,8,Nou Barris,49,Canyelles,8063,1122,589,533
2016,8,Nou Barris,49,Canyelles,8064,1735,917,818
2016,8,Nou Barris,50,les Roquetes,8065,1662,806,856
2016,8,Nou Barris,50,les Roquetes,8066,1573,795,778
2016,8,Nou Barris,50,les Roquetes,8067,1592,810,782
2016,8,Nou Barris,50,les Roquetes,8068,1820,970,850
2016,8,Nou Barris,50,les Roquetes,8069,1458,749,709
2016,8,Nou Barris,50,les Roquetes,8070,1408,738,670
2016,8,Nou Barris,50,les Roquetes,8071,1609,837,772
2016,8,Nou Barris,50,les Roquetes,8072,1191,631,560
2016,8,Nou Barris,50,les Roquetes,8073,1674,894,780
2016,8,Nou Barris,50,les Roquetes,8074,1423,735,688
2016,8,Nou Barris,51,Verdun,8075,1821,964,857
2016,8,Nou Barris,51,Verdun,8076,1567,824,743
2016,8,Nou Barris,51,Verdun,8077,1404,746,658
2016,8,Nou Barris,51,Verdun,8078,1503,811,692
2016,8,Nou Barris,51,Verdun,8079,1390,753,637
2016,8,Nou Barris,51,Verdun,8080,1464,801,663
2016,8,Nou Barris,51,Verdun,8081,1559,824,735
2016,8,Nou Barris,51,Verdun,8082,1553,851,702
2016,8,Nou Barris,52,la Prosperitat,8083,1258,675,583
2016,8,Nou Barris,52,la Prosperitat,8084,1161,621,540
2016,8,Nou Barris,52,la Prosperitat,8085,1407,731,676
2016,8,Nou Barris,52,la Prosperitat,8086,1668,888,780
2016,8,Nou Barris,52,la Prosperitat,8087,1222,662,560
2016,8,Nou Barris,52,la Prosperitat,8088,1244,660,584
2016,8,Nou Barris,52,la Prosperitat,8089,1231,656,575
2016,8,Nou Barris,52,la Prosperitat,8090,1228,654,574
2016,8,Nou Barris,52,la Prosperitat,8091,1170,586,584
2016,8,Nou Barris,52,la Prosperitat,8092,1008,506,502
2016,8,Nou Barris,52,la Prosperitat,8093,1249,638,611
2016,8,Nou Barris,52,la Prosperitat,8094,1503,782,721
2016,8,Nou Barris,52,la Prosperitat,8095,1097,572,525
2016,8,Nou Barris,52,la Prosperitat,8096,1425,729,696
2016,8,Nou Barris,52,la Prosperitat,8097,1338,699,639
2016,8,Nou Barris,52,la Prosperitat,8098,1235,647,588
2016,8,Nou Barris,52,la Prosperitat,8099,1340,690,650
2016,8,Nou Barris,52,la Prosperitat,8100,1242,685,557
2016,8,Nou Barris,52,la Prosperitat,8101,1695,918,777
2016,8,Nou Barris,52,la Prosperitat,8102,1463,793,670
2016,8,Nou Barris,53,la Trinitat Nova,8103,1504,751,753
2016,8,Nou Barris,53,la Trinitat Nova,8104,1226,682,544
2016,8,Nou Barris,53,la Trinitat Nova,8105,1593,827,766
2016,8,Nou Barris,53,la Trinitat Nova,8106,1165,617,548
2016,8,Nou Barris,53,la Trinitat Nova,8107,1771,921,850
2016,8,Nou Barris,54,Torre Baró,8108,1791,909,882
2016,8,Nou Barris,54,Torre Baró,8109,1004,490,514
2016,8,Nou Barris,55,Ciutat Meridiana,8110,1810,895,915
2016,8,Nou Barris,55,Ciutat Meridiana,8111,1501,791,710
2016,8,Nou Barris,55,Ciutat Meridiana,8112,1612,814,798
2016,8,Nou Barris,55,Ciutat Meridiana,8113,1691,843,848
2016,8,Nou Barris,55,Ciutat Meridiana,8114,1831,917,914
2016,8,Nou Barris,55,Ciutat Meridiana,8115,1610,833,777
2016,8,Nou Barris,56,Vallbona,8116,1354,695,659
2016,9,Sant Andreu,57,la Trinitat Vella,9001,2616,1209,1407
2016,9,Sant Andreu,57,la Trinitat Vella,9002,2109,1000,1109
2016,9,Sant Andreu,57,la Trinitat Vella,9003,2077,987,1090
2016,9,Sant Andreu,57,la Trinitat Vella,9004,1673,855,818
2016,9,Sant Andreu,57,la Trinitat Vella,9005,1573,790,783
2016,9,Sant Andreu,58,Baró de Viver,9006,1237,634,603
2016,9,Sant Andreu,58,Baró de Viver,9007,1274,647,627
2016,9,Sant Andreu,59,el Bon Pastor,9008,1911,949,962
2016,9,Sant Andreu,59,el Bon Pastor,9009,1418,727,691
2016,9,Sant Andreu,59,el Bon Pastor,9010,1800,934,866
2016,9,Sant Andreu,59,el Bon Pastor,9011,1801,915,886
2016,9,Sant Andreu,59,el Bon Pastor,9013,1883,975,908
2016,9,Sant Andreu,59,el Bon Pastor,9014,1972,880,1092
2016,9,Sant Andreu,59,el Bon Pastor,9015,1809,917,892
2016,9,Sant Andreu,60,Sant Andreu,9016,1401,741,660
2016,9,Sant Andreu,60,Sant Andreu,9017,1491,774,717
2016,9,Sant Andreu,60,Sant Andreu,9018,1474,766,708
2016,9,Sant Andreu,60,Sant Andreu,9019,2368,1207,1161
2016,9,Sant Andreu,60,Sant Andreu,9020,1119,599,520
2016,9,Sant Andreu,60,Sant Andreu,9021,1389,737,652
2016,9,Sant Andreu,60,Sant Andreu,9022,1189,620,569
2016,9,Sant Andreu,60,Sant Andreu,9023,1196,620,576
2016,9,Sant Andreu,60,Sant Andreu,9024,1124,612,512
2016,9,Sant Andreu,60,Sant Andreu,9025,1155,618,537
2016,9,Sant Andreu,60,Sant Andreu,9026,1523,805,718
2016,9,Sant Andreu,60,Sant Andreu,9027,1353,696,657
2016,9,Sant Andreu,60,Sant Andreu,9028,1619,824,795
2016,9,Sant Andreu,60,Sant Andreu,9029,1163,607,556
2016,9,Sant Andreu,60,Sant Andreu,9030,1486,802,684
2016,9,Sant Andreu,60,Sant Andreu,9031,1170,612,558
2016,9,Sant Andreu,60,Sant Andreu,9032,2000,1063,937
2016,9,Sant Andreu,60,Sant Andreu,9033,3154,1623,1531
2016,9,Sant Andreu,60,Sant Andreu,9034,1394,734,660
2016,9,Sant Andreu,60,Sant Andreu,9035,1516,804,712
2016,9,Sant Andreu,60,Sant Andreu,9036,1411,753,658
2016,9,Sant Andreu,60,Sant Andreu,9037,1344,729,615
2016,9,Sant Andreu,60,Sant Andreu,9038,1596,847,749
2016,9,Sant Andreu,60,Sant Andreu,9039,1552,813,739
2016,9,Sant Andreu,60,Sant Andreu,9040,1532,833,699
2016,9,Sant Andreu,60,Sant Andreu,9041,1421,770,651
2016,9,Sant Andreu,60,Sant Andreu,9042,1208,644,564
2016,9,Sant Andreu,60,Sant Andreu,9043,1340,720,620
2016,9,Sant Andreu,60,Sant Andreu,9044,1476,768,708
2016,9,Sant Andreu,60,Sant Andreu,9045,1448,767,681
2016,9,Sant Andreu,60,Sant Andreu,9046,1297,679,618
2016,9,Sant Andreu,60,Sant Andreu,9047,1461,786,675
2016,9,Sant Andreu,60,Sant Andreu,9048,1400,727,673
2016,9,Sant Andreu,60,Sant Andreu,9049,1282,701,581
2016,9,Sant Andreu,60,Sant Andreu,9050,1579,841,738
2016,9,Sant Andreu,60,Sant Andreu,9051,1227,654,573
2016,9,Sant Andreu,60,Sant Andreu,9052,1151,598,553
2016,9,Sant Andreu,60,Sant Andreu,9053,1538,854,684
2016,9,Sant Andreu,60,Sant Andreu,9054,1148,616,532
2016,9,Sant Andreu,61,la Sagrera,9055,1688,890,798
2016,9,Sant Andreu,61,la Sagrera,9056,1138,619,519
2016,9,Sant Andreu,61,la Sagrera,9057,1518,805,713
2016,9,Sant Andreu,61,la Sagrera,9058,1458,778,680
2016,9,Sant Andreu,61,la Sagrera,9059,1391,709,682
2016,9,Sant Andreu,61,la Sagrera,9060,1367,734,633
2016,9,Sant Andreu,61,la Sagrera,9061,1709,889,820
2016,9,Sant Andreu,61,la Sagrera,9062,1109,571,538
2016,9,Sant Andreu,61,la Sagrera,9063,1123,576,547
2016,9,Sant Andreu,61,la Sagrera,9064,1199,640,559
2016,9,Sant Andreu,61,la Sagrera,9065,2012,1107,905
2016,9,Sant Andreu,61,la Sagrera,9066,1411,739,672
2016,9,Sant Andreu,61,la Sagrera,9067,1370,758,612
2016,9,Sant Andreu,61,la Sagrera,9068,1551,803,748
2016,9,Sant Andreu,61,la Sagrera,9069,910,507,403
2016,9,Sant Andreu,61,la Sagrera,9070,1769,958,811
2016,9,Sant Andreu,61,la Sagrera,9071,1814,977,837
2016,9,Sant Andreu,61,la Sagrera,9072,1470,801,669
2016,9,Sant Andreu,61,la Sagrera,9073,1541,802,739
2016,9,Sant Andreu,61,la Sagrera,9156,1256,665,591
2016,9,Sant Andreu,62,el Congrés i els Indians,9074,1599,879,720
2016,9,Sant Andreu,62,el Congrés i els Indians,9075,1474,807,667
2016,9,Sant Andreu,62,el Congrés i els Indians,9076,1392,773,619
2016,9,Sant Andreu,62,el Congrés i els Indians,9077,1559,885,674
2016,9,Sant Andreu,62,el Congrés i els Indians,9078,1432,758,674
2016,9,Sant Andreu,62,el Congrés i els Indians,9079,1590,855,735
2016,9,Sant Andreu,62,el Congrés i els Indians,9080,1318,675,643
2016,9,Sant Andreu,62,el Congrés i els Indians,9081,1793,984,809
2016,9,Sant Andreu,62,el Congrés i els Indians,9082,1894,1038,856
2016,9,Sant Andreu,63,Navas,9083,1632,872,760
2016,9,Sant Andreu,63,Navas,9084,1711,888,823
2016,9,Sant Andreu,63,Navas,9085,1641,884,757
2016,9,Sant Andreu,63,Navas,9086,1448,794,654
2016,9,Sant Andreu,63,Navas,9087,1286,684,602
2016,9,Sant Andreu,63,Navas,9088,1939,1061,878
2016,9,Sant Andreu,63,Navas,9089,1459,808,651
2016,9,Sant Andreu,63,Navas,9090,1631,892,739
2016,9,Sant Andreu,63,Navas,9091,1861,976,885
2016,9,Sant Andreu,63,Navas,9092,1981,1030,951
2016,9,Sant Andreu,63,Navas,9093,1337,699,638
2016,9,Sant Andreu,63,Navas,9094,2062,1072,990
2016,9,Sant Andreu,63,Navas,9095,2109,1121,988
2016,10,Sant Martí,64,Camp de l'Arpa del Clot,10001,1607,837,770
2016,10,Sant Martí,64,Camp de l'Arpa del Clot,10002,1725,901,824
2016,10,Sant Martí,64,Camp de l'Arpa del Clot,10003,1584,808,776
2016,10,Sant Martí,64,Camp de l'Arpa del Clot,10004,1508,829,679
2016,10,Sant Martí,64,Camp de l'Arpa del Clot,10005,1625,881,744
2016,10,Sant Martí,64,Camp de l'Arpa del Clot,10006,1720,935,785
2016,10,Sant Martí,64,Camp de l'Arpa del Clot,10007,1341,688,653
2016,10,Sant Martí,64,Camp de l'Arpa del Clot,10008,1741,952,789
2016,10,Sant Martí,64,Camp de l'Arpa del Clot,10009,1566,837,729
2016,10,Sant Martí,64,Camp de l'Arpa del Clot,10010,1704,927,777
2016,10,Sant Martí,64,Camp de l'Arpa del Clot,10011,1183,629,554
2016,10,Sant Martí,64,Camp de l'Arpa del Clot,10012,1830,951,879
2016,10,Sant Martí,64,Camp de l'Arpa del Clot,10013,1409,771,638
2016,10,Sant Martí,64,Camp de l'Arpa del Clot,10014,1406,754,652
2016,10,Sant Martí,64,Camp de l'Arpa del Clot,10015,1805,947,858
2016,10,Sant Martí,64,Camp de l'Arpa del Clot,10016,1280,665,615
2016,10,Sant Martí,64,Camp de l'Arpa del Clot,10017,1715,927,788
2016,10,Sant Martí,64,Camp de l'Arpa del Clot,10018,1350,708,642
2016,10,Sant Martí,64,Camp de l'Arpa del Clot,10019,1645,873,772
2016,10,Sant Martí,64,Camp de l'Arpa del Clot,10020,1476,787,689
2016,10,Sant Martí,64,Camp de l'Arpa del Clot,10021,1322,696,626
2016,10,Sant Martí,64,Camp de l'Arpa del Clot,10022,1276,673,603
2016,10,Sant Martí,64,Camp de l'Arpa del Clot,10023,1452,788,664
2016,10,Sant Martí,64,Camp de l'Arpa del Clot,10024,1475,770,705
2016,10,Sant Martí,64,Camp de l'Arpa del Clot,10025,1385,764,621
2016,10,Sant Martí,65,el Clot,10026,1486,775,711
2016,10,Sant Martí,65,el Clot,10027,1552,815,737
2016,10,Sant Martí,65,el Clot,10028,1795,921,874
2016,10,Sant Martí,65,el Clot,10029,1452,754,698
2016,10,Sant Martí,65,el Clot,10030,1709,915,794
2016,10,Sant Martí,65,el Clot,10031,1537,788,749
2016,10,Sant Martí,65,el Clot,10032,1473,766,707
2016,10,Sant Martí,65,el Clot,10033,892,496,396
2016,10,Sant Martí,65,el Clot,10034,1712,873,839
2016,10,Sant Martí,65,el Clot,10035,2040,1047,993
2016,10,Sant Martí,65,el Clot,10036,1470,735,735
2016,10,Sant Martí,65,el Clot,10037,1060,553,507
2016,10,Sant Martí,65,el Clot,10038,1626,843,783
2016,10,Sant Martí,65,el Clot,10039,1767,953,814
2016,10,Sant Martí,65,el Clot,10040,1910,986,924
2016,10,Sant Martí,65,el Clot,10041,1555,785,770
2016,10,Sant Martí,65,el Clot,10234,1892,1012,880
2016,10,Sant Martí,66,el Parc i la Llacuna del Poblenou,10042,2479,1278,1201
2016,10,Sant Martí,66,el Parc i la Llacuna del Poblenou,10043,1933,966,967
2016,10,Sant Martí,66,el Parc i la Llacuna del Poblenou,10044,1500,767,733
2016,10,Sant Martí,66,el Parc i la Llacuna del Poblenou,10045,1255,691,564
2016,10,Sant Martí,66,el Parc i la Llacuna del Poblenou,10046,1261,656,605
2016,10,Sant Martí,66,el Parc i la Llacuna del Poblenou,10047,1876,941,935
2016,10,Sant Martí,66,el Parc i la Llacuna del Poblenou,10048,1618,841,777
2016,10,Sant Martí,66,el Parc i la Llacuna del Poblenou,10049,1304,671,633
2016,10,Sant Martí,66,el Parc i la Llacuna del Poblenou,10050,1633,870,763
2016,10,Sant Martí,67,la Vila Olímpica del Poblenou,10051,1578,831,747
2016,10,Sant Martí,67,la Vila Olímpica del Poblenou,10052,2366,1187,1179
2016,10,Sant Martí,67,la Vila Olímpica del Poblenou,10053,1819,914,905
2016,10,Sant Martí,67,la Vila Olímpica del Poblenou,10054,976,508,468
2016,10,Sant Martí,67,la Vila Olímpica del Poblenou,10055,2607,1326,1281
2016,10,Sant Martí,68,el Poblenou,10056,1862,944,918
2016,10,Sant Martí,68,el Poblenou,10057,1364,672,692
2016,10,Sant Martí,68,el Poblenou,10058,1136,584,552
2016,10,Sant Martí,68,el Poblenou,10059,1653,855,798
2016,10,Sant Martí,68,el Poblenou,10060,1621,786,835
2016,10,Sant Martí,68,el Poblenou,10061,1806,949,857
2016,10,Sant Martí,68,el Poblenou,10062,1541,788,753
2016,10,Sant Martí,68,el Poblenou,10063,1233,640,593
2016,10,Sant Martí,68,el Poblenou,10064,1703,853,850
2016,10,Sant Martí,68,el Poblenou,10065,1579,797,782
2016,10,Sant Martí,68,el Poblenou,10066,2136,1080,1056
2016,10,Sant Martí,68,el Poblenou,10067,1976,1044,932
2016,10,Sant Martí,68,el Poblenou,10068,1606,814,792
2016,10,Sant Martí,68,el Poblenou,10069,2200,1164,1036
2016,10,Sant Martí,68,el Poblenou,10070,1671,908,763
2016,10,Sant Martí,68,el Poblenou,10071,1794,912,882
2016,10,Sant Martí,68,el Poblenou,10072,2066,1050,1016
2016,10,Sant Martí,68,el Poblenou,10073,1486,784,702
2016,10,Sant Martí,68,el Poblenou,10074,1689,870,819
2016,10,Sant Martí,68,el Poblenou,10075,1501,753,748
2016,10,Sant Martí,69,Diagonal Mar i el Front Marítim del Poblenou,10076,2084,1093,991
2016,10,Sant Martí,69,Diagonal Mar i el Front Marítim del Poblenou,10077,1874,915,959
2016,10,Sant Martí,69,Diagonal Mar i el Front Marítim del Poblenou,10078,2257,1133,1124
2016,10,Sant Martí,69,Diagonal Mar i el Front Marítim del Poblenou,10079,1774,916,858
2016,10,Sant Martí,69,Diagonal Mar i el Front Marítim del Poblenou,10080,2469,1225,1244
2016,10,Sant Martí,69,Diagonal Mar i el Front Marítim del Poblenou,10235,1323,705,618
2016,10,Sant Martí,69,Diagonal Mar i el Front Marítim del Poblenou,10236,1635,863,772
2016,10,Sant Martí,70,el Besòs i el Maresme,10081,1893,949,944
2016,10,Sant Martí,70,el Besòs i el Maresme,10082,1930,897,1033
2016,10,Sant Martí,70,el Besòs i el Maresme,10083,2186,944,1242
2016,10,Sant Martí,70,el Besòs i el Maresme,10084,1629,802,827
2016,10,Sant Martí,70,el Besòs i el Maresme,10085,2000,946,1054
2016,10,Sant Martí,70,el Besòs i el Maresme,10086,1980,993,987
2016,10,Sant Martí,70,el Besòs i el Maresme,10087,1766,902,864
2016,10,Sant Martí,70,el Besòs i el Maresme,10088,1611,828,783
2016,10,Sant Martí,70,el Besòs i el Maresme,10089,1793,898,895
2016,10,Sant Martí,70,el Besòs i el Maresme,10090,1405,741,664
2016,10,Sant Martí,70,el Besòs i el Maresme,10091,1967,1010,957
2016,10,Sant Martí,70,el Besòs i el Maresme,10092,1512,795,717
2016,10,Sant Martí,70,el Besòs i el Maresme,10093,1111,556,555
2016,10,Sant Martí,71,Provençals del Poblenou,10094,2728,1379,1349
2016,10,Sant Martí,71,Provençals del Poblenou,10095,1319,658,661
2016,10,Sant Martí,71,Provençals del Poblenou,10096,1576,831,745
2016,10,Sant Martí,71,Provençals del Poblenou,10097,1594,824,770
2016,10,Sant Martí,71,Provençals del Poblenou,10098,1883,981,902
2016,10,Sant Martí,71,Provençals del Poblenou,10099,1097,560,537
2016,10,Sant Martí,71,Provençals del Poblenou,10100,1583,842,741
2016,10,Sant Martí,71,Provençals del Poblenou,10101,1453,709,744
2016,10,Sant Martí,71,Provençals del Poblenou,10102,2537,1327,1210
2016,10,Sant Martí,71,Provençals del Poblenou,10103,2197,1151,1046
2016,10,Sant Martí,71,Provençals del Poblenou,10104,1655,857,798
2016,10,Sant Martí,71,Provençals del Poblenou,10237,759,425,334
2016,10,Sant Martí,72,Sant Martí de Provençals,10105,2278,1212,1066
2016,10,Sant Martí,72,Sant Martí de Provençals,10106,990,525,465
2016,10,Sant Martí,72,Sant Martí de Provençals,10107,1538,818,720
2016,10,Sant Martí,72,Sant Martí de Provençals,10108,1329,710,619
2016,10,Sant Martí,72,Sant Martí de Provençals,10109,1528,826,702
2016,10,Sant Martí,72,Sant Martí de Provençals,10110,1627,898,729
2016,10,Sant Martí,72,Sant Martí de Provençals,10111,1288,689,599
2016,10,Sant Martí,72,Sant Martí de Provençals,10112,1570,804,766
2016,10,Sant Martí,72,Sant Martí de Provençals,10113,1182,622,560
2016,10,Sant Martí,72,Sant Martí de Provençals,10114,1404,750,654
2016,10,Sant Martí,72,Sant Martí de Provençals,10115,1468,733,735
2016,10,Sant Martí,72,Sant Martí de Provençals,10116,1875,992,883
2016,10,Sant Martí,72,Sant Martí de Provençals,10117,1293,671,622
2016,10,Sant Martí,72,Sant Martí de Provençals,10118,1001,527,474
2016,10,Sant Martí,72,Sant Martí de Provençals,10119,1129,600,529
2016,10,Sant Martí,72,Sant Martí de Provençals,10120,1449,807,642
2016,10,Sant Martí,72,Sant Martí de Provençals,10121,1551,819,732
2016,10,Sant Martí,72,Sant Martí de Provençals,10122,1531,788,743
2016,10,Sant Martí,73,la Verneda i la Pau,10123,1404,727,677
2016,10,Sant Martí,73,la Verneda i la Pau,10124,1110,561,549
2016,10,Sant Martí,73,la Verneda i la Pau,10125,1125,583,542
2016,10,Sant Martí,73,la Verneda i la Pau,10126,1064,560,504
2016,10,Sant Martí,73,la Verneda i la Pau,10127,1012,508,504
2016,10,Sant Martí,73,la Verneda i la Pau,10128,1622,867,755
2016,10,Sant Martí,73,la Verneda i la Pau,10129,1188,605,583
2016,10,Sant Martí,73,la Verneda i la Pau,10130,1202,646,556
2016,10,Sant Martí,73,la Verneda i la Pau,10131,1185,629,556
2016,10,Sant Martí,73,la Verneda i la Pau,10132,1243,661,582
2016,10,Sant Martí,73,la Verneda i la Pau,10133,1696,904,792
2016,10,Sant Martí,73,la Verneda i la Pau,10134,1537,834,703
2016,10,Sant Martí,73,la Verneda i la Pau,10135,1245,656,589
2016,10,Sant Martí,73,la Verneda i la Pau,10136,1371,705,666
2016,10,Sant Martí,73,la Verneda i la Pau,10137,1556,816,740
2016,10,Sant Martí,73,la Verneda i la Pau,10138,1541,810,731
2016,10,Sant Martí,73,la Verneda i la Pau,10139,1625,832,793
2016,10,Sant Martí,73,la Verneda i la Pau,10140,1581,850,731
2016,10,Sant Martí,73,la Verneda i la Pau,10141,1097,578,519
2016,10,Sant Martí,73,la Verneda i la Pau,10142,1568,839,729
2016,10,Sant Martí,73,la Verneda i la Pau,10143,1701,896,805
2017,1,Ciutat Vella,1,el Raval,1001,1265,566,699
2017,1,Ciutat Vella,1,el Raval,1002,1595,689,906
2017,1,Ciutat Vella,1,el Raval,1003,3454,1560,1894
2017,1,Ciutat Vella,1,el Raval,1004,2906,1319,1587
2017,1,Ciutat Vella,1,el Raval,1005,2506,1114,1392
2017,1,Ciutat Vella,1,el Raval,1006,1661,728,933
2017,1,Ciutat Vella,1,el Raval,1007,2097,827,1270
2017,1,Ciutat Vella,1,el Raval,1008,3324,1303,2021
2017,1,Ciutat Vella,1,el Raval,1009,2165,977,1188
2017,1,Ciutat Vella,1,el Raval,1010,2504,1074,1430
2017,1,Ciutat Vella,1,el Raval,1011,3230,1405,1825
2017,1,Ciutat Vella,1,el Raval,1012,1908,925,983
2017,1,Ciutat Vella,1,el Raval,1013,1405,731,674
2017,1,Ciutat Vella,1,el Raval,1014,2010,949,1061
2017,1,Ciutat Vella,1,el Raval,1015,2356,1128,1228
2017,1,Ciutat Vella,1,el Raval,1016,2208,1070,1138
2017,1,Ciutat Vella,1,el Raval,1017,2619,1291,1328
2017,1,Ciutat Vella,1,el Raval,1018,1657,796,861
2017,1,Ciutat Vella,1,el Raval,1019,2870,1329,1541
2017,1,Ciutat Vella,1,el Raval,1020,2127,1120,1007
2017,1,Ciutat Vella,1,el Raval,1021,2034,1014,1020
2017,1,Ciutat Vella,2,el Barri Gòtic,1022,1263,672,591
2017,1,Ciutat Vella,2,el Barri Gòtic,1023,1983,1026,957
2017,1,Ciutat Vella,2,el Barri Gòtic,1025,1262,619,643
2017,1,Ciutat Vella,2,el Barri Gòtic,1026,2653,1080,1573
2017,1,Ciutat Vella,2,el Barri Gòtic,1027,1659,825,834
2017,1,Ciutat Vella,2,el Barri Gòtic,1028,1870,956,914
2017,1,Ciutat Vella,2,el Barri Gòtic,1029,1415,688,727
2017,1,Ciutat Vella,2,el Barri Gòtic,1030,2500,1212,1288
2017,1,Ciutat Vella,2,el Barri Gòtic,1031,1635,722,913
2017,1,Ciutat Vella,3,la Barceloneta,1032,1775,883,892
2017,1,Ciutat Vella,3,la Barceloneta,1033,1132,531,601
2017,1,Ciutat Vella,3,la Barceloneta,1034,970,498,472
2017,1,Ciutat Vella,3,la Barceloneta,1035,1328,667,661
2017,1,Ciutat Vella,3,la Barceloneta,1036,1196,629,567
2017,1,Ciutat Vella,3,la Barceloneta,1037,1485,782,703
2017,1,Ciutat Vella,3,la Barceloneta,1038,1495,701,794
2017,1,Ciutat Vella,3,la Barceloneta,1039,1305,635,670
2017,1,Ciutat Vella,3,la Barceloneta,1040,1105,558,547
2017,1,Ciutat Vella,3,la Barceloneta,1041,1515,737,778
2017,1,Ciutat Vella,3,la Barceloneta,1042,1795,969,826
2017,1,Ciutat Vella,4,"Sant Pere, Santa Caterina i la Ribera",1043,1544,759,785
2017,1,Ciutat Vella,4,"Sant Pere, Santa Caterina i la Ribera",1044,1513,799,714
2017,1,Ciutat Vella,4,"Sant Pere, Santa Caterina i la Ribera",1045,1985,961,1024
2017,1,Ciutat Vella,4,"Sant Pere, Santa Caterina i la Ribera",1046,1754,882,872
2017,1,Ciutat Vella,4,"Sant Pere, Santa Caterina i la Ribera",1047,1812,931,881
2017,1,Ciutat Vella,4,"Sant Pere, Santa Caterina i la Ribera",1048,2159,1090,1069
2017,1,Ciutat Vella,4,"Sant Pere, Santa Caterina i la Ribera",1049,1544,806,738
2017,1,Ciutat Vella,4,"Sant Pere, Santa Caterina i la Ribera",1050,1609,795,814
2017,1,Ciutat Vella,4,"Sant Pere, Santa Caterina i la Ribera",1051,1865,951,914
2017,1,Ciutat Vella,4,"Sant Pere, Santa Caterina i la Ribera",1052,2585,1199,1386
2017,1,Ciutat Vella,4,"Sant Pere, Santa Caterina i la Ribera",1053,1899,979,920
2017,1,Ciutat Vella,4,"Sant Pere, Santa Caterina i la Ribera",1054,1343,657,686
2017,1,Ciutat Vella,4,"Sant Pere, Santa Caterina i la Ribera",1055,1311,683,628
2017,2,Eixample,5,el Fort Pienc,2001,1285,670,615
2017,2,Eixample,5,el Fort Pienc,2002,2337,1107,1230
2017,2,Eixample,5,el Fort Pienc,2003,1293,733,560
2017,2,Eixample,5,el Fort Pienc,2004,1504,766,738
2017,2,Eixample,5,el Fort Pienc,2005,2086,1128,958
2017,2,Eixample,5,el Fort Pienc,2006,1635,863,772
2017,2,Eixample,5,el Fort Pienc,2007,1265,709,556
2017,2,Eixample,5,el Fort Pienc,2008,1887,1034,853
2017,2,Eixample,5,el Fort Pienc,2009,1781,970,811
2017,2,Eixample,5,el Fort Pienc,2010,1205,653,552
2017,2,Eixample,5,el Fort Pienc,2011,1102,573,529
2017,2,Eixample,5,el Fort Pienc,2012,1587,830,757
2017,2,Eixample,5,el Fort Pienc,2013,1145,593,552
2017,2,Eixample,5,el Fort Pienc,2014,1351,672,679
2017,2,Eixample,5,el Fort Pienc,2015,1560,808,752
2017,2,Eixample,5,el Fort Pienc,2016,1910,1042,868
2017,2,Eixample,5,el Fort Pienc,2017,2000,1065,935
2017,2,Eixample,5,el Fort Pienc,2018,1876,1001,875
2017,2,Eixample,5,el Fort Pienc,2019,1924,1018,906
2017,2,Eixample,5,el Fort Pienc,2020,1404,770,634
2017,2,Eixample,6,la Sagrada Família,2021,1474,795,679
2017,2,Eixample,6,la Sagrada Família,2022,1282,665,617
2017,2,Eixample,6,la Sagrada Família,2023,1120,598,522
2017,2,Eixample,6,la Sagrada Família,2024,1089,600,489
2017,2,Eixample,6,la Sagrada Família,2025,1198,641,557
2017,2,Eixample,6,la Sagrada Família,2026,2156,1154,1002
2017,2,Eixample,6,la Sagrada Família,2027,1948,1055,893
2017,2,Eixample,6,la Sagrada Família,2028,2062,1111,951
2017,2,Eixample,6,la Sagrada Família,2029,1191,640,551
2017,2,Eixample,6,la Sagrada Família,2030,1324,708,616
2017,2,Eixample,6,la Sagrada Família,2031,1054,554,500
2017,2,Eixample,6,la Sagrada Família,2032,1222,721,501
2017,2,Eixample,6,la Sagrada Família,2033,1156,630,526
2017,2,Eixample,6,la Sagrada Família,2034,1219,659,560
2017,2,Eixample,6,la Sagrada Família,2035,1317,701,616
2017,2,Eixample,6,la Sagrada Família,2036,1197,656,541
2017,2,Eixample,6,la Sagrada Família,2037,1226,643,583
2017,2,Eixample,6,la Sagrada Família,2038,1627,862,765
2017,2,Eixample,6,la Sagrada Família,2039,1732,978,754
2017,2,Eixample,6,la Sagrada Família,2040,1659,880,779
2017,2,Eixample,6,la Sagrada Família,2041,1673,920,753
2017,2,Eixample,6,la Sagrada Família,2042,1670,905,765
2017,2,Eixample,6,la Sagrada Família,2043,1434,776,658
2017,2,Eixample,6,la Sagrada Família,2044,1267,717,550
2017,2,Eixample,6,la Sagrada Família,2045,1177,633,544
2017,2,Eixample,6,la Sagrada Família,2046,1864,1014,850
2017,2,Eixample,6,la Sagrada Família,2047,1901,1006,895
2017,2,Eixample,6,la Sagrada Família,2048,1250,681,569
2017,2,Eixample,6,la Sagrada Família,2049,2076,1144,932
2017,2,Eixample,6,la Sagrada Família,2050,1635,900,735
2017,2,Eixample,6,la Sagrada Família,2051,1906,1051,855
2017,2,Eixample,6,la Sagrada Família,2052,1823,1003,820
2017,2,Eixample,6,la Sagrada Família,2053,1845,991,854
2017,2,Eixample,6,la Sagrada Família,2054,1884,1026,858
2017,2,Eixample,7,la Dreta de l'Eixample,2055,1872,1004,868
2017,2,Eixample,7,la Dreta de l'Eixample,2056,1458,829,629
2017,2,Eixample,7,la Dreta de l'Eixample,2057,1319,704,615
2017,2,Eixample,7,la Dreta de l'Eixample,2058,1385,762,623
2017,2,Eixample,7,la Dreta de l'Eixample,2059,1669,921,748
2017,2,Eixample,7,la Dreta de l'Eixample,2060,1719,932,787
2017,2,Eixample,7,la Dreta de l'Eixample,2061,1331,741,590
2017,2,Eixample,7,la Dreta de l'Eixample,2062,1554,836,718
2017,2,Eixample,7,la Dreta de l'Eixample,2063,1211,739,472
2017,2,Eixample,7,la Dreta de l'Eixample,2064,1336,709,627
2017,2,Eixample,7,la Dreta de l'Eixample,2065,1899,1012,887
2017,2,Eixample,7,la Dreta de l'Eixample,2066,1802,959,843
2017,2,Eixample,7,la Dreta de l'Eixample,2067,1734,930,804
2017,2,Eixample,7,la Dreta de l'Eixample,2068,1675,904,771
2017,2,Eixample,7,la Dreta de l'Eixample,2069,1413,750,663
2017,2,Eixample,7,la Dreta de l'Eixample,2070,1319,708,611
2017,2,Eixample,7,la Dreta de l'Eixample,2071,1690,884,806
2017,2,Eixample,7,la Dreta de l'Eixample,2072,1228,637,591
2017,2,Eixample,7,la Dreta de l'Eixample,2073,1710,898,812
2017,2,Eixample,7,la Dreta de l'Eixample,2074,1264,631,633
2017,2,Eixample,7,la Dreta de l'Eixample,2075,1214,633,581
2017,2,Eixample,7,la Dreta de l'Eixample,2076,1674,879,795
2017,2,Eixample,7,la Dreta de l'Eixample,2077,1529,761,768
2017,2,Eixample,7,la Dreta de l'Eixample,2078,1473,803,670
2017,2,Eixample,7,la Dreta de l'Eixample,2079,1318,693,625
2017,2,Eixample,7,la Dreta de l'Eixample,2080,1459,766,693
2017,2,Eixample,7,la Dreta de l'Eixample,2081,2138,1157,981
2017,2,Eixample,7,la Dreta de l'Eixample,2082,955,522,433
2017,2,Eixample,7,la Dreta de l'Eixample,2083,1876,1028,848
2017,2,Eixample,8,l'Antiga Esquerra de l'Eixample,2084,2027,1118,909
2017,2,Eixample,8,l'Antiga Esquerra de l'Eixample,2085,1486,818,668
2017,2,Eixample,8,l'Antiga Esquerra de l'Eixample,2086,1478,805,673
2017,2,Eixample,8,l'Antiga Esquerra de l'Eixample,2087,1448,801,647
2017,2,Eixample,8,l'Antiga Esquerra de l'Eixample,2088,1633,891,742
2017,2,Eixample,8,l'Antiga Esquerra de l'Eixample,2089,1927,1021,906
2017,2,Eixample,8,l'Antiga Esquerra de l'Eixample,2090,1687,891,796
2017,2,Eixample,8,l'Antiga Esquerra de l'Eixample,2091,1840,933,907
2017,2,Eixample,8,l'Antiga Esquerra de l'Eixample,2092,2005,934,1071
2017,2,Eixample,8,l'Antiga Esquerra de l'Eixample,2093,1611,833,778
2017,2,Eixample,8,l'Antiga Esquerra de l'Eixample,2094,1423,751,672
2017,2,Eixample,8,l'Antiga Esquerra de l'Eixample,2095,1535,801,734
2017,2,Eixample,8,l'Antiga Esquerra de l'Eixample,2096,1411,735,676
2017,2,Eixample,8,l'Antiga Esquerra de l'Eixample,2097,1127,605,522
2017,2,Eixample,8,l'Antiga Esquerra de l'Eixample,2098,1540,857,683
2017,2,Eixample,8,l'Antiga Esquerra de l'Eixample,2099,1548,820,728
2017,2,Eixample,8,l'Antiga Esquerra de l'Eixample,2100,1425,754,671
2017,2,Eixample,8,l'Antiga Esquerra de l'Eixample,2101,2161,1171,990
2017,2,Eixample,8,l'Antiga Esquerra de l'Eixample,2102,1423,798,625
2017,2,Eixample,8,l'Antiga Esquerra de l'Eixample,2103,1706,906,800
2017,2,Eixample,8,l'Antiga Esquerra de l'Eixample,2104,1162,639,523
2017,2,Eixample,8,l'Antiga Esquerra de l'Eixample,2105,2097,1149,948
2017,2,Eixample,8,l'Antiga Esquerra de l'Eixample,2106,1446,752,694
2017,2,Eixample,8,l'Antiga Esquerra de l'Eixample,2107,1631,895,736
2017,2,Eixample,8,l'Antiga Esquerra de l'Eixample,2108,1638,928,710
2017,2,Eixample,8,l'Antiga Esquerra de l'Eixample,2109,2029,1113,916
2017,2,Eixample,9,la Nova Esquerra de l'Eixample,2110,1929,1018,911
2017,2,Eixample,9,la Nova Esquerra de l'Eixample,2111,1766,976,790
2017,2,Eixample,9,la Nova Esquerra de l'Eixample,2112,1383,752,631
2017,2,Eixample,9,la Nova Esquerra de l'Eixample,2113,2154,1137,1017
2017,2,Eixample,9,la Nova Esquerra de l'Eixample,2114,1678,927,751
2017,2,Eixample,9,la Nova Esquerra de l'Eixample,2115,1362,745,617
2017,2,Eixample,9,la Nova Esquerra de l'Eixample,2116,1070,576,494
2017,2,Eixample,9,la Nova Esquerra de l'Eixample,2117,1206,656,550
2017,2,Eixample,9,la Nova Esquerra de l'Eixample,2118,1502,821,681
2017,2,Eixample,9,la Nova Esquerra de l'Eixample,2119,1310,722,588
2017,2,Eixample,9,la Nova Esquerra de l'Eixample,2120,1206,640,566
2017,2,Eixample,9,la Nova Esquerra de l'Eixample,2121,1230,667,563
2017,2,Eixample,9,la Nova Esquerra de l'Eixample,2122,1096,613,483
2017,2,Eixample,9,la Nova Esquerra de l'Eixample,2123,1151,604,547
2017,2,Eixample,9,la Nova Esquerra de l'Eixample,2124,1088,582,506
2017,2,Eixample,9,la Nova Esquerra de l'Eixample,2125,1725,951,774
2017,2,Eixample,9,la Nova Esquerra de l'Eixample,2126,1483,816,667
2017,2,Eixample,9,la Nova Esquerra de l'Eixample,2127,1185,622,563
2017,2,Eixample,9,la Nova Esquerra de l'Eixample,2128,1309,702,607
2017,2,Eixample,9,la Nova Esquerra de l'Eixample,2129,1537,832,705
2017,2,Eixample,9,la Nova Esquerra de l'Eixample,2130,1149,597,552
2017,2,Eixample,9,la Nova Esquerra de l'Eixample,2131,1239,655,584
2017,2,Eixample,9,la Nova Esquerra de l'Eixample,2132,1172,623,549
2017,2,Eixample,9,la Nova Esquerra de l'Eixample,2133,879,484,395
2017,2,Eixample,9,la Nova Esquerra de l'Eixample,2134,1421,759,662
2017,2,Eixample,9,la Nova Esquerra de l'Eixample,2135,2111,1127,984
2017,2,Eixample,9,la Nova Esquerra de l'Eixample,2136,888,480,408
2017,2,Eixample,9,la Nova Esquerra de l'Eixample,2137,1453,784,669
2017,2,Eixample,9,la Nova Esquerra de l'Eixample,2138,1942,1010,932
2017,2,Eixample,9,la Nova Esquerra de l'Eixample,2139,1660,888,772
2017,2,Eixample,9,la Nova Esquerra de l'Eixample,2140,1939,1025,914
2017,2,Eixample,9,la Nova Esquerra de l'Eixample,2141,1273,682,591
2017,2,Eixample,9,la Nova Esquerra de l'Eixample,2142,2037,1084,953
2017,2,Eixample,9,la Nova Esquerra de l'Eixample,2143,1301,644,657
2017,2,Eixample,9,la Nova Esquerra de l'Eixample,2144,1518,816,702
2017,2,Eixample,9,la Nova Esquerra de l'Eixample,2145,1233,633,600
2017,2,Eixample,9,la Nova Esquerra de l'Eixample,2146,1155,619,536
2017,2,Eixample,9,la Nova Esquerra de l'Eixample,2147,2167,1169,998
2017,2,Eixample,9,la Nova Esquerra de l'Eixample,2148,1601,864,737
2017,2,Eixample,9,la Nova Esquerra de l'Eixample,2149,1829,965,864
2017,2,Eixample,10,Sant Antoni,2150,1497,771,726
2017,2,Eixample,10,Sant Antoni,2151,1477,780,697
2017,2,Eixample,10,Sant Antoni,2152,1237,689,548
2017,2,Eixample,10,Sant Antoni,2153,1351,737,614
2017,2,Eixample,10,Sant Antoni,2154,1086,575,511
2017,2,Eixample,10,Sant Antoni,2155,1870,1011,859
2017,2,Eixample,10,Sant Antoni,2156,1290,679,611
2017,2,Eixample,10,Sant Antoni,2157,1211,653,558
2017,2,Eixample,10,Sant Antoni,2158,1617,858,759
2017,2,Eixample,10,Sant Antoni,2159,1860,972,888
2017,2,Eixample,10,Sant Antoni,2160,2028,1052,976
2017,2,Eixample,10,Sant Antoni,2161,1110,573,537
2017,2,Eixample,10,Sant Antoni,2162,1377,716,661
2017,2,Eixample,10,Sant Antoni,2163,1832,967,865
2017,2,Eixample,10,Sant Antoni,2164,1464,788,676
2017,2,Eixample,10,Sant Antoni,2165,1686,882,804
2017,2,Eixample,10,Sant Antoni,2166,2114,1113,1001
2017,2,Eixample,10,Sant Antoni,2167,2112,1079,1033
2017,2,Eixample,10,Sant Antoni,2168,2232,1177,1055
2017,2,Eixample,10,Sant Antoni,2169,1590,812,778
2017,2,Eixample,10,Sant Antoni,2170,1586,827,759
2017,2,Eixample,10,Sant Antoni,2171,1671,869,802
2017,2,Eixample,10,Sant Antoni,2172,1637,847,790
2017,2,Eixample,10,Sant Antoni,2173,1535,816,719
2017,3,Sants-Montjuïc,11,el Poble-sec,3001,1659,892,767
2017,3,Sants-Montjuïc,11,el Poble-sec,3002,2049,1044,1005
2017,3,Sants-Montjuïc,11,el Poble-sec,3003,1705,885,820
2017,3,Sants-Montjuïc,11,el Poble-sec,3004,1568,819,749
2017,3,Sants-Montjuïc,11,el Poble-sec,3005,1276,649,627
2017,3,Sants-Montjuïc,11,el Poble-sec,3006,1428,698,730
2017,3,Sants-Montjuïc,11,el Poble-sec,3007,1706,877,829
2017,3,Sants-Montjuïc,11,el Poble-sec,3008,1210,635,575
2017,3,Sants-Montjuïc,11,el Poble-sec,3009,1206,639,567
2017,3,Sants-Montjuïc,11,el Poble-sec,3010,1954,950,1004
2017,3,Sants-Montjuïc,11,el Poble-sec,3011,1787,916,871
2017,3,Sants-Montjuïc,11,el Poble-sec,3012,2136,1109,1027
2017,3,Sants-Montjuïc,11,el Poble-sec,3013,1913,928,985
2017,3,Sants-Montjuïc,11,el Poble-sec,3014,1826,894,932
2017,3,Sants-Montjuïc,11,el Poble-sec,3015,2994,1498,1496
2017,3,Sants-Montjuïc,11,el Poble-sec,3016,1205,606,599
2017,3,Sants-Montjuïc,11,el Poble-sec,3017,1668,811,857
2017,3,Sants-Montjuïc,11,el Poble-sec,3018,1749,872,877
2017,3,Sants-Montjuïc,11,el Poble-sec,3019,1503,798,705
2017,3,Sants-Montjuïc,11,el Poble-sec,3020,1185,578,607
2017,3,Sants-Montjuïc,11,el Poble-sec,3021,1147,614,533
2017,3,Sants-Montjuïc,11,el Poble-sec,3022,1481,748,733
2017,3,Sants-Montjuïc,11,el Poble-sec,3023,1968,990,978
2017,3,Sants-Montjuïc,11,el Poble-sec,3024,2062,1031,1031
2017,3,Sants-Montjuïc,12,la Marina del Prat Vermell,3025,1151,553,598
2017,3,Sants-Montjuïc,13,la Marina de Port,3026,1006,519,487
2017,3,Sants-Montjuïc,13,la Marina de Port,3027,1818,943,875
2017,3,Sants-Montjuïc,13,la Marina de Port,3028,2419,1255,1164
2017,3,Sants-Montjuïc,13,la Marina de Port,3029,1284,673,611
2017,3,Sants-Montjuïc,13,la Marina de Port,3030,1579,852,727
2017,3,Sants-Montjuïc,13,la Marina de Port,3031,2455,1272,1183
2017,3,Sants-Montjuïc,13,la Marina de Port,3032,1614,829,785
2017,3,Sants-Montjuïc,13,la Marina de Port,3033,1430,715,715
2017,3,Sants-Montjuïc,13,la Marina de Port,3034,1531,788,743
2017,3,Sants-Montjuïc,13,la Marina de Port,3035,2311,1221,1090
2017,3,Sants-Montjuïc,13,la Marina de Port,3036,2372,1240,1132
2017,3,Sants-Montjuïc,13,la Marina de Port,3037,1082,553,529
2017,3,Sants-Montjuïc,13,la Marina de Port,3038,1022,534,488
2017,3,Sants-Montjuïc,13,la Marina de Port,3039,2436,1234,1202
2017,3,Sants-Montjuïc,13,la Marina de Port,3211,1483,759,724
2017,3,Sants-Montjuïc,13,la Marina de Port,3212,2433,1284,1149
2017,3,Sants-Montjuïc,13,la Marina de Port,3213,2347,1225,1122
2017,3,Sants-Montjuïc,14,la Font de la Guatlla,3040,1563,821,742
2017,3,Sants-Montjuïc,14,la Font de la Guatlla,3041,1408,755,653
2017,3,Sants-Montjuïc,14,la Font de la Guatlla,3042,1389,723,666
2017,3,Sants-Montjuïc,14,la Font de la Guatlla,3043,1644,890,754
2017,3,Sants-Montjuïc,14,la Font de la Guatlla,3044,1940,1027,913
2017,3,Sants-Montjuïc,14,la Font de la Guatlla,3045,1081,555,526
2017,3,Sants-Montjuïc,14,la Font de la Guatlla,3046,1397,743,654
2017,3,Sants-Montjuïc,15,Hostafrancs,3047,1800,955,845
2017,3,Sants-Montjuïc,15,Hostafrancs,3048,1388,725,663
2017,3,Sants-Montjuïc,15,Hostafrancs,3049,1651,868,783
2017,3,Sants-Montjuïc,15,Hostafrancs,3050,1607,836,771
2017,3,Sants-Montjuïc,15,Hostafrancs,3051,1812,929,883
2017,3,Sants-Montjuïc,15,Hostafrancs,3052,1297,677,620
2017,3,Sants-Montjuïc,15,Hostafrancs,3053,2179,1127,1052
2017,3,Sants-Montjuïc,15,Hostafrancs,3054,1787,914,873
2017,3,Sants-Montjuïc,15,Hostafrancs,3055,1577,819,758
2017,3,Sants-Montjuïc,15,Hostafrancs,3056,851,474,377
2017,3,Sants-Montjuïc,16,la Bordeta,3057,1543,834,709
2017,3,Sants-Montjuïc,16,la Bordeta,3058,1357,775,582
2017,3,Sants-Montjuïc,16,la Bordeta,3059,1211,629,582
2017,3,Sants-Montjuïc,16,la Bordeta,3060,1335,694,641
2017,3,Sants-Montjuïc,16,la Bordeta,3061,1074,572,502
2017,3,Sants-Montjuïc,16,la Bordeta,3062,1659,888,771
2017,3,Sants-Montjuïc,16,la Bordeta,3063,1325,683,642
2017,3,Sants-Montjuïc,16,la Bordeta,3064,1247,667,580
2017,3,Sants-Montjuïc,16,la Bordeta,3065,1390,715,675
2017,3,Sants-Montjuïc,16,la Bordeta,3066,2329,1204,1125
2017,3,Sants-Montjuïc,16,la Bordeta,3067,1749,916,833
2017,3,Sants-Montjuïc,16,la Bordeta,3068,1157,625,532
2017,3,Sants-Montjuïc,16,la Bordeta,3069,1185,611,574
2017,3,Sants-Montjuïc,17,Sants - Badal,3070,1250,635,615
2017,3,Sants-Montjuïc,17,Sants - Badal,3071,1265,662,603
2017,3,Sants-Montjuïc,17,Sants - Badal,3072,1401,742,659
2017,3,Sants-Montjuïc,17,Sants - Badal,3073,1638,852,786
2017,3,Sants-Montjuïc,17,Sants - Badal,3074,1777,964,813
2017,3,Sants-Montjuïc,17,Sants - Badal,3075,1648,874,774
2017,3,Sants-Montjuïc,17,Sants - Badal,3076,1016,532,484
2017,3,Sants-Montjuïc,17,Sants - Badal,3077,1300,717,583
2017,3,Sants-Montjuïc,17,Sants - Badal,3078,1682,878,804
2017,3,Sants-Montjuïc,17,Sants - Badal,3079,1808,948,860
2017,3,Sants-Montjuïc,17,Sants - Badal,3080,1531,838,693
2017,3,Sants-Montjuïc,17,Sants - Badal,3081,1847,999,848
2017,3,Sants-Montjuïc,17,Sants - Badal,3082,1857,997,860
2017,3,Sants-Montjuïc,17,Sants - Badal,3083,1353,736,617
2017,3,Sants-Montjuïc,17,Sants - Badal,3084,1440,778,662
2017,3,Sants-Montjuïc,17,Sants - Badal,3085,1234,660,574
2017,3,Sants-Montjuïc,18,Sants,3086,1260,660,600
2017,3,Sants-Montjuïc,18,Sants,3087,1502,815,687
2017,3,Sants-Montjuïc,18,Sants,3088,1426,762,664
2017,3,Sants-Montjuïc,18,Sants,3089,1227,658,569
2017,3,Sants-Montjuïc,18,Sants,3090,1056,565,491
2017,3,Sants-Montjuïc,18,Sants,3091,1424,742,682
2017,3,Sants-Montjuïc,18,Sants,3092,1222,634,588
2017,3,Sants-Montjuïc,18,Sants,3093,1535,809,726
2017,3,Sants-Montjuïc,18,Sants,3094,1140,601,539
2017,3,Sants-Montjuïc,18,Sants,3095,1634,881,753
2017,3,Sants-Montjuïc,18,Sants,3096,1549,811,738
2017,3,Sants-Montjuïc,18,Sants,3097,1647,857,790
2017,3,Sants-Montjuïc,18,Sants,3098,1377,719,658
2017,3,Sants-Montjuïc,18,Sants,3099,989,545,444
2017,3,Sants-Montjuïc,18,Sants,3100,1249,669,580
2017,3,Sants-Montjuïc,18,Sants,3101,2005,959,1046
2017,3,Sants-Montjuïc,18,Sants,3102,1347,713,634
2017,3,Sants-Montjuïc,18,Sants,3103,1207,637,570
2017,3,Sants-Montjuïc,18,Sants,3104,1492,807,685
2017,3,Sants-Montjuïc,18,Sants,3105,1155,632,523
2017,3,Sants-Montjuïc,18,Sants,3106,1257,682,575
2017,3,Sants-Montjuïc,18,Sants,3107,1576,796,780
2017,3,Sants-Montjuïc,18,Sants,3108,1608,877,731
2017,3,Sants-Montjuïc,18,Sants,3109,1505,810,695
2017,3,Sants-Montjuïc,18,Sants,3110,1556,828,728
2017,3,Sants-Montjuïc,18,Sants,3111,1315,708,607
2017,3,Sants-Montjuïc,18,Sants,3112,1899,1014,885
2017,3,Sants-Montjuïc,18,Sants,3113,1634,876,758
2017,3,Sants-Montjuïc,18,Sants,3114,1451,789,662
2017,4,Les Corts,19,les Corts,4001,1272,677,595
2017,4,Les Corts,19,les Corts,4002,1944,1019,925
2017,4,Les Corts,19,les Corts,4003,1072,545,527
2017,4,Les Corts,19,les Corts,4004,981,545,436
2017,4,Les Corts,19,les Corts,4005,1238,665,573
2017,4,Les Corts,19,les Corts,4006,1134,606,528
2017,4,Les Corts,19,les Corts,4007,1083,611,472
2017,4,Les Corts,19,les Corts,4008,989,529,460
2017,4,Les Corts,19,les Corts,4009,1420,779,641
2017,4,Les Corts,19,les Corts,4010,908,496,412
2017,4,Les Corts,19,les Corts,4011,1724,911,813
2017,4,Les Corts,19,les Corts,4012,1375,745,630
2017,4,Les Corts,19,les Corts,4013,1265,688,577
2017,4,Les Corts,19,les Corts,4014,849,464,385
2017,4,Les Corts,19,les Corts,4015,1896,1034,862
2017,4,Les Corts,19,les Corts,4016,1094,580,514
2017,4,Les Corts,19,les Corts,4017,1135,623,512
2017,4,Les Corts,19,les Corts,4018,1545,841,704
2017,4,Les Corts,19,les Corts,4019,1342,716,626
2017,4,Les Corts,19,les Corts,4020,1447,772,675
2017,4,Les Corts,19,les Corts,4021,1301,705,596
2017,4,Les Corts,19,les Corts,4022,1579,833,746
2017,4,Les Corts,19,les Corts,4023,1088,581,507
2017,4,Les Corts,19,les Corts,4024,1068,568,500
2017,4,Les Corts,19,les Corts,4025,1189,635,554
2017,4,Les Corts,19,les Corts,4026,1305,715,590
2017,4,Les Corts,19,les Corts,4027,1175,612,563
2017,4,Les Corts,19,les Corts,4028,1347,712,635
2017,4,Les Corts,19,les Corts,4029,1149,618,531
2017,4,Les Corts,19,les Corts,4030,1777,961,816
2017,4,Les Corts,19,les Corts,4031,1793,871,922
2017,4,Les Corts,19,les Corts,4032,1555,857,698
2017,4,Les Corts,19,les Corts,4033,1178,642,536
2017,4,Les Corts,19,les Corts,4034,1471,775,696
2017,4,Les Corts,19,les Corts,4035,1416,769,647
2017,4,Les Corts,20,la Maternitat i Sant Ramon,4036,1719,936,783
2017,4,Les Corts,20,la Maternitat i Sant Ramon,4037,2145,1157,988
2017,4,Les Corts,20,la Maternitat i Sant Ramon,4038,1287,693,594
2017,4,Les Corts,20,la Maternitat i Sant Ramon,4039,1211,635,576
2017,4,Les Corts,20,la Maternitat i Sant Ramon,4040,1583,852,731
2017,4,Les Corts,20,la Maternitat i Sant Ramon,4041,1330,704,626
2017,4,Les Corts,20,la Maternitat i Sant Ramon,4042,1735,905,830
2017,4,Les Corts,20,la Maternitat i Sant Ramon,4043,1639,902,737
2017,4,Les Corts,20,la Maternitat i Sant Ramon,4044,1624,855,769
2017,4,Les Corts,20,la Maternitat i Sant Ramon,4045,1423,756,667
2017,4,Les Corts,20,la Maternitat i Sant Ramon,4046,2456,1255,1201
2017,4,Les Corts,20,la Maternitat i Sant Ramon,4047,1746,916,830
2017,4,Les Corts,20,la Maternitat i Sant Ramon,4048,1527,834,693
2017,4,Les Corts,20,la Maternitat i Sant Ramon,4049,1176,632,544
2017,4,Les Corts,20,la Maternitat i Sant Ramon,4084,1379,747,632
2017,4,Les Corts,21,Pedralbes,4050,2094,1124,970
2017,4,Les Corts,21,Pedralbes,4051,1636,896,740
2017,4,Les Corts,21,Pedralbes,4052,2191,1201,990
2017,4,Les Corts,21,Pedralbes,4053,1705,876,829
2017,4,Les Corts,21,Pedralbes,4054,1085,577,508
2017,4,Les Corts,21,Pedralbes,4055,1604,831,773
2017,4,Les Corts,21,Pedralbes,4056,1802,939,863
2017,5,Sarrià-Sant Gervasi,22,"Vallvidrera, el Tibidabo i les Planes",5001,1757,870,887
2017,5,Sarrià-Sant Gervasi,22,"Vallvidrera, el Tibidabo i les Planes",5002,1552,807,745
2017,5,Sarrià-Sant Gervasi,22,"Vallvidrera, el Tibidabo i les Planes",5003,1380,685,695
2017,5,Sarrià-Sant Gervasi,23,Sarrià,5004,1100,638,462
2017,5,Sarrià-Sant Gervasi,23,Sarrià,5005,1201,622,579
2017,5,Sarrià-Sant Gervasi,23,Sarrià,5006,1783,892,891
2017,5,Sarrià-Sant Gervasi,23,Sarrià,5007,1724,868,856
2017,5,Sarrià-Sant Gervasi,23,Sarrià,5008,1640,879,761
2017,5,Sarrià-Sant Gervasi,23,Sarrià,5009,1727,944,783
2017,5,Sarrià-Sant Gervasi,23,Sarrià,5010,1619,875,744
2017,5,Sarrià-Sant Gervasi,23,Sarrià,5011,1409,757,652
2017,5,Sarrià-Sant Gervasi,23,Sarrià,5012,1395,762,633
2017,5,Sarrià-Sant Gervasi,23,Sarrià,5013,1705,897,808
2017,5,Sarrià-Sant Gervasi,23,Sarrià,5014,1731,907,824
2017,5,Sarrià-Sant Gervasi,23,Sarrià,5015,1610,880,730
2017,5,Sarrià-Sant Gervasi,23,Sarrià,5016,1897,1042,855
2017,5,Sarrià-Sant Gervasi,23,Sarrià,5017,1598,856,742
2017,5,Sarrià-Sant Gervasi,23,Sarrià,5018,1240,683,557
2017,5,Sarrià-Sant Gervasi,23,Sarrià,5019,1727,923,804
2017,5,Sarrià-Sant Gervasi,24,les Tres Torres,5020,1138,637,501
2017,5,Sarrià-Sant Gervasi,24,les Tres Torres,5021,1385,756,629
2017,5,Sarrià-Sant Gervasi,24,les Tres Torres,5022,1795,1021,774
2017,5,Sarrià-Sant Gervasi,24,les Tres Torres,5023,1481,832,649
2017,5,Sarrià-Sant Gervasi,24,les Tres Torres,5024,1909,1015,894
2017,5,Sarrià-Sant Gervasi,24,les Tres Torres,5025,1380,743,637
2017,5,Sarrià-Sant Gervasi,24,les Tres Torres,5026,1457,750,707
2017,5,Sarrià-Sant Gervasi,24,les Tres Torres,5027,1416,728,688
2017,5,Sarrià-Sant Gervasi,24,les Tres Torres,5028,1630,827,803
2017,5,Sarrià-Sant Gervasi,24,les Tres Torres,5029,1703,896,807
2017,5,Sarrià-Sant Gervasi,24,les Tres Torres,5030,1405,753,652
2017,5,Sarrià-Sant Gervasi,25,Sant Gervasi - la Bonanova,5031,1662,894,768
2017,5,Sarrià-Sant Gervasi,25,Sant Gervasi - la Bonanova,5032,1857,1003,854
2017,5,Sarrià-Sant Gervasi,25,Sant Gervasi - la Bonanova,5033,1363,734,629
2017,5,Sarrià-Sant Gervasi,25,Sant Gervasi - la Bonanova,5034,1238,694,544
2017,5,Sarrià-Sant Gervasi,25,Sant Gervasi - la Bonanova,5035,1088,563,525
2017,5,Sarrià-Sant Gervasi,25,Sant Gervasi - la Bonanova,5036,1747,910,837
2017,5,Sarrià-Sant Gervasi,25,Sant Gervasi - la Bonanova,5037,1433,814,619
2017,5,Sarrià-Sant Gervasi,25,Sant Gervasi - la Bonanova,5038,1313,716,597
2017,5,Sarrià-Sant Gervasi,25,Sant Gervasi - la Bonanova,5039,1547,837,710
2017,5,Sarrià-Sant Gervasi,25,Sant Gervasi - la Bonanova,5040,1449,802,647
2017,5,Sarrià-Sant Gervasi,25,Sant Gervasi - la Bonanova,5041,1868,946,922
2017,5,Sarrià-Sant Gervasi,25,Sant Gervasi - la Bonanova,5042,1286,667,619
2017,5,Sarrià-Sant Gervasi,25,Sant Gervasi - la Bonanova,5043,1473,788,685
2017,5,Sarrià-Sant Gervasi,25,Sant Gervasi - la Bonanova,5044,1326,727,599
2017,5,Sarrià-Sant Gervasi,25,Sant Gervasi - la Bonanova,5045,1561,850,711
2017,5,Sarrià-Sant Gervasi,25,Sant Gervasi - la Bonanova,5046,1140,650,490
2017,5,Sarrià-Sant Gervasi,25,Sant Gervasi - la Bonanova,5047,1286,698,588
2017,5,Sarrià-Sant Gervasi,25,Sant Gervasi - la Bonanova,5048,1272,696,576
2017,5,Sarrià-Sant Gervasi,26,Sant Gervasi - Galvany,5049,1671,911,760
2017,5,Sarrià-Sant Gervasi,26,Sant Gervasi - Galvany,5050,1708,924,784
2017,5,Sarrià-Sant Gervasi,26,Sant Gervasi - Galvany,5051,1641,876,765
2017,5,Sarrià-Sant Gervasi,26,Sant Gervasi - Galvany,5052,1510,841,669
2017,5,Sarrià-Sant Gervasi,26,Sant Gervasi - Galvany,5053,1543,826,717
2017,5,Sarrià-Sant Gervasi,26,Sant Gervasi - Galvany,5054,1033,586,447
2017,5,Sarrià-Sant Gervasi,26,Sant Gervasi - Galvany,5055,1440,771,669
2017,5,Sarrià-Sant Gervasi,26,Sant Gervasi - Galvany,5056,1237,725,512
2017,5,Sarrià-Sant Gervasi,26,Sant Gervasi - Galvany,5057,1725,919,806
2017,5,Sarrià-Sant Gervasi,26,Sant Gervasi - Galvany,5058,1578,857,721
2017,5,Sarrià-Sant Gervasi,26,Sant Gervasi - Galvany,5059,1642,934,708
2017,5,Sarrià-Sant Gervasi,26,Sant Gervasi - Galvany,5060,1139,624,515
2017,5,Sarrià-Sant Gervasi,26,Sant Gervasi - Galvany,5061,1449,810,639
2017,5,Sarrià-Sant Gervasi,26,Sant Gervasi - Galvany,5062,1584,903,681
2017,5,Sarrià-Sant Gervasi,26,Sant Gervasi - Galvany,5063,1590,871,719
2017,5,Sarrià-Sant Gervasi,26,Sant Gervasi - Galvany,5064,1597,885,712
2017,5,Sarrià-Sant Gervasi,26,Sant Gervasi - Galvany,5065,1677,914,763
2017,5,Sarrià-Sant Gervasi,26,Sant Gervasi - Galvany,5066,1212,664,548
2017,5,Sarrià-Sant Gervasi,26,Sant Gervasi - Galvany,5067,1345,731,614
2017,5,Sarrià-Sant Gervasi,26,Sant Gervasi - Galvany,5068,1555,840,715
2017,5,Sarrià-Sant Gervasi,26,Sant Gervasi - Galvany,5069,1787,979,808
2017,5,Sarrià-Sant Gervasi,26,Sant Gervasi - Galvany,5070,1465,814,651
2017,5,Sarrià-Sant Gervasi,26,Sant Gervasi - Galvany,5071,1623,897,726
2017,5,Sarrià-Sant Gervasi,26,Sant Gervasi - Galvany,5072,1693,935,758
2017,5,Sarrià-Sant Gervasi,26,Sant Gervasi - Galvany,5073,1650,903,747
2017,5,Sarrià-Sant Gervasi,26,Sant Gervasi - Galvany,5074,1722,926,796
2017,5,Sarrià-Sant Gervasi,26,Sant Gervasi - Galvany,5075,1773,993,780
2017,5,Sarrià-Sant Gervasi,26,Sant Gervasi - Galvany,5076,1389,755,634
2017,5,Sarrià-Sant Gervasi,26,Sant Gervasi - Galvany,5077,1489,832,657
2017,5,Sarrià-Sant Gervasi,26,Sant Gervasi - Galvany,5078,2101,1121,980
2017,5,Sarrià-Sant Gervasi,26,Sant Gervasi - Galvany,5079,1248,690,558
2017,5,Sarrià-Sant Gervasi,27,el Putget i Farró,5080,1372,772,600
2017,5,Sarrià-Sant Gervasi,27,el Putget i Farró,5081,1624,908,716
2017,5,Sarrià-Sant Gervasi,27,el Putget i Farró,5082,1695,908,787
2017,5,Sarrià-Sant Gervasi,27,el Putget i Farró,5083,1302,711,591
2017,5,Sarrià-Sant Gervasi,27,el Putget i Farró,5084,1342,753,589
2017,5,Sarrià-Sant Gervasi,27,el Putget i Farró,5085,1307,699,608
2017,5,Sarrià-Sant Gervasi,27,el Putget i Farró,5086,1309,697,612
2017,5,Sarrià-Sant Gervasi,27,el Putget i Farró,5087,1534,858,676
2017,5,Sarrià-Sant Gervasi,27,el Putget i Farró,5088,1732,906,826
2017,5,Sarrià-Sant Gervasi,27,el Putget i Farró,5089,1725,907,818
2017,5,Sarrià-Sant Gervasi,27,el Putget i Farró,5090,1888,1009,879
2017,5,Sarrià-Sant Gervasi,27,el Putget i Farró,5091,1524,850,674
2017,5,Sarrià-Sant Gervasi,27,el Putget i Farró,5092,1561,861,700
2017,5,Sarrià-Sant Gervasi,27,el Putget i Farró,5093,1166,662,504
2017,5,Sarrià-Sant Gervasi,27,el Putget i Farró,5094,2557,1412,1145
2017,5,Sarrià-Sant Gervasi,27,el Putget i Farró,5095,1644,912,732
2017,5,Sarrià-Sant Gervasi,27,el Putget i Farró,5096,1119,617,502
2017,5,Sarrià-Sant Gervasi,27,el Putget i Farró,5097,1581,833,748
2017,5,Sarrià-Sant Gervasi,27,el Putget i Farró,5098,1533,844,689
2017,6,Gràcia,28,Vallcarca i els Penitents,6001,1173,654,519
2017,6,Gràcia,28,Vallcarca i els Penitents,6002,1462,785,677
2017,6,Gràcia,28,Vallcarca i els Penitents,6003,2236,1160,1076
2017,6,Gràcia,28,Vallcarca i els Penitents,6004,1429,738,691
2017,6,Gràcia,28,Vallcarca i els Penitents,6006,999,536,463
2017,6,Gràcia,28,Vallcarca i els Penitents,6007,1875,994,881
2017,6,Gràcia,28,Vallcarca i els Penitents,6008,1942,1095,847
2017,6,Gràcia,28,Vallcarca i els Penitents,6009,1236,650,586
2017,6,Gràcia,28,Vallcarca i els Penitents,6010,1061,571,490
2017,6,Gràcia,28,Vallcarca i els Penitents,6011,1298,688,610
2017,6,Gràcia,28,Vallcarca i els Penitents,6012,1110,584,526
2017,6,Gràcia,29,el Coll,6013,1733,918,815
2017,6,Gràcia,29,el Coll,6014,1376,732,644
2017,6,Gràcia,29,el Coll,6015,1395,739,656
2017,6,Gràcia,29,el Coll,6016,1587,854,733
2017,6,Gràcia,29,el Coll,6017,1337,709,628
2017,6,Gràcia,30,la Salut,6018,1299,676,623
2017,6,Gràcia,30,la Salut,6019,1496,811,685
2017,6,Gràcia,30,la Salut,6020,1122,594,528
2017,6,Gràcia,30,la Salut,6021,1343,746,597
2017,6,Gràcia,30,la Salut,6022,1339,675,664
2017,6,Gràcia,30,la Salut,6023,1354,721,633
2017,6,Gràcia,30,la Salut,6024,1642,918,724
2017,6,Gràcia,30,la Salut,6025,1410,773,637
2017,6,Gràcia,30,la Salut,6026,1008,547,461
2017,6,Gràcia,30,la Salut,6027,1194,678,516
2017,6,Gràcia,31,Vila de Gràcia,6028,1323,702,621
2017,6,Gràcia,31,Vila de Gràcia,6029,1223,664,559
2017,6,Gràcia,31,Vila de Gràcia,6030,1344,722,622
2017,6,Gràcia,31,Vila de Gràcia,6031,1099,616,483
2017,6,Gràcia,31,Vila de Gràcia,6032,1156,611,545
2017,6,Gràcia,31,Vila de Gràcia,6033,1302,711,591
2017,6,Gràcia,31,Vila de Gràcia,6034,1283,720,563
2017,6,Gràcia,31,Vila de Gràcia,6035,1016,548,468
2017,6,Gràcia,31,Vila de Gràcia,6036,1445,820,625
2017,6,Gràcia,31,Vila de Gràcia,6037,1128,604,524
2017,6,Gràcia,31,Vila de Gràcia,6038,1482,856,626
2017,6,Gràcia,31,Vila de Gràcia,6039,1611,893,718
2017,6,Gràcia,31,Vila de Gràcia,6040,1626,951,675
2017,6,Gràcia,31,Vila de Gràcia,6041,1715,938,777
2017,6,Gràcia,31,Vila de Gràcia,6042,1773,955,818
2017,6,Gràcia,31,Vila de Gràcia,6043,1310,713,597
2017,6,Gràcia,31,Vila de Gràcia,6044,1495,789,706
2017,6,Gràcia,31,Vila de Gràcia,6045,1325,721,604
2017,6,Gràcia,31,Vila de Gràcia,6046,1147,619,528
2017,6,Gràcia,31,Vila de Gràcia,6047,1698,870,828
2017,6,Gràcia,31,Vila de Gràcia,6048,1388,735,653
2017,6,Gràcia,31,Vila de Gràcia,6049,1130,626,504
2017,6,Gràcia,31,Vila de Gràcia,6050,1260,675,585
2017,6,Gràcia,31,Vila de Gràcia,6051,1331,753,578
2017,6,Gràcia,31,Vila de Gràcia,6052,1574,853,721
2017,6,Gràcia,31,Vila de Gràcia,6053,1481,817,664
2017,6,Gràcia,31,Vila de Gràcia,6054,1630,851,779
2017,6,Gràcia,31,Vila de Gràcia,6055,1415,800,615
2017,6,Gràcia,31,Vila de Gràcia,6056,1579,853,726
2017,6,Gràcia,31,Vila de Gràcia,6057,1509,834,675
2017,6,Gràcia,31,Vila de Gràcia,6058,1601,887,714
2017,6,Gràcia,31,Vila de Gràcia,6059,1491,805,686
2017,6,Gràcia,31,Vila de Gràcia,6060,1790,963,827
2017,6,Gràcia,31,Vila de Gràcia,6061,1343,726,617
2017,6,Gràcia,31,Vila de Gràcia,6062,1315,709,606
2017,6,Gràcia,31,Vila de Gràcia,6063,1547,832,715
2017,6,Gràcia,32,el Camp d'en Grassot i Gràcia Nova,6064,1932,1055,877
2017,6,Gràcia,32,el Camp d'en Grassot i Gràcia Nova,6065,1208,661,547
2017,6,Gràcia,32,el Camp d'en Grassot i Gràcia Nova,6066,993,552,441
2017,6,Gràcia,32,el Camp d'en Grassot i Gràcia Nova,6067,1780,970,810
2017,6,Gràcia,32,el Camp d'en Grassot i Gràcia Nova,6068,1550,858,692
2017,6,Gràcia,32,el Camp d'en Grassot i Gràcia Nova,6069,1103,589,514
2017,6,Gràcia,32,el Camp d'en Grassot i Gràcia Nova,6070,1859,1039,820
2017,6,Gràcia,32,el Camp d'en Grassot i Gràcia Nova,6071,1067,569,498
2017,6,Gràcia,32,el Camp d'en Grassot i Gràcia Nova,6072,1614,895,719
2017,6,Gràcia,32,el Camp d'en Grassot i Gràcia Nova,6073,1383,750,633
2017,6,Gràcia,32,el Camp d'en Grassot i Gràcia Nova,6074,1125,593,532
2017,6,Gràcia,32,el Camp d'en Grassot i Gràcia Nova,6075,1092,592,500
2017,6,Gràcia,32,el Camp d'en Grassot i Gràcia Nova,6076,1305,666,639
2017,6,Gràcia,32,el Camp d'en Grassot i Gràcia Nova,6077,1182,668,514
2017,6,Gràcia,32,el Camp d'en Grassot i Gràcia Nova,6078,1330,717,613
2017,6,Gràcia,32,el Camp d'en Grassot i Gràcia Nova,6079,1094,589,505
2017,6,Gràcia,32,el Camp d'en Grassot i Gràcia Nova,6080,1148,621,527
2017,6,Gràcia,32,el Camp d'en Grassot i Gràcia Nova,6081,1295,706,589
2017,6,Gràcia,32,el Camp d'en Grassot i Gràcia Nova,6082,1814,1001,813
2017,6,Gràcia,32,el Camp d'en Grassot i Gràcia Nova,6083,1710,895,815
2017,6,Gràcia,32,el Camp d'en Grassot i Gràcia Nova,6084,1515,814,701
2017,6,Gràcia,32,el Camp d'en Grassot i Gràcia Nova,6085,1277,702,575
2017,6,Gràcia,32,el Camp d'en Grassot i Gràcia Nova,6086,990,523,467
2017,6,Gràcia,32,el Camp d'en Grassot i Gràcia Nova,6087,1860,1028,832
2017,6,Gràcia,32,el Camp d'en Grassot i Gràcia Nova,6088,1205,662,543
2017,7,Horta-Guinardó,33,el Baix Guinardó,7001,1573,876,697
2017,7,Horta-Guinardó,33,el Baix Guinardó,7002,1145,627,518
2017,7,Horta-Guinardó,33,el Baix Guinardó,7003,1324,712,612
2017,7,Horta-Guinardó,33,el Baix Guinardó,7004,1486,791,695
2017,7,Horta-Guinardó,33,el Baix Guinardó,7005,1506,785,721
2017,7,Horta-Guinardó,33,el Baix Guinardó,7006,948,510,438
2017,7,Horta-Guinardó,33,el Baix Guinardó,7007,1403,786,617
2017,7,Horta-Guinardó,33,el Baix Guinardó,7008,1443,757,686
2017,7,Horta-Guinardó,33,el Baix Guinardó,7009,1194,661,533
2017,7,Horta-Guinardó,33,el Baix Guinardó,7010,1318,699,619
2017,7,Horta-Guinardó,33,el Baix Guinardó,7011,1139,630,509
2017,7,Horta-Guinardó,33,el Baix Guinardó,7012,1604,867,737
2017,7,Horta-Guinardó,33,el Baix Guinardó,7013,1222,640,582
2017,7,Horta-Guinardó,33,el Baix Guinardó,7014,921,484,437
2017,7,Horta-Guinardó,33,el Baix Guinardó,7015,1378,726,652
2017,7,Horta-Guinardó,33,el Baix Guinardó,7016,1336,687,649
2017,7,Horta-Guinardó,33,el Baix Guinardó,7017,1646,928,718
2017,7,Horta-Guinardó,33,el Baix Guinardó,7018,1676,930,746
2017,7,Horta-Guinardó,33,el Baix Guinardó,7019,1472,795,677
2017,7,Horta-Guinardó,34,Can Baró,7020,1570,860,710
2017,7,Horta-Guinardó,34,Can Baró,7021,1017,522,495
2017,7,Horta-Guinardó,34,Can Baró,7022,1158,608,550
2017,7,Horta-Guinardó,34,Can Baró,7023,1296,658,638
2017,7,Horta-Guinardó,34,Can Baró,7024,1475,785,690
2017,7,Horta-Guinardó,34,Can Baró,7025,1428,774,654
2017,7,Horta-Guinardó,34,Can Baró,7026,1076,585,491
2017,7,Horta-Guinardó,35,el Guinardó,7027,1962,1043,919
2017,7,Horta-Guinardó,35,el Guinardó,7028,1503,774,729
2017,7,Horta-Guinardó,35,el Guinardó,7029,1299,663,636
2017,7,Horta-Guinardó,35,el Guinardó,7030,1386,763,623
2017,7,Horta-Guinardó,35,el Guinardó,7031,1553,799,754
2017,7,Horta-Guinardó,35,el Guinardó,7032,1393,699,694
2017,7,Horta-Guinardó,35,el Guinardó,7033,1388,738,650
2017,7,Horta-Guinardó,35,el Guinardó,7034,1716,894,822
2017,7,Horta-Guinardó,35,el Guinardó,7035,1761,972,789
2017,7,Horta-Guinardó,35,el Guinardó,7036,1387,752,635
2017,7,Horta-Guinardó,35,el Guinardó,7037,1478,813,665
2017,7,Horta-Guinardó,35,el Guinardó,7038,1324,715,609
2017,7,Horta-Guinardó,35,el Guinardó,7039,1594,851,743
2017,7,Horta-Guinardó,35,el Guinardó,7040,1493,801,692
2017,7,Horta-Guinardó,35,el Guinardó,7041,1349,745,604
2017,7,Horta-Guinardó,35,el Guinardó,7042,1569,852,717
2017,7,Horta-Guinardó,35,el Guinardó,7043,1380,737,643
2017,7,Horta-Guinardó,35,el Guinardó,7044,1297,691,606
2017,7,Horta-Guinardó,35,el Guinardó,7045,1483,775,708
2017,7,Horta-Guinardó,35,el Guinardó,7046,1425,766,659
2017,7,Horta-Guinardó,35,el Guinardó,7047,1474,770,704
2017,7,Horta-Guinardó,35,el Guinardó,7048,1239,677,562
2017,7,Horta-Guinardó,35,el Guinardó,7049,1206,630,576
2017,7,Horta-Guinardó,35,el Guinardó,7050,1153,611,542
2017,7,Horta-Guinardó,35,el Guinardó,7051,1726,945,781
2017,7,Horta-Guinardó,36,la Font d'en Fargues,7052,1215,643,572
2017,7,Horta-Guinardó,36,la Font d'en Fargues,7053,1438,756,682
2017,7,Horta-Guinardó,36,la Font d'en Fargues,7054,1561,824,737
2017,7,Horta-Guinardó,36,la Font d'en Fargues,7055,1202,636,566
2017,7,Horta-Guinardó,36,la Font d'en Fargues,7056,1168,597,571
2017,7,Horta-Guinardó,36,la Font d'en Fargues,7057,1447,774,673
2017,7,Horta-Guinardó,36,la Font d'en Fargues,7058,1359,695,664
2017,7,Horta-Guinardó,37,el Carmel,7059,1265,659,606
2017,7,Horta-Guinardó,37,el Carmel,7060,1810,911,899
2017,7,Horta-Guinardó,37,el Carmel,7061,1200,600,600
2017,7,Horta-Guinardó,37,el Carmel,7062,1283,667,616
2017,7,Horta-Guinardó,37,el Carmel,7063,1449,735,714
2017,7,Horta-Guinardó,37,el Carmel,7064,1656,863,793
2017,7,Horta-Guinardó,37,el Carmel,7065,1669,873,796
2017,7,Horta-Guinardó,37,el Carmel,7066,1748,922,826
2017,7,Horta-Guinardó,37,el Carmel,7067,1479,795,684
2017,7,Horta-Guinardó,37,el Carmel,7068,1275,674,601
2017,7,Horta-Guinardó,37,el Carmel,7069,1430,737,693
2017,7,Horta-Guinardó,37,el Carmel,7070,1418,750,668
2017,7,Horta-Guinardó,37,el Carmel,7071,1366,737,629
2017,7,Horta-Guinardó,37,el Carmel,7072,1341,693,648
2017,7,Horta-Guinardó,37,el Carmel,7073,1121,625,496
2017,7,Horta-Guinardó,37,el Carmel,7074,1680,884,796
2017,7,Horta-Guinardó,37,el Carmel,7075,1235,639,596
2017,7,Horta-Guinardó,37,el Carmel,7076,1331,690,641
2017,7,Horta-Guinardó,37,el Carmel,7077,1352,697,655
2017,7,Horta-Guinardó,37,el Carmel,7078,1364,699,665
2017,7,Horta-Guinardó,37,el Carmel,7079,1352,699,653
2017,7,Horta-Guinardó,37,el Carmel,7080,1759,936,823
2017,7,Horta-Guinardó,38,la Teixonera,7081,1949,1003,946
2017,7,Horta-Guinardó,38,la Teixonera,7082,1243,633,610
2017,7,Horta-Guinardó,38,la Teixonera,7083,1274,664,610
2017,7,Horta-Guinardó,38,la Teixonera,7084,1278,654,624
2017,7,Horta-Guinardó,38,la Teixonera,7085,1273,658,615
2017,7,Horta-Guinardó,38,la Teixonera,7086,1466,757,709
2017,7,Horta-Guinardó,38,la Teixonera,7087,1575,833,742
2017,7,Horta-Guinardó,38,la Teixonera,7088,1576,814,762
2017,7,Horta-Guinardó,39,Sant Genís dels Agudells,7089,1349,747,602
2017,7,Horta-Guinardó,39,Sant Genís dels Agudells,7090,1386,704,682
2017,7,Horta-Guinardó,39,Sant Genís dels Agudells,7091,1152,617,535
2017,7,Horta-Guinardó,39,Sant Genís dels Agudells,7092,1357,753,604
2017,7,Horta-Guinardó,39,Sant Genís dels Agudells,7093,1584,824,760
2017,7,Horta-Guinardó,40,Montbau,7094,1263,703,560
2017,7,Horta-Guinardó,40,Montbau,7095,1517,831,686
2017,7,Horta-Guinardó,40,Montbau,7096,1408,765,643
2017,7,Horta-Guinardó,40,Montbau,7097,920,525,395
2017,7,Horta-Guinardó,41,la Vall d'Hebron,7098,2139,1145,994
2017,7,Horta-Guinardó,41,la Vall d'Hebron,7099,1087,559,528
2017,7,Horta-Guinardó,41,la Vall d'Hebron,7100,1186,626,560
2017,7,Horta-Guinardó,41,la Vall d'Hebron,7101,1380,718,662
2017,7,Horta-Guinardó,42,la Clota,7102,611,297,314
2017,7,Horta-Guinardó,43,Horta,7103,1537,833,704
2017,7,Horta-Guinardó,43,Horta,7104,1602,860,742
2017,7,Horta-Guinardó,43,Horta,7105,1086,561,525
2017,7,Horta-Guinardó,43,Horta,7106,1196,635,561
2017,7,Horta-Guinardó,43,Horta,7107,1251,645,606
2017,7,Horta-Guinardó,43,Horta,7108,1219,635,584
2017,7,Horta-Guinardó,43,Horta,7109,1633,859,774
2017,7,Horta-Guinardó,43,Horta,7110,1054,601,453
2017,7,Horta-Guinardó,43,Horta,7111,887,497,390
2017,7,Horta-Guinardó,43,Horta,7112,1247,656,591
2017,7,Horta-Guinardó,43,Horta,7113,1195,612,583
2017,7,Horta-Guinardó,43,Horta,7114,1159,617,542
2017,7,Horta-Guinardó,43,Horta,7115,1103,565,538
2017,7,Horta-Guinardó,43,Horta,7116,1466,777,689
2017,7,Horta-Guinardó,43,Horta,7117,1570,727,843
2017,7,Horta-Guinardó,43,Horta,7118,1224,698,526
2017,7,Horta-Guinardó,43,Horta,7119,1196,645,551
2017,7,Horta-Guinardó,43,Horta,7120,1215,656,559
2017,7,Horta-Guinardó,43,Horta,7121,1177,645,532
2017,7,Horta-Guinardó,43,Horta,7122,1334,743,591
2017,7,Horta-Guinardó,43,Horta,7123,1392,722,670
2017,8,Nou Barris,44,Vilapicina i la Torre Llobeta,8001,1282,683,599
2017,8,Nou Barris,44,Vilapicina i la Torre Llobeta,8002,1232,667,565
2017,8,Nou Barris,44,Vilapicina i la Torre Llobeta,8003,1234,646,588
2017,8,Nou Barris,44,Vilapicina i la Torre Llobeta,8004,1436,786,650
2017,8,Nou Barris,44,Vilapicina i la Torre Llobeta,8005,1152,610,542
2017,8,Nou Barris,44,Vilapicina i la Torre Llobeta,8006,1501,795,706
2017,8,Nou Barris,44,Vilapicina i la Torre Llobeta,8007,1197,674,523
2017,8,Nou Barris,44,Vilapicina i la Torre Llobeta,8008,1591,832,759
2017,8,Nou Barris,44,Vilapicina i la Torre Llobeta,8009,1676,881,795
2017,8,Nou Barris,44,Vilapicina i la Torre Llobeta,8010,1112,601,511
2017,8,Nou Barris,44,Vilapicina i la Torre Llobeta,8011,1196,658,538
2017,8,Nou Barris,44,Vilapicina i la Torre Llobeta,8012,1339,745,594
2017,8,Nou Barris,44,Vilapicina i la Torre Llobeta,8013,1186,649,537
2017,8,Nou Barris,44,Vilapicina i la Torre Llobeta,8014,1215,651,564
2017,8,Nou Barris,44,Vilapicina i la Torre Llobeta,8015,1410,786,624
2017,8,Nou Barris,44,Vilapicina i la Torre Llobeta,8016,1146,635,511
2017,8,Nou Barris,44,Vilapicina i la Torre Llobeta,8017,1371,725,646
2017,8,Nou Barris,44,Vilapicina i la Torre Llobeta,8018,1545,835,710
2017,8,Nou Barris,44,Vilapicina i la Torre Llobeta,8019,1797,970,827
2017,8,Nou Barris,45,Porta,8020,1302,711,591
2017,8,Nou Barris,45,Porta,8021,1459,794,665
2017,8,Nou Barris,45,Porta,8022,1227,665,562
2017,8,Nou Barris,45,Porta,8023,1347,704,643
2017,8,Nou Barris,45,Porta,8024,1396,766,630
2017,8,Nou Barris,45,Porta,8025,1188,660,528
2017,8,Nou Barris,45,Porta,8026,1418,757,661
2017,8,Nou Barris,45,Porta,8027,1285,652,633
2017,8,Nou Barris,45,Porta,8028,1094,599,495
2017,8,Nou Barris,45,Porta,8029,1519,810,709
2017,8,Nou Barris,45,Porta,8030,1508,803,705
2017,8,Nou Barris,45,Porta,8031,1313,696,617
2017,8,Nou Barris,45,Porta,8032,1295,697,598
2017,8,Nou Barris,45,Porta,8033,1460,758,702
2017,8,Nou Barris,45,Porta,8034,1203,684,519
2017,8,Nou Barris,45,Porta,8035,2034,992,1042
2017,8,Nou Barris,45,Porta,8036,1492,806,686
2017,8,Nou Barris,45,Porta,8037,1506,832,674
2017,8,Nou Barris,46,el Turó de la Peira,8038,1470,816,654
2017,8,Nou Barris,46,el Turó de la Peira,8039,1525,819,706
2017,8,Nou Barris,46,el Turó de la Peira,8040,1652,878,774
2017,8,Nou Barris,46,el Turó de la Peira,8041,2352,1213,1139
2017,8,Nou Barris,46,el Turó de la Peira,8042,1274,698,576
2017,8,Nou Barris,46,el Turó de la Peira,8043,1155,651,504
2017,8,Nou Barris,46,el Turó de la Peira,8044,1358,725,633
2017,8,Nou Barris,46,el Turó de la Peira,8045,1730,904,826
2017,8,Nou Barris,46,el Turó de la Peira,8046,1376,758,618
2017,8,Nou Barris,46,el Turó de la Peira,8047,1574,851,723
2017,8,Nou Barris,47,Can Peguera,8048,1013,532,481
2017,8,Nou Barris,47,Can Peguera,8049,1260,665,595
2017,8,Nou Barris,48,la Guineueta,8050,1411,754,657
2017,8,Nou Barris,48,la Guineueta,8051,1355,713,642
2017,8,Nou Barris,48,la Guineueta,8052,904,506,398
2017,8,Nou Barris,48,la Guineueta,8053,1174,620,554
2017,8,Nou Barris,48,la Guineueta,8054,1692,941,751
2017,8,Nou Barris,48,la Guineueta,8055,1871,973,898
2017,8,Nou Barris,48,la Guineueta,8056,1481,791,690
2017,8,Nou Barris,48,la Guineueta,8057,1331,711,620
2017,8,Nou Barris,48,la Guineueta,8058,1599,869,730
2017,8,Nou Barris,48,la Guineueta,8059,964,510,454
2017,8,Nou Barris,48,la Guineueta,8215,1465,808,657
2017,8,Nou Barris,49,Canyelles,8060,1175,626,549
2017,8,Nou Barris,49,Canyelles,8061,1670,855,815
2017,8,Nou Barris,49,Canyelles,8062,1171,607,564
2017,8,Nou Barris,49,Canyelles,8063,1100,566,534
2017,8,Nou Barris,49,Canyelles,8064,1747,927,820
2017,8,Nou Barris,50,les Roquetes,8065,1684,821,863
2017,8,Nou Barris,50,les Roquetes,8066,1543,785,758
2017,8,Nou Barris,50,les Roquetes,8067,1699,870,829
2017,8,Nou Barris,50,les Roquetes,8068,1797,949,848
2017,8,Nou Barris,50,les Roquetes,8069,1490,770,720
2017,8,Nou Barris,50,les Roquetes,8070,1417,752,665
2017,8,Nou Barris,50,les Roquetes,8071,1643,848,795
2017,8,Nou Barris,50,les Roquetes,8072,1213,637,576
2017,8,Nou Barris,50,les Roquetes,8073,1736,925,811
2017,8,Nou Barris,50,les Roquetes,8074,1409,736,673
2017,8,Nou Barris,51,Verdun,8075,1860,986,874
2017,8,Nou Barris,51,Verdun,8076,1548,837,711
2017,8,Nou Barris,51,Verdun,8077,1389,744,645
2017,8,Nou Barris,51,Verdun,8078,1515,815,700
2017,8,Nou Barris,51,Verdun,8079,1418,740,678
2017,8,Nou Barris,51,Verdun,8080,1471,791,680
2017,8,Nou Barris,51,Verdun,8081,1607,835,772
2017,8,Nou Barris,51,Verdun,8082,1560,866,694
2017,8,Nou Barris,52,la Prosperitat,8083,1297,712,585
2017,8,Nou Barris,52,la Prosperitat,8084,1170,628,542
2017,8,Nou Barris,52,la Prosperitat,8085,1428,741,687
2017,8,Nou Barris,52,la Prosperitat,8086,1690,906,784
2017,8,Nou Barris,52,la Prosperitat,8087,1227,668,559
2017,8,Nou Barris,52,la Prosperitat,8088,1275,682,593
2017,8,Nou Barris,52,la Prosperitat,8089,1260,669,591
2017,8,Nou Barris,52,la Prosperitat,8090,1222,647,575
2017,8,Nou Barris,52,la Prosperitat,8091,1180,599,581
2017,8,Nou Barris,52,la Prosperitat,8092,1004,516,488
2017,8,Nou Barris,52,la Prosperitat,8093,1241,637,604
2017,8,Nou Barris,52,la Prosperitat,8094,1485,777,708
2017,8,Nou Barris,52,la Prosperitat,8095,1094,578,516
2017,8,Nou Barris,52,la Prosperitat,8096,1459,747,712
2017,8,Nou Barris,52,la Prosperitat,8097,1340,709,631
2017,8,Nou Barris,52,la Prosperitat,8098,1221,650,571
2017,8,Nou Barris,52,la Prosperitat,8099,1330,696,634
2017,8,Nou Barris,52,la Prosperitat,8100,1252,697,555
2017,8,Nou Barris,52,la Prosperitat,8101,1708,920,788
2017,8,Nou Barris,52,la Prosperitat,8102,1532,838,694
2017,8,Nou Barris,53,la Trinitat Nova,8103,1535,762,773
2017,8,Nou Barris,53,la Trinitat Nova,8104,1231,681,550
2017,8,Nou Barris,53,la Trinitat Nova,8105,1525,795,730
2017,8,Nou Barris,53,la Trinitat Nova,8106,1191,638,553
2017,8,Nou Barris,53,la Trinitat Nova,8107,1789,937,852
2017,8,Nou Barris,54,Torre Baró,8108,1872,963,909
2017,8,Nou Barris,54,Torre Baró,8109,987,481,506
2017,8,Nou Barris,55,Ciutat Meridiana,8110,1885,934,951
2017,8,Nou Barris,55,Ciutat Meridiana,8111,1594,851,743
2017,8,Nou Barris,55,Ciutat Meridiana,8112,1675,853,822
2017,8,Nou Barris,55,Ciutat Meridiana,8113,1729,866,863
2017,8,Nou Barris,55,Ciutat Meridiana,8114,1840,916,924
2017,8,Nou Barris,55,Ciutat Meridiana,8115,1646,847,799
2017,8,Nou Barris,56,Vallbona,8116,1379,701,678
2017,9,Sant Andreu,57,la Trinitat Vella,9001,2568,1186,1382
2017,9,Sant Andreu,57,la Trinitat Vella,9002,2112,1017,1095
2017,9,Sant Andreu,57,la Trinitat Vella,9003,2094,1010,1084
2017,9,Sant Andreu,57,la Trinitat Vella,9004,1642,837,805
2017,9,Sant Andreu,57,la Trinitat Vella,9005,1590,797,793
2017,9,Sant Andreu,58,Baró de Viver,9006,1238,636,602
2017,9,Sant Andreu,58,Baró de Viver,9007,1301,670,631
2017,9,Sant Andreu,59,el Bon Pastor,9008,1927,960,967
2017,9,Sant Andreu,59,el Bon Pastor,9009,1434,734,700
2017,9,Sant Andreu,59,el Bon Pastor,9010,1782,914,868
2017,9,Sant Andreu,59,el Bon Pastor,9011,1737,882,855
2017,9,Sant Andreu,59,el Bon Pastor,9013,1897,991,906
2017,9,Sant Andreu,59,el Bon Pastor,9014,2011,928,1083
2017,9,Sant Andreu,59,el Bon Pastor,9015,1794,911,883
2017,9,Sant Andreu,60,Sant Andreu,9016,1371,727,644
2017,9,Sant Andreu,60,Sant Andreu,9017,1502,768,734
2017,9,Sant Andreu,60,Sant Andreu,9018,1478,762,716
2017,9,Sant Andreu,60,Sant Andreu,9019,2440,1235,1205
2017,9,Sant Andreu,60,Sant Andreu,9020,1125,601,524
2017,9,Sant Andreu,60,Sant Andreu,9021,1366,722,644
2017,9,Sant Andreu,60,Sant Andreu,9022,1195,629,566
2017,9,Sant Andreu,60,Sant Andreu,9023,1219,633,586
2017,9,Sant Andreu,60,Sant Andreu,9024,1140,626,514
2017,9,Sant Andreu,60,Sant Andreu,9025,1167,633,534
2017,9,Sant Andreu,60,Sant Andreu,9026,1534,809,725
2017,9,Sant Andreu,60,Sant Andreu,9027,1337,691,646
2017,9,Sant Andreu,60,Sant Andreu,9028,1634,837,797
2017,9,Sant Andreu,60,Sant Andreu,9029,1144,592,552
2017,9,Sant Andreu,60,Sant Andreu,9030,1504,812,692
2017,9,Sant Andreu,60,Sant Andreu,9031,1172,617,555
2017,9,Sant Andreu,60,Sant Andreu,9032,2143,1137,1006
2017,9,Sant Andreu,60,Sant Andreu,9033,3214,1659,1555
2017,9,Sant Andreu,60,Sant Andreu,9034,1401,747,654
2017,9,Sant Andreu,60,Sant Andreu,9035,1542,821,721
2017,9,Sant Andreu,60,Sant Andreu,9036,1419,759,660
2017,9,Sant Andreu,60,Sant Andreu,9037,1436,763,673
2017,9,Sant Andreu,60,Sant Andreu,9038,1575,836,739
2017,9,Sant Andreu,60,Sant Andreu,9039,1550,807,743
2017,9,Sant Andreu,60,Sant Andreu,9040,1523,826,697
2017,9,Sant Andreu,60,Sant Andreu,9041,1428,777,651
2017,9,Sant Andreu,60,Sant Andreu,9042,1239,662,577
2017,9,Sant Andreu,60,Sant Andreu,9043,1339,721,618
2017,9,Sant Andreu,60,Sant Andreu,9044,1473,768,705
2017,9,Sant Andreu,60,Sant Andreu,9045,1425,756,669
2017,9,Sant Andreu,60,Sant Andreu,9046,1298,686,612
2017,9,Sant Andreu,60,Sant Andreu,9047,1524,804,720
2017,9,Sant Andreu,60,Sant Andreu,9048,1424,744,680
2017,9,Sant Andreu,60,Sant Andreu,9049,1286,704,582
2017,9,Sant Andreu,60,Sant Andreu,9050,1554,827,727
2017,9,Sant Andreu,60,Sant Andreu,9051,1218,651,567
2017,9,Sant Andreu,60,Sant Andreu,9052,1174,612,562
2017,9,Sant Andreu,60,Sant Andreu,9053,1586,871,715
2017,9,Sant Andreu,60,Sant Andreu,9054,1124,610,514
2017,9,Sant Andreu,61,la Sagrera,9055,1733,925,808
2017,9,Sant Andreu,61,la Sagrera,9056,1142,612,530
2017,9,Sant Andreu,61,la Sagrera,9057,1536,801,735
2017,9,Sant Andreu,61,la Sagrera,9058,1508,798,710
2017,9,Sant Andreu,61,la Sagrera,9059,1394,704,690
2017,9,Sant Andreu,61,la Sagrera,9060,1348,724,624
2017,9,Sant Andreu,61,la Sagrera,9061,1705,898,807
2017,9,Sant Andreu,61,la Sagrera,9062,1111,574,537
2017,9,Sant Andreu,61,la Sagrera,9063,1131,589,542
2017,9,Sant Andreu,61,la Sagrera,9064,1204,635,569
2017,9,Sant Andreu,61,la Sagrera,9065,2044,1116,928
2017,9,Sant Andreu,61,la Sagrera,9066,1424,753,671
2017,9,Sant Andreu,61,la Sagrera,9067,1455,808,647
2017,9,Sant Andreu,61,la Sagrera,9068,1560,810,750
2017,9,Sant Andreu,61,la Sagrera,9069,922,517,405
2017,9,Sant Andreu,61,la Sagrera,9070,1767,962,805
2017,9,Sant Andreu,61,la Sagrera,9071,1863,1003,860
2017,9,Sant Andreu,61,la Sagrera,9072,1465,794,671
2017,9,Sant Andreu,61,la Sagrera,9073,1548,810,738
2017,9,Sant Andreu,61,la Sagrera,9156,1267,669,598
2017,9,Sant Andreu,62,el Congrés i els Indians,9074,1603,877,726
2017,9,Sant Andreu,62,el Congrés i els Indians,9075,1478,801,677
2017,9,Sant Andreu,62,el Congrés i els Indians,9076,1412,783,629
2017,9,Sant Andreu,62,el Congrés i els Indians,9077,1586,890,696
2017,9,Sant Andreu,62,el Congrés i els Indians,9078,1461,782,679
2017,9,Sant Andreu,62,el Congrés i els Indians,9079,1572,841,731
2017,9,Sant Andreu,62,el Congrés i els Indians,9080,1315,675,640
2017,9,Sant Andreu,62,el Congrés i els Indians,9081,1778,970,808
2017,9,Sant Andreu,62,el Congrés i els Indians,9082,1936,1038,898
2017,9,Sant Andreu,63,Navas,9083,1641,882,759
2017,9,Sant Andreu,63,Navas,9084,1734,888,846
2017,9,Sant Andreu,63,Navas,9085,1686,914,772
2017,9,Sant Andreu,63,Navas,9086,1452,785,667
2017,9,Sant Andreu,63,Navas,9087,1273,676,597
2017,9,Sant Andreu,63,Navas,9088,1983,1083,900
2017,9,Sant Andreu,63,Navas,9089,1476,821,655
2017,9,Sant Andreu,63,Navas,9090,1607,872,735
2017,9,Sant Andreu,63,Navas,9091,1862,985,877
2017,9,Sant Andreu,63,Navas,9092,1928,1006,922
2017,9,Sant Andreu,63,Navas,9093,1332,693,639
2017,9,Sant Andreu,63,Navas,9094,2077,1070,1007
2017,9,Sant Andreu,63,Navas,9095,2120,1118,1002
2017,10,Sant Martí,64,Camp de l'Arpa del Clot,10001,1611,835,776
2017,10,Sant Martí,64,Camp de l'Arpa del Clot,10002,1742,909,833
2017,10,Sant Martí,64,Camp de l'Arpa del Clot,10003,1602,835,767
2017,10,Sant Martí,64,Camp de l'Arpa del Clot,10004,1520,831,689
2017,10,Sant Martí,64,Camp de l'Arpa del Clot,10005,1598,865,733
2017,10,Sant Martí,64,Camp de l'Arpa del Clot,10006,1756,946,810
2017,10,Sant Martí,64,Camp de l'Arpa del Clot,10007,1324,678,646
2017,10,Sant Martí,64,Camp de l'Arpa del Clot,10008,1700,921,779
2017,10,Sant Martí,64,Camp de l'Arpa del Clot,10009,1560,836,724
2017,10,Sant Martí,64,Camp de l'Arpa del Clot,10010,1685,915,770
2017,10,Sant Martí,64,Camp de l'Arpa del Clot,10011,1203,646,557
2017,10,Sant Martí,64,Camp de l'Arpa del Clot,10012,1883,1001,882
2017,10,Sant Martí,64,Camp de l'Arpa del Clot,10013,1365,738,627
2017,10,Sant Martí,64,Camp de l'Arpa del Clot,10014,1418,756,662
2017,10,Sant Martí,64,Camp de l'Arpa del Clot,10015,1838,978,860
2017,10,Sant Martí,64,Camp de l'Arpa del Clot,10016,1286,664,622
2017,10,Sant Martí,64,Camp de l'Arpa del Clot,10017,1730,942,788
2017,10,Sant Martí,64,Camp de l'Arpa del Clot,10018,1401,735,666
2017,10,Sant Martí,64,Camp de l'Arpa del Clot,10019,1642,876,766
2017,10,Sant Martí,64,Camp de l'Arpa del Clot,10020,1473,781,692
2017,10,Sant Martí,64,Camp de l'Arpa del Clot,10021,1322,699,623
2017,10,Sant Martí,64,Camp de l'Arpa del Clot,10022,1292,679,613
2017,10,Sant Martí,64,Camp de l'Arpa del Clot,10023,1460,792,668
2017,10,Sant Martí,64,Camp de l'Arpa del Clot,10024,1472,753,719
2017,10,Sant Martí,64,Camp de l'Arpa del Clot,10025,1364,746,618
2017,10,Sant Martí,65,el Clot,10026,1506,786,720
2017,10,Sant Martí,65,el Clot,10027,1556,813,743
2017,10,Sant Martí,65,el Clot,10028,1801,939,862
2017,10,Sant Martí,65,el Clot,10029,1505,789,716
2017,10,Sant Martí,65,el Clot,10030,1755,930,825
2017,10,Sant Martí,65,el Clot,10031,1558,807,751
2017,10,Sant Martí,65,el Clot,10032,1452,761,691
2017,10,Sant Martí,65,el Clot,10033,889,496,393
2017,10,Sant Martí,65,el Clot,10034,1745,891,854
2017,10,Sant Martí,65,el Clot,10035,2011,1031,980
2017,10,Sant Martí,65,el Clot,10036,1469,734,735
2017,10,Sant Martí,65,el Clot,10037,1061,558,503
2017,10,Sant Martí,65,el Clot,10038,1618,830,788
2017,10,Sant Martí,65,el Clot,10039,1784,962,822
2017,10,Sant Martí,65,el Clot,10040,1921,984,937
2017,10,Sant Martí,65,el Clot,10041,1576,805,771
2017,10,Sant Martí,65,el Clot,10234,1882,1012,870
2017,10,Sant Martí,66,el Parc i la Llacuna del Poblenou,10042,2545,1310,1235
2017,10,Sant Martí,66,el Parc i la Llacuna del Poblenou,10043,2148,1080,1068
2017,10,Sant Martí,66,el Parc i la Llacuna del Poblenou,10044,1533,795,738
2017,10,Sant Martí,66,el Parc i la Llacuna del Poblenou,10045,1282,694,588
2017,10,Sant Martí,66,el Parc i la Llacuna del Poblenou,10046,1249,651,598
2017,10,Sant Martí,66,el Parc i la Llacuna del Poblenou,10047,1918,963,955
2017,10,Sant Martí,66,el Parc i la Llacuna del Poblenou,10048,1633,843,790
2017,10,Sant Martí,66,el Parc i la Llacuna del Poblenou,10049,1276,656,620
2017,10,Sant Martí,66,el Parc i la Llacuna del Poblenou,10050,1618,857,761
2017,10,Sant Martí,67,la Vila Olímpica del Poblenou,10051,1581,830,751
2017,10,Sant Martí,67,la Vila Olímpica del Poblenou,10052,2375,1182,1193
2017,10,Sant Martí,67,la Vila Olímpica del Poblenou,10053,1795,903,892
2017,10,Sant Martí,67,la Vila Olímpica del Poblenou,10054,990,523,467
2017,10,Sant Martí,67,la Vila Olímpica del Poblenou,10055,2663,1357,1306
2017,10,Sant Martí,68,el Poblenou,10056,1917,986,931
2017,10,Sant Martí,68,el Poblenou,10057,1378,693,685
2017,10,Sant Martí,68,el Poblenou,10058,1159,599,560
2017,10,Sant Martí,68,el Poblenou,10059,1693,881,812
2017,10,Sant Martí,68,el Poblenou,10060,1588,787,801
2017,10,Sant Martí,68,el Poblenou,10061,1829,966,863
2017,10,Sant Martí,68,el Poblenou,10062,1516,776,740
2017,10,Sant Martí,68,el Poblenou,10063,1224,637,587
2017,10,Sant Martí,68,el Poblenou,10064,1728,871,857
2017,10,Sant Martí,68,el Poblenou,10065,1607,826,781
2017,10,Sant Martí,68,el Poblenou,10066,2165,1096,1069
2017,10,Sant Martí,68,el Poblenou,10067,1980,1043,937
2017,10,Sant Martí,68,el Poblenou,10068,1622,821,801
2017,10,Sant Martí,68,el Poblenou,10069,2272,1200,1072
2017,10,Sant Martí,68,el Poblenou,10070,1680,900,780
2017,10,Sant Martí,68,el Poblenou,10071,1828,929,899
2017,10,Sant Martí,68,el Poblenou,10072,2042,1029,1013
2017,10,Sant Martí,68,el Poblenou,10073,1512,784,728
2017,10,Sant Martí,68,el Poblenou,10074,1684,857,827
2017,10,Sant Martí,68,el Poblenou,10075,1509,760,749
2017,10,Sant Martí,69,Diagonal Mar i el Front Marítim del Poblenou,10076,2143,1119,1024
2017,10,Sant Martí,69,Diagonal Mar i el Front Marítim del Poblenou,10077,1903,927,976
2017,10,Sant Martí,69,Diagonal Mar i el Front Marítim del Poblenou,10078,2376,1188,1188
2017,10,Sant Martí,69,Diagonal Mar i el Front Marítim del Poblenou,10079,1775,912,863
2017,10,Sant Martí,69,Diagonal Mar i el Front Marítim del Poblenou,10080,2494,1228,1266
2017,10,Sant Martí,69,Diagonal Mar i el Front Marítim del Poblenou,10235,1343,707,636
2017,10,Sant Martí,69,Diagonal Mar i el Front Marítim del Poblenou,10236,1636,866,770
2017,10,Sant Martí,70,el Besòs i el Maresme,10081,1952,974,978
2017,10,Sant Martí,70,el Besòs i el Maresme,10082,1894,895,999
2017,10,Sant Martí,70,el Besòs i el Maresme,10083,2187,952,1235
2017,10,Sant Martí,70,el Besòs i el Maresme,10084,1572,766,806
2017,10,Sant Martí,70,el Besòs i el Maresme,10085,2069,997,1072
2017,10,Sant Martí,70,el Besòs i el Maresme,10086,1970,1004,966
2017,10,Sant Martí,70,el Besòs i el Maresme,10087,1728,884,844
2017,10,Sant Martí,70,el Besòs i el Maresme,10088,1634,839,795
2017,10,Sant Martí,70,el Besòs i el Maresme,10089,2107,1010,1097
2017,10,Sant Martí,70,el Besòs i el Maresme,10090,1416,748,668
2017,10,Sant Martí,70,el Besòs i el Maresme,10091,1965,1011,954
2017,10,Sant Martí,70,el Besòs i el Maresme,10092,1492,789,703
2017,10,Sant Martí,70,el Besòs i el Maresme,10093,1077,540,537
2017,10,Sant Martí,71,Provençals del Poblenou,10094,2793,1403,1390
2017,10,Sant Martí,71,Provençals del Poblenou,10095,1313,654,659
2017,10,Sant Martí,71,Provençals del Poblenou,10096,1604,853,751
2017,10,Sant Martí,71,Provençals del Poblenou,10097,1567,819,748
2017,10,Sant Martí,71,Provençals del Poblenou,10098,1863,965,898
2017,10,Sant Martí,71,Provençals del Poblenou,10099,1110,576,534
2017,10,Sant Martí,71,Provençals del Poblenou,10100,1602,856,746
2017,10,Sant Martí,71,Provençals del Poblenou,10101,1524,745,779
2017,10,Sant Martí,71,Provençals del Poblenou,10102,2556,1331,1225
2017,10,Sant Martí,71,Provençals del Poblenou,10103,2183,1145,1038
2017,10,Sant Martí,71,Provençals del Poblenou,10104,1648,849,799
2017,10,Sant Martí,71,Provençals del Poblenou,10237,756,425,331
2017,10,Sant Martí,72,Sant Martí de Provençals,10105,2252,1208,1044
2017,10,Sant Martí,72,Sant Martí de Provençals,10106,1007,529,478
2017,10,Sant Martí,72,Sant Martí de Provençals,10107,1612,845,767
2017,10,Sant Martí,72,Sant Martí de Provençals,10108,1318,711,607
2017,10,Sant Martí,72,Sant Martí de Provençals,10109,1543,823,720
2017,10,Sant Martí,72,Sant Martí de Provençals,10110,1633,907,726
2017,10,Sant Martí,72,Sant Martí de Provençals,10111,1278,683,595
2017,10,Sant Martí,72,Sant Martí de Provençals,10112,1553,795,758
2017,10,Sant Martí,72,Sant Martí de Provençals,10113,1195,637,558
2017,10,Sant Martí,72,Sant Martí de Provençals,10114,1406,741,665
2017,10,Sant Martí,72,Sant Martí de Provençals,10115,1536,754,782
2017,10,Sant Martí,72,Sant Martí de Provençals,10116,1856,983,873
2017,10,Sant Martí,72,Sant Martí de Provençals,10117,1283,673,610
2017,10,Sant Martí,72,Sant Martí de Provençals,10118,1016,535,481
2017,10,Sant Martí,72,Sant Martí de Provençals,10119,1128,602,526
2017,10,Sant Martí,72,Sant Martí de Provençals,10120,1468,815,653
2017,10,Sant Martí,72,Sant Martí de Provençals,10121,1581,828,753
2017,10,Sant Martí,72,Sant Martí de Provençals,10122,1522,792,730
2017,10,Sant Martí,73,la Verneda i la Pau,10123,1402,720,682
2017,10,Sant Martí,73,la Verneda i la Pau,10124,1099,557,542
2017,10,Sant Martí,73,la Verneda i la Pau,10125,1120,585,535
2017,10,Sant Martí,73,la Verneda i la Pau,10126,1067,557,510
2017,10,Sant Martí,73,la Verneda i la Pau,10127,1017,510,507
2017,10,Sant Martí,73,la Verneda i la Pau,10128,1578,845,733
2017,10,Sant Martí,73,la Verneda i la Pau,10129,1213,625,588
2017,10,Sant Martí,73,la Verneda i la Pau,10130,1182,636,546
2017,10,Sant Martí,73,la Verneda i la Pau,10131,1197,650,547
2017,10,Sant Martí,73,la Verneda i la Pau,10132,1270,678,592
2017,10,Sant Martí,73,la Verneda i la Pau,10133,1701,912,789
2017,10,Sant Martí,73,la Verneda i la Pau,10134,1523,837,686
2017,10,Sant Martí,73,la Verneda i la Pau,10135,1230,642,588
2017,10,Sant Martí,73,la Verneda i la Pau,10136,1368,702,666
2017,10,Sant Martí,73,la Verneda i la Pau,10137,1567,814,753
2017,10,Sant Martí,73,la Verneda i la Pau,10138,1541,800,741
2017,10,Sant Martí,73,la Verneda i la Pau,10139,1620,828,792
2017,10,Sant Martí,73,la Verneda i la Pau,10140,1573,838,735
2017,10,Sant Martí,73,la Verneda i la Pau,10141,1099,580,519
2017,10,Sant Martí,73,la Verneda i la Pau,10142,1612,850,762
2017,10,Sant Martí,73,la Verneda i la Pau,10143,1746,920,826
2018,1,Ciutat Vella,1,el Raval,1001,1281,583,698
2018,1,Ciutat Vella,1,el Raval,1002,1501,684,817
2018,1,Ciutat Vella,1,el Raval,1003,3496,1616,1880
2018,1,Ciutat Vella,1,el Raval,1004,2875,1313,1562
2018,1,Ciutat Vella,1,el Raval,1005,2460,1112,1348
2018,1,Ciutat Vella,1,el Raval,1006,1635,710,925
2018,1,Ciutat Vella,1,el Raval,1007,1982,790,1192
2018,1,Ciutat Vella,1,el Raval,1008,3306,1321,1985
2018,1,Ciutat Vella,1,el Raval,1009,2246,1003,1243
2018,1,Ciutat Vella,1,el Raval,1010,2439,1061,1378
2018,1,Ciutat Vella,1,el Raval,1011,3236,1416,1820
2018,1,Ciutat Vella,1,el Raval,1012,1908,947,961
2018,1,Ciutat Vella,1,el Raval,1013,1434,741,693
2018,1,Ciutat Vella,1,el Raval,1014,2049,936,1113
2018,1,Ciutat Vella,1,el Raval,1015,2376,1121,1255
2018,1,Ciutat Vella,1,el Raval,1016,2183,1055,1128
2018,1,Ciutat Vella,1,el Raval,1017,2518,1282,1236
2018,1,Ciutat Vella,1,el Raval,1018,1656,816,840
2018,1,Ciutat Vella,1,el Raval,1019,2845,1328,1517
2018,1,Ciutat Vella,1,el Raval,1020,2069,1092,977
2018,1,Ciutat Vella,1,el Raval,1021,2019,1016,1003
2018,1,Ciutat Vella,2,el Barri Gòtic,1022,1276,680,596
2018,1,Ciutat Vella,2,el Barri Gòtic,1023,1982,1002,980
2018,1,Ciutat Vella,2,el Barri Gòtic,1025,1247,631,616
2018,1,Ciutat Vella,2,el Barri Gòtic,1026,3677,1232,2445
2018,1,Ciutat Vella,2,el Barri Gòtic,1027,1629,811,818
2018,1,Ciutat Vella,2,el Barri Gòtic,1028,1812,931,881
2018,1,Ciutat Vella,2,el Barri Gòtic,1029,1386,691,695
2018,1,Ciutat Vella,2,el Barri Gòtic,1030,2482,1230,1252
2018,1,Ciutat Vella,2,el Barri Gòtic,1031,1544,694,850
2018,1,Ciutat Vella,3,la Barceloneta,1032,1794,901,893
2018,1,Ciutat Vella,3,la Barceloneta,1033,1127,532,595
2018,1,Ciutat Vella,3,la Barceloneta,1034,929,479,450
2018,1,Ciutat Vella,3,la Barceloneta,1035,1292,635,657
2018,1,Ciutat Vella,3,la Barceloneta,1036,1199,643,556
2018,1,Ciutat Vella,3,la Barceloneta,1037,1445,760,685
2018,1,Ciutat Vella,3,la Barceloneta,1038,1468,668,800
2018,1,Ciutat Vella,3,la Barceloneta,1039,1279,632,647
2018,1,Ciutat Vella,3,la Barceloneta,1040,1102,557,545
2018,1,Ciutat Vella,3,la Barceloneta,1041,1455,707,748
2018,1,Ciutat Vella,3,la Barceloneta,1042,1803,975,828
2018,1,Ciutat Vella,4,"Sant Pere, Santa Caterina i la Ribera",1043,1617,812,805
2018,1,Ciutat Vella,4,"Sant Pere, Santa Caterina i la Ribera",1044,1456,772,684
2018,1,Ciutat Vella,4,"Sant Pere, Santa Caterina i la Ribera",1045,1950,966,984
2018,1,Ciutat Vella,4,"Sant Pere, Santa Caterina i la Ribera",1046,1747,870,877
2018,1,Ciutat Vella,4,"Sant Pere, Santa Caterina i la Ribera",1047,1727,902,825
2018,1,Ciutat Vella,4,"Sant Pere, Santa Caterina i la Ribera",1048,2051,1037,1014
2018,1,Ciutat Vella,4,"Sant Pere, Santa Caterina i la Ribera",1049,1564,821,743
2018,1,Ciutat Vella,4,"Sant Pere, Santa Caterina i la Ribera",1050,1554,767,787
2018,1,Ciutat Vella,4,"Sant Pere, Santa Caterina i la Ribera",1051,1767,902,865
2018,1,Ciutat Vella,4,"Sant Pere, Santa Caterina i la Ribera",1052,2694,1190,1504
2018,1,Ciutat Vella,4,"Sant Pere, Santa Caterina i la Ribera",1053,1862,980,882
2018,1,Ciutat Vella,4,"Sant Pere, Santa Caterina i la Ribera",1054,1283,635,648
2018,1,Ciutat Vella,4,"Sant Pere, Santa Caterina i la Ribera",1055,1333,683,650
2018,2,Eixample,5,el Fort Pienc,2001,1315,689,626
2018,2,Eixample,5,el Fort Pienc,2002,2526,1215,1311
2018,2,Eixample,5,el Fort Pienc,2003,1263,702,561
2018,2,Eixample,5,el Fort Pienc,2004,1488,755,733
2018,2,Eixample,5,el Fort Pienc,2005,2037,1108,929
2018,2,Eixample,5,el Fort Pienc,2006,1661,865,796
2018,2,Eixample,5,el Fort Pienc,2007,1281,728,553
2018,2,Eixample,5,el Fort Pienc,2008,1925,1047,878
2018,2,Eixample,5,el Fort Pienc,2009,1771,957,814
2018,2,Eixample,5,el Fort Pienc,2010,1194,643,551
2018,2,Eixample,5,el Fort Pienc,2011,1093,558,535
2018,2,Eixample,5,el Fort Pienc,2012,1551,800,751
2018,2,Eixample,5,el Fort Pienc,2013,1151,583,568
2018,2,Eixample,5,el Fort Pienc,2014,1359,684,675
2018,2,Eixample,5,el Fort Pienc,2015,1573,807,766
2018,2,Eixample,5,el Fort Pienc,2016,1872,1029,843
2018,2,Eixample,5,el Fort Pienc,2017,1977,1061,916
2018,2,Eixample,5,el Fort Pienc,2018,1861,988,873
2018,2,Eixample,5,el Fort Pienc,2019,1866,988,878
2018,2,Eixample,5,el Fort Pienc,2020,1406,759,647
2018,2,Eixample,6,la Sagrada Família,2021,1497,814,683
2018,2,Eixample,6,la Sagrada Família,2022,1293,665,628
2018,2,Eixample,6,la Sagrada Família,2023,1103,602,501
2018,2,Eixample,6,la Sagrada Família,2024,1089,613,476
2018,2,Eixample,6,la Sagrada Família,2025,1168,617,551
2018,2,Eixample,6,la Sagrada Família,2026,2165,1165,1000
2018,2,Eixample,6,la Sagrada Família,2027,1949,1083,866
2018,2,Eixample,6,la Sagrada Família,2028,2050,1105,945
2018,2,Eixample,6,la Sagrada Família,2029,1275,691,584
2018,2,Eixample,6,la Sagrada Família,2030,1310,697,613
2018,2,Eixample,6,la Sagrada Família,2031,1072,568,504
2018,2,Eixample,6,la Sagrada Família,2032,1212,710,502
2018,2,Eixample,6,la Sagrada Família,2033,1179,652,527
2018,2,Eixample,6,la Sagrada Família,2034,1233,676,557
2018,2,Eixample,6,la Sagrada Família,2035,1325,701,624
2018,2,Eixample,6,la Sagrada Família,2036,1222,681,541
2018,2,Eixample,6,la Sagrada Família,2037,1229,642,587
2018,2,Eixample,6,la Sagrada Família,2038,1584,845,739
2018,2,Eixample,6,la Sagrada Família,2039,1749,983,766
2018,2,Eixample,6,la Sagrada Família,2040,1655,878,777
2018,2,Eixample,6,la Sagrada Família,2041,1658,904,754
2018,2,Eixample,6,la Sagrada Família,2042,1630,889,741
2018,2,Eixample,6,la Sagrada Família,2043,1457,781,676
2018,2,Eixample,6,la Sagrada Família,2044,1221,687,534
2018,2,Eixample,6,la Sagrada Família,2045,1160,624,536
2018,2,Eixample,6,la Sagrada Família,2046,1905,1029,876
2018,2,Eixample,6,la Sagrada Família,2047,1914,1028,886
2018,2,Eixample,6,la Sagrada Família,2048,1277,712,565
2018,2,Eixample,6,la Sagrada Família,2049,2119,1164,955
2018,2,Eixample,6,la Sagrada Família,2050,1613,891,722
2018,2,Eixample,6,la Sagrada Família,2051,1832,967,865
2018,2,Eixample,6,la Sagrada Família,2052,1787,969,818
2018,2,Eixample,6,la Sagrada Família,2053,1855,1013,842
2018,2,Eixample,6,la Sagrada Família,2054,1874,1014,860
2018,2,Eixample,7,la Dreta de l'Eixample,2055,1843,975,868
2018,2,Eixample,7,la Dreta de l'Eixample,2056,1457,817,640
2018,2,Eixample,7,la Dreta de l'Eixample,2057,1306,697,609
2018,2,Eixample,7,la Dreta de l'Eixample,2058,1388,756,632
2018,2,Eixample,7,la Dreta de l'Eixample,2059,1637,922,715
2018,2,Eixample,7,la Dreta de l'Eixample,2060,1671,916,755
2018,2,Eixample,7,la Dreta de l'Eixample,2061,1372,768,604
2018,2,Eixample,7,la Dreta de l'Eixample,2062,1529,803,726
2018,2,Eixample,7,la Dreta de l'Eixample,2063,1217,738,479
2018,2,Eixample,7,la Dreta de l'Eixample,2064,1348,711,637
2018,2,Eixample,7,la Dreta de l'Eixample,2065,1891,1001,890
2018,2,Eixample,7,la Dreta de l'Eixample,2066,1798,952,846
2018,2,Eixample,7,la Dreta de l'Eixample,2067,1676,888,788
2018,2,Eixample,7,la Dreta de l'Eixample,2068,1647,879,768
2018,2,Eixample,7,la Dreta de l'Eixample,2069,1369,730,639
2018,2,Eixample,7,la Dreta de l'Eixample,2070,1323,705,618
2018,2,Eixample,7,la Dreta de l'Eixample,2071,1709,890,819
2018,2,Eixample,7,la Dreta de l'Eixample,2072,1236,622,614
2018,2,Eixample,7,la Dreta de l'Eixample,2073,1686,900,786
2018,2,Eixample,7,la Dreta de l'Eixample,2074,1261,634,627
2018,2,Eixample,7,la Dreta de l'Eixample,2075,1238,642,596
2018,2,Eixample,7,la Dreta de l'Eixample,2076,1688,874,814
2018,2,Eixample,7,la Dreta de l'Eixample,2077,1539,755,784
2018,2,Eixample,7,la Dreta de l'Eixample,2078,1400,761,639
2018,2,Eixample,7,la Dreta de l'Eixample,2079,1308,693,615
2018,2,Eixample,7,la Dreta de l'Eixample,2080,1450,751,699
2018,2,Eixample,7,la Dreta de l'Eixample,2081,2130,1147,983
2018,2,Eixample,7,la Dreta de l'Eixample,2082,917,502,415
2018,2,Eixample,7,la Dreta de l'Eixample,2083,1819,988,831
2018,2,Eixample,8,l'Antiga Esquerra de l'Eixample,2084,2058,1148,910
2018,2,Eixample,8,l'Antiga Esquerra de l'Eixample,2085,1484,814,670
2018,2,Eixample,8,l'Antiga Esquerra de l'Eixample,2086,1442,793,649
2018,2,Eixample,8,l'Antiga Esquerra de l'Eixample,2087,1439,797,642
2018,2,Eixample,8,l'Antiga Esquerra de l'Eixample,2088,1646,900,746
2018,2,Eixample,8,l'Antiga Esquerra de l'Eixample,2089,1898,1010,888
2018,2,Eixample,8,l'Antiga Esquerra de l'Eixample,2090,1717,905,812
2018,2,Eixample,8,l'Antiga Esquerra de l'Eixample,2091,1885,958,927
2018,2,Eixample,8,l'Antiga Esquerra de l'Eixample,2092,2166,971,1195
2018,2,Eixample,8,l'Antiga Esquerra de l'Eixample,2093,1589,845,744
2018,2,Eixample,8,l'Antiga Esquerra de l'Eixample,2094,1425,751,674
2018,2,Eixample,8,l'Antiga Esquerra de l'Eixample,2095,1507,789,718
2018,2,Eixample,8,l'Antiga Esquerra de l'Eixample,2096,1429,753,676
2018,2,Eixample,8,l'Antiga Esquerra de l'Eixample,2097,1080,574,506
2018,2,Eixample,8,l'Antiga Esquerra de l'Eixample,2098,1515,846,669
2018,2,Eixample,8,l'Antiga Esquerra de l'Eixample,2099,1576,841,735
2018,2,Eixample,8,l'Antiga Esquerra de l'Eixample,2100,1388,747,641
2018,2,Eixample,8,l'Antiga Esquerra de l'Eixample,2101,2187,1187,1000
2018,2,Eixample,8,l'Antiga Esquerra de l'Eixample,2102,1398,772,626
2018,2,Eixample,8,l'Antiga Esquerra de l'Eixample,2103,1676,892,784
2018,2,Eixample,8,l'Antiga Esquerra de l'Eixample,2104,1158,642,516
2018,2,Eixample,8,l'Antiga Esquerra de l'Eixample,2105,2133,1162,971
2018,2,Eixample,8,l'Antiga Esquerra de l'Eixample,2106,1454,772,682
2018,2,Eixample,8,l'Antiga Esquerra de l'Eixample,2107,1615,888,727
2018,2,Eixample,8,l'Antiga Esquerra de l'Eixample,2108,1614,898,716
2018,2,Eixample,8,l'Antiga Esquerra de l'Eixample,2109,2055,1125,930
2018,2,Eixample,9,la Nova Esquerra de l'Eixample,2110,1912,1006,906
2018,2,Eixample,9,la Nova Esquerra de l'Eixample,2111,1805,997,808
2018,2,Eixample,9,la Nova Esquerra de l'Eixample,2112,1323,725,598
2018,2,Eixample,9,la Nova Esquerra de l'Eixample,2113,2259,1209,1050
2018,2,Eixample,9,la Nova Esquerra de l'Eixample,2114,1679,938,741
2018,2,Eixample,9,la Nova Esquerra de l'Eixample,2115,1360,748,612
2018,2,Eixample,9,la Nova Esquerra de l'Eixample,2116,1033,557,476
2018,2,Eixample,9,la Nova Esquerra de l'Eixample,2117,1208,661,547
2018,2,Eixample,9,la Nova Esquerra de l'Eixample,2118,1499,813,686
2018,2,Eixample,9,la Nova Esquerra de l'Eixample,2119,1278,690,588
2018,2,Eixample,9,la Nova Esquerra de l'Eixample,2120,1192,619,573
2018,2,Eixample,9,la Nova Esquerra de l'Eixample,2121,1258,676,582
2018,2,Eixample,9,la Nova Esquerra de l'Eixample,2122,1065,588,477
2018,2,Eixample,9,la Nova Esquerra de l'Eixample,2123,1145,591,554
2018,2,Eixample,9,la Nova Esquerra de l'Eixample,2124,1065,586,479
2018,2,Eixample,9,la Nova Esquerra de l'Eixample,2125,1692,946,746
2018,2,Eixample,9,la Nova Esquerra de l'Eixample,2126,1437,785,652
2018,2,Eixample,9,la Nova Esquerra de l'Eixample,2127,1159,623,536
2018,2,Eixample,9,la Nova Esquerra de l'Eixample,2128,1303,716,587
2018,2,Eixample,9,la Nova Esquerra de l'Eixample,2129,1538,836,702
2018,2,Eixample,9,la Nova Esquerra de l'Eixample,2130,1152,603,549
2018,2,Eixample,9,la Nova Esquerra de l'Eixample,2131,1212,646,566
2018,2,Eixample,9,la Nova Esquerra de l'Eixample,2132,1164,615,549
2018,2,Eixample,9,la Nova Esquerra de l'Eixample,2133,878,481,397
2018,2,Eixample,9,la Nova Esquerra de l'Eixample,2134,1421,758,663
2018,2,Eixample,9,la Nova Esquerra de l'Eixample,2135,2112,1125,987
2018,2,Eixample,9,la Nova Esquerra de l'Eixample,2136,913,496,417
2018,2,Eixample,9,la Nova Esquerra de l'Eixample,2137,1473,778,695
2018,2,Eixample,9,la Nova Esquerra de l'Eixample,2138,1969,1029,940
2018,2,Eixample,9,la Nova Esquerra de l'Eixample,2139,1625,875,750
2018,2,Eixample,9,la Nova Esquerra de l'Eixample,2140,1917,1033,884
2018,2,Eixample,9,la Nova Esquerra de l'Eixample,2141,1260,673,587
2018,2,Eixample,9,la Nova Esquerra de l'Eixample,2142,1971,1037,934
2018,2,Eixample,9,la Nova Esquerra de l'Eixample,2143,1340,660,680
2018,2,Eixample,9,la Nova Esquerra de l'Eixample,2144,1572,834,738
2018,2,Eixample,9,la Nova Esquerra de l'Eixample,2145,1297,667,630
2018,2,Eixample,9,la Nova Esquerra de l'Eixample,2146,1164,628,536
2018,2,Eixample,9,la Nova Esquerra de l'Eixample,2147,2172,1152,1020
2018,2,Eixample,9,la Nova Esquerra de l'Eixample,2148,1608,866,742
2018,2,Eixample,9,la Nova Esquerra de l'Eixample,2149,1835,973,862
2018,2,Eixample,10,Sant Antoni,2150,1481,761,720
2018,2,Eixample,10,Sant Antoni,2151,1466,769,697
2018,2,Eixample,10,Sant Antoni,2152,1224,664,560
2018,2,Eixample,10,Sant Antoni,2153,1343,724,619
2018,2,Eixample,10,Sant Antoni,2154,1058,553,505
2018,2,Eixample,10,Sant Antoni,2155,1887,1019,868
2018,2,Eixample,10,Sant Antoni,2156,1314,687,627
2018,2,Eixample,10,Sant Antoni,2157,1235,670,565
2018,2,Eixample,10,Sant Antoni,2158,1665,876,789
2018,2,Eixample,10,Sant Antoni,2159,1890,975,915
2018,2,Eixample,10,Sant Antoni,2160,1994,1033,961
2018,2,Eixample,10,Sant Antoni,2161,1113,576,537
2018,2,Eixample,10,Sant Antoni,2162,1386,727,659
2018,2,Eixample,10,Sant Antoni,2163,1824,971,853
2018,2,Eixample,10,Sant Antoni,2164,1467,783,684
2018,2,Eixample,10,Sant Antoni,2165,1682,880,802
2018,2,Eixample,10,Sant Antoni,2166,2112,1098,1014
2018,2,Eixample,10,Sant Antoni,2167,2096,1079,1017
2018,2,Eixample,10,Sant Antoni,2168,2191,1155,1036
2018,2,Eixample,10,Sant Antoni,2169,1571,788,783
2018,2,Eixample,10,Sant Antoni,2170,1542,805,737
2018,2,Eixample,10,Sant Antoni,2171,1677,874,803
2018,2,Eixample,10,Sant Antoni,2172,1583,832,751
2018,2,Eixample,10,Sant Antoni,2173,1555,818,737
2018,3,Sants-Montjuïc,11,el Poble-sec,3001,1663,902,761
2018,3,Sants-Montjuïc,11,el Poble-sec,3002,1979,1019,960
2018,3,Sants-Montjuïc,11,el Poble-sec,3003,1735,906,829
2018,3,Sants-Montjuïc,11,el Poble-sec,3004,1580,829,751
2018,3,Sants-Montjuïc,11,el Poble-sec,3005,1258,646,612
2018,3,Sants-Montjuïc,11,el Poble-sec,3006,1401,677,724
2018,3,Sants-Montjuïc,11,el Poble-sec,3007,1737,892,845
2018,3,Sants-Montjuïc,11,el Poble-sec,3008,1179,624,555
2018,3,Sants-Montjuïc,11,el Poble-sec,3009,1143,606,537
2018,3,Sants-Montjuïc,11,el Poble-sec,3010,1916,932,984
2018,3,Sants-Montjuïc,11,el Poble-sec,3011,1777,903,874
2018,3,Sants-Montjuïc,11,el Poble-sec,3012,2108,1084,1024
2018,3,Sants-Montjuïc,11,el Poble-sec,3013,1822,893,929
2018,3,Sants-Montjuïc,11,el Poble-sec,3014,1828,908,920
2018,3,Sants-Montjuïc,11,el Poble-sec,3015,2898,1472,1426
2018,3,Sants-Montjuïc,11,el Poble-sec,3016,1201,623,578
2018,3,Sants-Montjuïc,11,el Poble-sec,3017,1653,803,850
2018,3,Sants-Montjuïc,11,el Poble-sec,3018,1728,868,860
2018,3,Sants-Montjuïc,11,el Poble-sec,3019,1516,827,689
2018,3,Sants-Montjuïc,11,el Poble-sec,3020,1157,567,590
2018,3,Sants-Montjuïc,11,el Poble-sec,3021,1136,603,533
2018,3,Sants-Montjuïc,11,el Poble-sec,3022,1447,727,720
2018,3,Sants-Montjuïc,11,el Poble-sec,3023,1926,980,946
2018,3,Sants-Montjuïc,11,el Poble-sec,3024,2013,1020,993
2018,3,Sants-Montjuïc,12,la Marina del Prat Vermell,3025,1161,561,600
2018,3,Sants-Montjuïc,13,la Marina de Port,3026,970,506,464
2018,3,Sants-Montjuïc,13,la Marina de Port,3027,1782,934,848
2018,3,Sants-Montjuïc,13,la Marina de Port,3028,2568,1339,1229
2018,3,Sants-Montjuïc,13,la Marina de Port,3029,1291,671,620
2018,3,Sants-Montjuïc,13,la Marina de Port,3030,1581,856,725
2018,3,Sants-Montjuïc,13,la Marina de Port,3031,2438,1266,1172
2018,3,Sants-Montjuïc,13,la Marina de Port,3032,1646,841,805
2018,3,Sants-Montjuïc,13,la Marina de Port,3033,1423,711,712
2018,3,Sants-Montjuïc,13,la Marina de Port,3034,1506,770,736
2018,3,Sants-Montjuïc,13,la Marina de Port,3035,2302,1226,1076
2018,3,Sants-Montjuïc,13,la Marina de Port,3036,2371,1236,1135
2018,3,Sants-Montjuïc,13,la Marina de Port,3037,1069,556,513
2018,3,Sants-Montjuïc,13,la Marina de Port,3038,991,537,454
2018,3,Sants-Montjuïc,13,la Marina de Port,3039,2485,1273,1212
2018,3,Sants-Montjuïc,13,la Marina de Port,3211,1504,769,735
2018,3,Sants-Montjuïc,13,la Marina de Port,3212,2454,1291,1163
2018,3,Sants-Montjuïc,13,la Marina de Port,3213,2370,1245,1125
2018,3,Sants-Montjuïc,14,la Font de la Guatlla,3040,1526,815,711
2018,3,Sants-Montjuïc,14,la Font de la Guatlla,3041,1364,717,647
2018,3,Sants-Montjuïc,14,la Font de la Guatlla,3042,1356,700,656
2018,3,Sants-Montjuïc,14,la Font de la Guatlla,3043,1669,898,771
2018,3,Sants-Montjuïc,14,la Font de la Guatlla,3044,1930,1001,929
2018,3,Sants-Montjuïc,14,la Font de la Guatlla,3045,1078,549,529
2018,3,Sants-Montjuïc,14,la Font de la Guatlla,3046,1384,750,634
2018,3,Sants-Montjuïc,15,Hostafrancs,3047,1785,931,854
2018,3,Sants-Montjuïc,15,Hostafrancs,3048,1345,710,635
2018,3,Sants-Montjuïc,15,Hostafrancs,3049,1643,864,779
2018,3,Sants-Montjuïc,15,Hostafrancs,3050,1638,847,791
2018,3,Sants-Montjuïc,15,Hostafrancs,3051,1847,943,904
2018,3,Sants-Montjuïc,15,Hostafrancs,3052,1274,662,612
2018,3,Sants-Montjuïc,15,Hostafrancs,3053,2210,1153,1057
2018,3,Sants-Montjuïc,15,Hostafrancs,3054,1772,907,865
2018,3,Sants-Montjuïc,15,Hostafrancs,3055,1576,818,758
2018,3,Sants-Montjuïc,15,Hostafrancs,3056,879,492,387
2018,3,Sants-Montjuïc,16,la Bordeta,3057,1529,817,712
2018,3,Sants-Montjuïc,16,la Bordeta,3058,1406,796,610
2018,3,Sants-Montjuïc,16,la Bordeta,3059,1234,640,594
2018,3,Sants-Montjuïc,16,la Bordeta,3060,1388,700,688
2018,3,Sants-Montjuïc,16,la Bordeta,3061,1084,583,501
2018,3,Sants-Montjuïc,16,la Bordeta,3062,1612,865,747
2018,3,Sants-Montjuïc,16,la Bordeta,3063,1630,840,790
2018,3,Sants-Montjuïc,16,la Bordeta,3064,1243,664,579
2018,3,Sants-Montjuïc,16,la Bordeta,3065,1376,711,665
2018,3,Sants-Montjuïc,16,la Bordeta,3066,2273,1187,1086
2018,3,Sants-Montjuïc,16,la Bordeta,3067,1720,903,817
2018,3,Sants-Montjuïc,16,la Bordeta,3068,1158,613,545
2018,3,Sants-Montjuïc,16,la Bordeta,3069,1180,615,565
2018,3,Sants-Montjuïc,17,Sants - Badal,3070,1242,637,605
2018,3,Sants-Montjuïc,17,Sants - Badal,3071,1281,672,609
2018,3,Sants-Montjuïc,17,Sants - Badal,3072,1382,729,653
2018,3,Sants-Montjuïc,17,Sants - Badal,3073,1623,850,773
2018,3,Sants-Montjuïc,17,Sants - Badal,3074,1778,950,828
2018,3,Sants-Montjuïc,17,Sants - Badal,3075,1675,890,785
2018,3,Sants-Montjuïc,17,Sants - Badal,3076,1002,527,475
2018,3,Sants-Montjuïc,17,Sants - Badal,3077,1269,691,578
2018,3,Sants-Montjuïc,17,Sants - Badal,3078,1707,901,806
2018,3,Sants-Montjuïc,17,Sants - Badal,3079,1751,910,841
2018,3,Sants-Montjuïc,17,Sants - Badal,3080,1547,853,694
2018,3,Sants-Montjuïc,17,Sants - Badal,3081,1818,992,826
2018,3,Sants-Montjuïc,17,Sants - Badal,3082,1893,1014,879
2018,3,Sants-Montjuïc,17,Sants - Badal,3083,1350,728,622
2018,3,Sants-Montjuïc,17,Sants - Badal,3084,1437,774,663
2018,3,Sants-Montjuïc,17,Sants - Badal,3085,1263,687,576
2018,3,Sants-Montjuïc,18,Sants,3086,1239,648,591
2018,3,Sants-Montjuïc,18,Sants,3087,1483,811,672
2018,3,Sants-Montjuïc,18,Sants,3088,1375,743,632
2018,3,Sants-Montjuïc,18,Sants,3089,1243,686,557
2018,3,Sants-Montjuïc,18,Sants,3090,1054,560,494
2018,3,Sants-Montjuïc,18,Sants,3091,1417,735,682
2018,3,Sants-Montjuïc,18,Sants,3092,1200,617,583
2018,3,Sants-Montjuïc,18,Sants,3093,1513,807,706
2018,3,Sants-Montjuïc,18,Sants,3094,1185,632,553
2018,3,Sants-Montjuïc,18,Sants,3095,1615,868,747
2018,3,Sants-Montjuïc,18,Sants,3096,1572,826,746
2018,3,Sants-Montjuïc,18,Sants,3097,1599,839,760
2018,3,Sants-Montjuïc,18,Sants,3098,1364,720,644
2018,3,Sants-Montjuïc,18,Sants,3099,959,523,436
2018,3,Sants-Montjuïc,18,Sants,3100,1242,665,577
2018,3,Sants-Montjuïc,18,Sants,3101,2355,1099,1256
2018,3,Sants-Montjuïc,18,Sants,3102,1350,714,636
2018,3,Sants-Montjuïc,18,Sants,3103,1180,629,551
2018,3,Sants-Montjuïc,18,Sants,3104,1455,779,676
2018,3,Sants-Montjuïc,18,Sants,3105,1157,625,532
2018,3,Sants-Montjuïc,18,Sants,3106,1267,685,582
2018,3,Sants-Montjuïc,18,Sants,3107,1578,803,775
2018,3,Sants-Montjuïc,18,Sants,3108,1574,856,718
2018,3,Sants-Montjuïc,18,Sants,3109,1594,862,732
2018,3,Sants-Montjuïc,18,Sants,3110,1490,789,701
2018,3,Sants-Montjuïc,18,Sants,3111,1282,689,593
2018,3,Sants-Montjuïc,18,Sants,3112,1901,1021,880
2018,3,Sants-Montjuïc,18,Sants,3113,1641,866,775
2018,3,Sants-Montjuïc,18,Sants,3114,1486,795,691
2018,4,Les Corts,19,les Corts,4001,1265,684,581
2018,4,Les Corts,19,les Corts,4002,1956,1029,927
2018,4,Les Corts,19,les Corts,4003,1077,551,526
2018,4,Les Corts,19,les Corts,4004,988,540,448
2018,4,Les Corts,19,les Corts,4005,1221,660,561
2018,4,Les Corts,19,les Corts,4006,1134,608,526
2018,4,Les Corts,19,les Corts,4007,1094,612,482
2018,4,Les Corts,19,les Corts,4008,996,526,470
2018,4,Les Corts,19,les Corts,4009,1423,785,638
2018,4,Les Corts,19,les Corts,4010,891,489,402
2018,4,Les Corts,19,les Corts,4011,1765,935,830
2018,4,Les Corts,19,les Corts,4012,1393,751,642
2018,4,Les Corts,19,les Corts,4013,1263,683,580
2018,4,Les Corts,19,les Corts,4014,865,469,396
2018,4,Les Corts,19,les Corts,4015,1895,1050,845
2018,4,Les Corts,19,les Corts,4016,1101,583,518
2018,4,Les Corts,19,les Corts,4017,1155,626,529
2018,4,Les Corts,19,les Corts,4018,1551,864,687
2018,4,Les Corts,19,les Corts,4019,1338,719,619
2018,4,Les Corts,19,les Corts,4020,1470,777,693
2018,4,Les Corts,19,les Corts,4021,1322,722,600
2018,4,Les Corts,19,les Corts,4022,1605,837,768
2018,4,Les Corts,19,les Corts,4023,1084,581,503
2018,4,Les Corts,19,les Corts,4024,1068,567,501
2018,4,Les Corts,19,les Corts,4025,1166,622,544
2018,4,Les Corts,19,les Corts,4026,1243,687,556
2018,4,Les Corts,19,les Corts,4027,1248,665,583
2018,4,Les Corts,19,les Corts,4028,1310,705,605
2018,4,Les Corts,19,les Corts,4029,1139,612,527
2018,4,Les Corts,19,les Corts,4030,1781,966,815
2018,4,Les Corts,19,les Corts,4031,1750,869,881
2018,4,Les Corts,19,les Corts,4032,1537,855,682
2018,4,Les Corts,19,les Corts,4033,1164,630,534
2018,4,Les Corts,19,les Corts,4034,1497,780,717
2018,4,Les Corts,19,les Corts,4035,1397,756,641
2018,4,Les Corts,20,la Maternitat i Sant Ramon,4036,1729,940,789
2018,4,Les Corts,20,la Maternitat i Sant Ramon,4037,2155,1171,984
2018,4,Les Corts,20,la Maternitat i Sant Ramon,4038,1273,689,584
2018,4,Les Corts,20,la Maternitat i Sant Ramon,4039,1209,639,570
2018,4,Les Corts,20,la Maternitat i Sant Ramon,4040,1576,843,733
2018,4,Les Corts,20,la Maternitat i Sant Ramon,4041,1332,708,624
2018,4,Les Corts,20,la Maternitat i Sant Ramon,4042,1737,921,816
2018,4,Les Corts,20,la Maternitat i Sant Ramon,4043,1647,912,735
2018,4,Les Corts,20,la Maternitat i Sant Ramon,4044,1605,852,753
2018,4,Les Corts,20,la Maternitat i Sant Ramon,4045,1403,756,647
2018,4,Les Corts,20,la Maternitat i Sant Ramon,4046,2458,1263,1195
2018,4,Les Corts,20,la Maternitat i Sant Ramon,4047,1778,943,835
2018,4,Les Corts,20,la Maternitat i Sant Ramon,4048,1523,833,690
2018,4,Les Corts,20,la Maternitat i Sant Ramon,4049,1185,637,548
2018,4,Les Corts,20,la Maternitat i Sant Ramon,4084,1374,747,627
2018,4,Les Corts,21,Pedralbes,4050,2090,1112,978
2018,4,Les Corts,21,Pedralbes,4051,1640,900,740
2018,4,Les Corts,21,Pedralbes,4052,2222,1220,1002
2018,4,Les Corts,21,Pedralbes,4053,1674,876,798
2018,4,Les Corts,21,Pedralbes,4054,1045,556,489
2018,4,Les Corts,21,Pedralbes,4055,1576,811,765
2018,4,Les Corts,21,Pedralbes,4056,1799,929,870
2018,5,Sarrià-Sant Gervasi,22,"Vallvidrera, el Tibidabo i les Planes",5001,1731,851,880
2018,5,Sarrià-Sant Gervasi,22,"Vallvidrera, el Tibidabo i les Planes",5002,1572,820,752
2018,5,Sarrià-Sant Gervasi,22,"Vallvidrera, el Tibidabo i les Planes",5003,1407,711,696
2018,5,Sarrià-Sant Gervasi,23,Sarrià,5004,1123,640,483
2018,5,Sarrià-Sant Gervasi,23,Sarrià,5005,1227,637,590
2018,5,Sarrià-Sant Gervasi,23,Sarrià,5006,1752,881,871
2018,5,Sarrià-Sant Gervasi,23,Sarrià,5007,1732,860,872
2018,5,Sarrià-Sant Gervasi,23,Sarrià,5008,1644,875,769
2018,5,Sarrià-Sant Gervasi,23,Sarrià,5009,1723,937,786
2018,5,Sarrià-Sant Gervasi,23,Sarrià,5010,1602,867,735
2018,5,Sarrià-Sant Gervasi,23,Sarrià,5011,1405,744,661
2018,5,Sarrià-Sant Gervasi,23,Sarrià,5012,1369,751,618
2018,5,Sarrià-Sant Gervasi,23,Sarrià,5013,1686,881,805
2018,5,Sarrià-Sant Gervasi,23,Sarrià,5014,1715,910,805
2018,5,Sarrià-Sant Gervasi,23,Sarrià,5015,1632,892,740
2018,5,Sarrià-Sant Gervasi,23,Sarrià,5016,1912,1051,861
2018,5,Sarrià-Sant Gervasi,23,Sarrià,5017,1596,846,750
2018,5,Sarrià-Sant Gervasi,23,Sarrià,5018,1260,687,573
2018,5,Sarrià-Sant Gervasi,23,Sarrià,5019,1738,930,808
2018,5,Sarrià-Sant Gervasi,24,les Tres Torres,5020,1130,619,511
2018,5,Sarrià-Sant Gervasi,24,les Tres Torres,5021,1394,769,625
2018,5,Sarrià-Sant Gervasi,24,les Tres Torres,5022,1783,1006,777
2018,5,Sarrià-Sant Gervasi,24,les Tres Torres,5023,1483,822,661
2018,5,Sarrià-Sant Gervasi,24,les Tres Torres,5024,1913,1020,893
2018,5,Sarrià-Sant Gervasi,24,les Tres Torres,5025,1347,711,636
2018,5,Sarrià-Sant Gervasi,24,les Tres Torres,5026,1477,760,717
2018,5,Sarrià-Sant Gervasi,24,les Tres Torres,5027,1434,743,691
2018,5,Sarrià-Sant Gervasi,24,les Tres Torres,5028,1642,822,820
2018,5,Sarrià-Sant Gervasi,24,les Tres Torres,5029,1686,882,804
2018,5,Sarrià-Sant Gervasi,24,les Tres Torres,5030,1424,765,659
2018,5,Sarrià-Sant Gervasi,25,Sant Gervasi - la Bonanova,5031,1668,893,775
2018,5,Sarrià-Sant Gervasi,25,Sant Gervasi - la Bonanova,5032,1827,994,833
2018,5,Sarrià-Sant Gervasi,25,Sant Gervasi - la Bonanova,5033,1367,735,632
2018,5,Sarrià-Sant Gervasi,25,Sant Gervasi - la Bonanova,5034,1248,670,578
2018,5,Sarrià-Sant Gervasi,25,Sant Gervasi - la Bonanova,5035,1089,563,526
2018,5,Sarrià-Sant Gervasi,25,Sant Gervasi - la Bonanova,5036,1761,919,842
2018,5,Sarrià-Sant Gervasi,25,Sant Gervasi - la Bonanova,5037,1409,808,601
2018,5,Sarrià-Sant Gervasi,25,Sant Gervasi - la Bonanova,5038,1312,721,591
2018,5,Sarrià-Sant Gervasi,25,Sant Gervasi - la Bonanova,5039,1551,837,714
2018,5,Sarrià-Sant Gervasi,25,Sant Gervasi - la Bonanova,5040,1440,797,643
2018,5,Sarrià-Sant Gervasi,25,Sant Gervasi - la Bonanova,5041,1862,964,898
2018,5,Sarrià-Sant Gervasi,25,Sant Gervasi - la Bonanova,5042,1277,664,613
2018,5,Sarrià-Sant Gervasi,25,Sant Gervasi - la Bonanova,5043,1482,818,664
2018,5,Sarrià-Sant Gervasi,25,Sant Gervasi - la Bonanova,5044,1327,737,590
2018,5,Sarrià-Sant Gervasi,25,Sant Gervasi - la Bonanova,5045,1566,856,710
2018,5,Sarrià-Sant Gervasi,25,Sant Gervasi - la Bonanova,5046,1153,665,488
2018,5,Sarrià-Sant Gervasi,25,Sant Gervasi - la Bonanova,5047,1255,695,560
2018,5,Sarrià-Sant Gervasi,25,Sant Gervasi - la Bonanova,5048,1295,707,588
2018,5,Sarrià-Sant Gervasi,26,Sant Gervasi - Galvany,5049,1683,929,754
2018,5,Sarrià-Sant Gervasi,26,Sant Gervasi - Galvany,5050,1653,897,756
2018,5,Sarrià-Sant Gervasi,26,Sant Gervasi - Galvany,5051,1589,856,733
2018,5,Sarrià-Sant Gervasi,26,Sant Gervasi - Galvany,5052,1507,834,673
2018,5,Sarrià-Sant Gervasi,26,Sant Gervasi - Galvany,5053,1509,801,708
2018,5,Sarrià-Sant Gervasi,26,Sant Gervasi - Galvany,5054,1032,581,451
2018,5,Sarrià-Sant Gervasi,26,Sant Gervasi - Galvany,5055,1475,804,671
2018,5,Sarrià-Sant Gervasi,26,Sant Gervasi - Galvany,5056,1238,725,513
2018,5,Sarrià-Sant Gervasi,26,Sant Gervasi - Galvany,5057,1689,906,783
2018,5,Sarrià-Sant Gervasi,26,Sant Gervasi - Galvany,5058,1580,850,730
2018,5,Sarrià-Sant Gervasi,26,Sant Gervasi - Galvany,5059,1667,940,727
2018,5,Sarrià-Sant Gervasi,26,Sant Gervasi - Galvany,5060,1159,637,522
2018,5,Sarrià-Sant Gervasi,26,Sant Gervasi - Galvany,5061,1479,831,648
2018,5,Sarrià-Sant Gervasi,26,Sant Gervasi - Galvany,5062,1568,894,674
2018,5,Sarrià-Sant Gervasi,26,Sant Gervasi - Galvany,5063,1587,861,726
2018,5,Sarrià-Sant Gervasi,26,Sant Gervasi - Galvany,5064,1607,898,709
2018,5,Sarrià-Sant Gervasi,26,Sant Gervasi - Galvany,5065,1696,927,769
2018,5,Sarrià-Sant Gervasi,26,Sant Gervasi - Galvany,5066,1255,701,554
2018,5,Sarrià-Sant Gervasi,26,Sant Gervasi - Galvany,5067,1318,721,597
2018,5,Sarrià-Sant Gervasi,26,Sant Gervasi - Galvany,5068,1537,819,718
2018,5,Sarrià-Sant Gervasi,26,Sant Gervasi - Galvany,5069,1758,952,806
2018,5,Sarrià-Sant Gervasi,26,Sant Gervasi - Galvany,5070,1455,814,641
2018,5,Sarrià-Sant Gervasi,26,Sant Gervasi - Galvany,5071,1622,922,700
2018,5,Sarrià-Sant Gervasi,26,Sant Gervasi - Galvany,5072,1733,964,769
2018,5,Sarrià-Sant Gervasi,26,Sant Gervasi - Galvany,5073,1615,898,717
2018,5,Sarrià-Sant Gervasi,26,Sant Gervasi - Galvany,5074,1722,931,791
2018,5,Sarrià-Sant Gervasi,26,Sant Gervasi - Galvany,5075,1795,1007,788
2018,5,Sarrià-Sant Gervasi,26,Sant Gervasi - Galvany,5076,1387,753,634
2018,5,Sarrià-Sant Gervasi,26,Sant Gervasi - Galvany,5077,1516,834,682
2018,5,Sarrià-Sant Gervasi,26,Sant Gervasi - Galvany,5078,2114,1124,990
2018,5,Sarrià-Sant Gervasi,26,Sant Gervasi - Galvany,5079,1274,702,572
2018,5,Sarrià-Sant Gervasi,27,el Putget i Farró,5080,1344,751,593
2018,5,Sarrià-Sant Gervasi,27,el Putget i Farró,5081,1607,882,725
2018,5,Sarrià-Sant Gervasi,27,el Putget i Farró,5082,1674,908,766
2018,5,Sarrià-Sant Gervasi,27,el Putget i Farró,5083,1291,705,586
2018,5,Sarrià-Sant Gervasi,27,el Putget i Farró,5084,1317,732,585
2018,5,Sarrià-Sant Gervasi,27,el Putget i Farró,5085,1336,713,623
2018,5,Sarrià-Sant Gervasi,27,el Putget i Farró,5086,1309,698,611
2018,5,Sarrià-Sant Gervasi,27,el Putget i Farró,5087,1541,856,685
2018,5,Sarrià-Sant Gervasi,27,el Putget i Farró,5088,1764,927,837
2018,5,Sarrià-Sant Gervasi,27,el Putget i Farró,5089,1710,895,815
2018,5,Sarrià-Sant Gervasi,27,el Putget i Farró,5090,1885,1000,885
2018,5,Sarrià-Sant Gervasi,27,el Putget i Farró,5091,1549,860,689
2018,5,Sarrià-Sant Gervasi,27,el Putget i Farró,5092,1591,863,728
2018,5,Sarrià-Sant Gervasi,27,el Putget i Farró,5093,1153,655,498
2018,5,Sarrià-Sant Gervasi,27,el Putget i Farró,5094,2643,1467,1176
2018,5,Sarrià-Sant Gervasi,27,el Putget i Farró,5095,1630,920,710
2018,5,Sarrià-Sant Gervasi,27,el Putget i Farró,5096,1118,618,500
2018,5,Sarrià-Sant Gervasi,27,el Putget i Farró,5097,1596,851,745
2018,5,Sarrià-Sant Gervasi,27,el Putget i Farró,5098,1532,845,687
2018,6,Gràcia,28,Vallcarca i els Penitents,6001,1201,676,525
2018,6,Gràcia,28,Vallcarca i els Penitents,6002,1486,798,688
2018,6,Gràcia,28,Vallcarca i els Penitents,6003,2268,1175,1093
2018,6,Gràcia,28,Vallcarca i els Penitents,6004,1442,749,693
2018,6,Gràcia,28,Vallcarca i els Penitents,6006,1022,545,477
2018,6,Gràcia,28,Vallcarca i els Penitents,6007,1871,1006,865
2018,6,Gràcia,28,Vallcarca i els Penitents,6008,1997,1120,877
2018,6,Gràcia,28,Vallcarca i els Penitents,6009,1232,656,576
2018,6,Gràcia,28,Vallcarca i els Penitents,6010,1049,568,481
2018,6,Gràcia,28,Vallcarca i els Penitents,6011,1299,682,617
2018,6,Gràcia,28,Vallcarca i els Penitents,6012,1118,588,530
2018,6,Gràcia,29,el Coll,6013,1717,924,793
2018,6,Gràcia,29,el Coll,6014,1383,754,629
2018,6,Gràcia,29,el Coll,6015,1408,746,662
2018,6,Gràcia,29,el Coll,6016,1613,871,742
2018,6,Gràcia,29,el Coll,6017,1339,710,629
2018,6,Gràcia,30,la Salut,6018,1270,657,613
2018,6,Gràcia,30,la Salut,6019,1459,789,670
2018,6,Gràcia,30,la Salut,6020,1144,612,532
2018,6,Gràcia,30,la Salut,6021,1352,734,618
2018,6,Gràcia,30,la Salut,6022,1355,675,680
2018,6,Gràcia,30,la Salut,6023,1354,735,619
2018,6,Gràcia,30,la Salut,6024,1670,933,737
2018,6,Gràcia,30,la Salut,6025,1429,774,655
2018,6,Gràcia,30,la Salut,6026,1039,575,464
2018,6,Gràcia,30,la Salut,6027,1188,667,521
2018,6,Gràcia,31,Vila de Gràcia,6028,1313,679,634
2018,6,Gràcia,31,Vila de Gràcia,6029,1268,674,594
2018,6,Gràcia,31,Vila de Gràcia,6030,1340,724,616
2018,6,Gràcia,31,Vila de Gràcia,6031,1092,601,491
2018,6,Gràcia,31,Vila de Gràcia,6032,1173,636,537
2018,6,Gràcia,31,Vila de Gràcia,6033,1311,724,587
2018,6,Gràcia,31,Vila de Gràcia,6034,1236,689,547
2018,6,Gràcia,31,Vila de Gràcia,6035,1023,556,467
2018,6,Gràcia,31,Vila de Gràcia,6036,1446,819,627
2018,6,Gràcia,31,Vila de Gràcia,6037,1105,584,521
2018,6,Gràcia,31,Vila de Gràcia,6038,1465,850,615
2018,6,Gràcia,31,Vila de Gràcia,6039,1577,878,699
2018,6,Gràcia,31,Vila de Gràcia,6040,1646,948,698
2018,6,Gràcia,31,Vila de Gràcia,6041,1777,989,788
2018,6,Gràcia,31,Vila de Gràcia,6042,1760,952,808
2018,6,Gràcia,31,Vila de Gràcia,6043,1294,692,602
2018,6,Gràcia,31,Vila de Gràcia,6044,1507,798,709
2018,6,Gràcia,31,Vila de Gràcia,6045,1255,695,560
2018,6,Gràcia,31,Vila de Gràcia,6046,1155,613,542
2018,6,Gràcia,31,Vila de Gràcia,6047,1488,765,723
2018,6,Gràcia,31,Vila de Gràcia,6048,1351,716,635
2018,6,Gràcia,31,Vila de Gràcia,6049,1163,634,529
2018,6,Gràcia,31,Vila de Gràcia,6050,1241,673,568
2018,6,Gràcia,31,Vila de Gràcia,6051,1270,716,554
2018,6,Gràcia,31,Vila de Gràcia,6052,1540,850,690
2018,6,Gràcia,31,Vila de Gràcia,6053,1481,816,665
2018,6,Gràcia,31,Vila de Gràcia,6054,1603,838,765
2018,6,Gràcia,31,Vila de Gràcia,6055,1428,801,627
2018,6,Gràcia,31,Vila de Gràcia,6056,1551,827,724
2018,6,Gràcia,31,Vila de Gràcia,6057,1497,839,658
2018,6,Gràcia,31,Vila de Gràcia,6058,1636,917,719
2018,6,Gràcia,31,Vila de Gràcia,6059,1529,818,711
2018,6,Gràcia,31,Vila de Gràcia,6060,1754,941,813
2018,6,Gràcia,31,Vila de Gràcia,6061,1325,717,608
2018,6,Gràcia,31,Vila de Gràcia,6062,1288,696,592
2018,6,Gràcia,31,Vila de Gràcia,6063,1533,813,720
2018,6,Gràcia,32,el Camp d'en Grassot i Gràcia Nova,6064,1932,1062,870
2018,6,Gràcia,32,el Camp d'en Grassot i Gràcia Nova,6065,1199,653,546
2018,6,Gràcia,32,el Camp d'en Grassot i Gràcia Nova,6066,1026,576,450
2018,6,Gràcia,32,el Camp d'en Grassot i Gràcia Nova,6067,1771,976,795
2018,6,Gràcia,32,el Camp d'en Grassot i Gràcia Nova,6068,1536,852,684
2018,6,Gràcia,32,el Camp d'en Grassot i Gràcia Nova,6069,1085,584,501
2018,6,Gràcia,32,el Camp d'en Grassot i Gràcia Nova,6070,1851,1039,812
2018,6,Gràcia,32,el Camp d'en Grassot i Gràcia Nova,6071,1074,579,495
2018,6,Gràcia,32,el Camp d'en Grassot i Gràcia Nova,6072,1608,886,722
2018,6,Gràcia,32,el Camp d'en Grassot i Gràcia Nova,6073,1350,731,619
2018,6,Gràcia,32,el Camp d'en Grassot i Gràcia Nova,6074,1098,584,514
2018,6,Gràcia,32,el Camp d'en Grassot i Gràcia Nova,6075,1091,588,503
2018,6,Gràcia,32,el Camp d'en Grassot i Gràcia Nova,6076,1328,664,664
2018,6,Gràcia,32,el Camp d'en Grassot i Gràcia Nova,6077,1192,678,514
2018,6,Gràcia,32,el Camp d'en Grassot i Gràcia Nova,6078,1372,729,643
2018,6,Gràcia,32,el Camp d'en Grassot i Gràcia Nova,6079,1088,589,499
2018,6,Gràcia,32,el Camp d'en Grassot i Gràcia Nova,6080,1174,628,546
2018,6,Gràcia,32,el Camp d'en Grassot i Gràcia Nova,6081,1311,719,592
2018,6,Gràcia,32,el Camp d'en Grassot i Gràcia Nova,6082,2002,1087,915
2018,6,Gràcia,32,el Camp d'en Grassot i Gràcia Nova,6083,1743,908,835
2018,6,Gràcia,32,el Camp d'en Grassot i Gràcia Nova,6084,1496,806,690
2018,6,Gràcia,32,el Camp d'en Grassot i Gràcia Nova,6085,1240,685,555
2018,6,Gràcia,32,el Camp d'en Grassot i Gràcia Nova,6086,1016,530,486
2018,6,Gràcia,32,el Camp d'en Grassot i Gràcia Nova,6087,1857,1014,843
2018,6,Gràcia,32,el Camp d'en Grassot i Gràcia Nova,6088,1223,672,551
2018,7,Horta-Guinardó,33,el Baix Guinardó,7001,1572,878,694
2018,7,Horta-Guinardó,33,el Baix Guinardó,7002,1163,638,525
2018,7,Horta-Guinardó,33,el Baix Guinardó,7003,1310,703,607
2018,7,Horta-Guinardó,33,el Baix Guinardó,7004,1511,812,699
2018,7,Horta-Guinardó,33,el Baix Guinardó,7005,1476,774,702
2018,7,Horta-Guinardó,33,el Baix Guinardó,7006,947,504,443
2018,7,Horta-Guinardó,33,el Baix Guinardó,7007,1435,779,656
2018,7,Horta-Guinardó,33,el Baix Guinardó,7008,1450,778,672
2018,7,Horta-Guinardó,33,el Baix Guinardó,7009,1184,653,531
2018,7,Horta-Guinardó,33,el Baix Guinardó,7010,1327,694,633
2018,7,Horta-Guinardó,33,el Baix Guinardó,7011,1167,641,526
2018,7,Horta-Guinardó,33,el Baix Guinardó,7012,1575,849,726
2018,7,Horta-Guinardó,33,el Baix Guinardó,7013,1216,639,577
2018,7,Horta-Guinardó,33,el Baix Guinardó,7014,896,482,414
2018,7,Horta-Guinardó,33,el Baix Guinardó,7015,1386,733,653
2018,7,Horta-Guinardó,33,el Baix Guinardó,7016,1348,696,652
2018,7,Horta-Guinardó,33,el Baix Guinardó,7017,1716,948,768
2018,7,Horta-Guinardó,33,el Baix Guinardó,7018,1678,933,745
2018,7,Horta-Guinardó,33,el Baix Guinardó,7019,1436,771,665
2018,7,Horta-Guinardó,34,Can Baró,7020,1620,871,749
2018,7,Horta-Guinardó,34,Can Baró,7021,1038,540,498
2018,7,Horta-Guinardó,34,Can Baró,7022,1151,605,546
2018,7,Horta-Guinardó,34,Can Baró,7023,1292,665,627
2018,7,Horta-Guinardó,34,Can Baró,7024,1475,783,692
2018,7,Horta-Guinardó,34,Can Baró,7025,1420,755,665
2018,7,Horta-Guinardó,34,Can Baró,7026,1075,592,483
2018,7,Horta-Guinardó,35,el Guinardó,7027,2025,1082,943
2018,7,Horta-Guinardó,35,el Guinardó,7028,1485,771,714
2018,7,Horta-Guinardó,35,el Guinardó,7029,1292,664,628
2018,7,Horta-Guinardó,35,el Guinardó,7030,1395,766,629
2018,7,Horta-Guinardó,35,el Guinardó,7031,1567,810,757
2018,7,Horta-Guinardó,35,el Guinardó,7032,1392,701,691
2018,7,Horta-Guinardó,35,el Guinardó,7033,1442,785,657
2018,7,Horta-Guinardó,35,el Guinardó,7034,1786,936,850
2018,7,Horta-Guinardó,35,el Guinardó,7035,1775,972,803
2018,7,Horta-Guinardó,35,el Guinardó,7036,1389,763,626
2018,7,Horta-Guinardó,35,el Guinardó,7037,1483,815,668
2018,7,Horta-Guinardó,35,el Guinardó,7038,1304,692,612
2018,7,Horta-Guinardó,35,el Guinardó,7039,1595,832,763
2018,7,Horta-Guinardó,35,el Guinardó,7040,1504,819,685
2018,7,Horta-Guinardó,35,el Guinardó,7041,1410,771,639
2018,7,Horta-Guinardó,35,el Guinardó,7042,1560,851,709
2018,7,Horta-Guinardó,35,el Guinardó,7043,1383,746,637
2018,7,Horta-Guinardó,35,el Guinardó,7044,1285,674,611
2018,7,Horta-Guinardó,35,el Guinardó,7045,1521,798,723
2018,7,Horta-Guinardó,35,el Guinardó,7046,1401,741,660
2018,7,Horta-Guinardó,35,el Guinardó,7047,1497,786,711
2018,7,Horta-Guinardó,35,el Guinardó,7048,1272,701,571
2018,7,Horta-Guinardó,35,el Guinardó,7049,1205,619,586
2018,7,Horta-Guinardó,35,el Guinardó,7050,1183,629,554
2018,7,Horta-Guinardó,35,el Guinardó,7051,1739,949,790
2018,7,Horta-Guinardó,36,la Font d'en Fargues,7052,1233,654,579
2018,7,Horta-Guinardó,36,la Font d'en Fargues,7053,1455,772,683
2018,7,Horta-Guinardó,36,la Font d'en Fargues,7054,1555,831,724
2018,7,Horta-Guinardó,36,la Font d'en Fargues,7055,1192,632,560
2018,7,Horta-Guinardó,36,la Font d'en Fargues,7056,1185,611,574
2018,7,Horta-Guinardó,36,la Font d'en Fargues,7057,1451,768,683
2018,7,Horta-Guinardó,36,la Font d'en Fargues,7058,1375,701,674
2018,7,Horta-Guinardó,37,el Carmel,7059,1273,665,608
2018,7,Horta-Guinardó,37,el Carmel,7060,1840,943,897
2018,7,Horta-Guinardó,37,el Carmel,7061,1221,622,599
2018,7,Horta-Guinardó,37,el Carmel,7062,1290,666,624
2018,7,Horta-Guinardó,37,el Carmel,7063,1442,749,693
2018,7,Horta-Guinardó,37,el Carmel,7064,1640,862,778
2018,7,Horta-Guinardó,37,el Carmel,7065,1687,888,799
2018,7,Horta-Guinardó,37,el Carmel,7066,1805,957,848
2018,7,Horta-Guinardó,37,el Carmel,7067,1519,821,698
2018,7,Horta-Guinardó,37,el Carmel,7068,1293,689,604
2018,7,Horta-Guinardó,37,el Carmel,7069,1365,704,661
2018,7,Horta-Guinardó,37,el Carmel,7070,1451,754,697
2018,7,Horta-Guinardó,37,el Carmel,7071,1371,732,639
2018,7,Horta-Guinardó,37,el Carmel,7072,1393,727,666
2018,7,Horta-Guinardó,37,el Carmel,7073,1129,626,503
2018,7,Horta-Guinardó,37,el Carmel,7074,1687,902,785
2018,7,Horta-Guinardó,37,el Carmel,7075,1231,640,591
2018,7,Horta-Guinardó,37,el Carmel,7076,1332,696,636
2018,7,Horta-Guinardó,37,el Carmel,7077,1321,682,639
2018,7,Horta-Guinardó,37,el Carmel,7078,1375,700,675
2018,7,Horta-Guinardó,37,el Carmel,7079,1387,711,676
2018,7,Horta-Guinardó,37,el Carmel,7080,1780,942,838
2018,7,Horta-Guinardó,38,la Teixonera,7081,1912,982,930
2018,7,Horta-Guinardó,38,la Teixonera,7082,1266,644,622
2018,7,Horta-Guinardó,38,la Teixonera,7083,1256,659,597
2018,7,Horta-Guinardó,38,la Teixonera,7084,1272,656,616
2018,7,Horta-Guinardó,38,la Teixonera,7085,1302,658,644
2018,7,Horta-Guinardó,38,la Teixonera,7086,1396,726,670
2018,7,Horta-Guinardó,38,la Teixonera,7087,1618,858,760
2018,7,Horta-Guinardó,38,la Teixonera,7088,1628,834,794
2018,7,Horta-Guinardó,39,Sant Genís dels Agudells,7089,1358,760,598
2018,7,Horta-Guinardó,39,Sant Genís dels Agudells,7090,1401,722,679
2018,7,Horta-Guinardó,39,Sant Genís dels Agudells,7091,1186,636,550
2018,7,Horta-Guinardó,39,Sant Genís dels Agudells,7092,1417,771,646
2018,7,Horta-Guinardó,39,Sant Genís dels Agudells,7093,1649,836,813
2018,7,Horta-Guinardó,40,Montbau,7094,1252,694,558
2018,7,Horta-Guinardó,40,Montbau,7095,1542,837,705
2018,7,Horta-Guinardó,40,Montbau,7096,1379,761,618
2018,7,Horta-Guinardó,40,Montbau,7097,926,529,397
2018,7,Horta-Guinardó,41,la Vall d'Hebron,7098,2111,1134,977
2018,7,Horta-Guinardó,41,la Vall d'Hebron,7099,1076,549,527
2018,7,Horta-Guinardó,41,la Vall d'Hebron,7100,1171,623,548
2018,7,Horta-Guinardó,41,la Vall d'Hebron,7101,1379,727,652
2018,7,Horta-Guinardó,42,la Clota,7102,657,321,336
2018,7,Horta-Guinardó,43,Horta,7103,1565,842,723
2018,7,Horta-Guinardó,43,Horta,7104,1596,859,737
2018,7,Horta-Guinardó,43,Horta,7105,1083,562,521
2018,7,Horta-Guinardó,43,Horta,7106,1191,644,547
2018,7,Horta-Guinardó,43,Horta,7107,1233,634,599
2018,7,Horta-Guinardó,43,Horta,7108,1209,635,574
2018,7,Horta-Guinardó,43,Horta,7109,1618,844,774
2018,7,Horta-Guinardó,43,Horta,7110,1030,584,446
2018,7,Horta-Guinardó,43,Horta,7111,872,490,382
2018,7,Horta-Guinardó,43,Horta,7112,1259,663,596
2018,7,Horta-Guinardó,43,Horta,7113,1190,615,575
2018,7,Horta-Guinardó,43,Horta,7114,1165,616,549
2018,7,Horta-Guinardó,43,Horta,7115,1082,579,503
2018,7,Horta-Guinardó,43,Horta,7116,1463,780,683
2018,7,Horta-Guinardó,43,Horta,7117,1748,849,899
2018,7,Horta-Guinardó,43,Horta,7118,1236,694,542
2018,7,Horta-Guinardó,43,Horta,7119,1222,652,570
2018,7,Horta-Guinardó,43,Horta,7120,1221,652,569
2018,7,Horta-Guinardó,43,Horta,7121,1166,640,526
2018,7,Horta-Guinardó,43,Horta,7122,1308,719,589
2018,7,Horta-Guinardó,43,Horta,7123,1410,736,674
2018,8,Nou Barris,44,Vilapicina i la Torre Llobeta,8001,1258,668,590
2018,8,Nou Barris,44,Vilapicina i la Torre Llobeta,8002,1256,672,584
2018,8,Nou Barris,44,Vilapicina i la Torre Llobeta,8003,1256,651,605
2018,8,Nou Barris,44,Vilapicina i la Torre Llobeta,8004,1433,792,641
2018,8,Nou Barris,44,Vilapicina i la Torre Llobeta,8005,1161,621,540
2018,8,Nou Barris,44,Vilapicina i la Torre Llobeta,8006,1505,791,714
2018,8,Nou Barris,44,Vilapicina i la Torre Llobeta,8007,1223,690,533
2018,8,Nou Barris,44,Vilapicina i la Torre Llobeta,8008,1586,838,748
2018,8,Nou Barris,44,Vilapicina i la Torre Llobeta,8009,1687,889,798
2018,8,Nou Barris,44,Vilapicina i la Torre Llobeta,8010,1072,582,490
2018,8,Nou Barris,44,Vilapicina i la Torre Llobeta,8011,1213,659,554
2018,8,Nou Barris,44,Vilapicina i la Torre Llobeta,8012,1348,751,597
2018,8,Nou Barris,44,Vilapicina i la Torre Llobeta,8013,1222,663,559
2018,8,Nou Barris,44,Vilapicina i la Torre Llobeta,8014,1230,654,576
2018,8,Nou Barris,44,Vilapicina i la Torre Llobeta,8015,1420,801,619
2018,8,Nou Barris,44,Vilapicina i la Torre Llobeta,8016,1144,636,508
2018,8,Nou Barris,44,Vilapicina i la Torre Llobeta,8017,1336,705,631
2018,8,Nou Barris,44,Vilapicina i la Torre Llobeta,8018,1537,829,708
2018,8,Nou Barris,44,Vilapicina i la Torre Llobeta,8019,1788,978,810
2018,8,Nou Barris,45,Porta,8020,1324,711,613
2018,8,Nou Barris,45,Porta,8021,1459,798,661
2018,8,Nou Barris,45,Porta,8022,1242,675,567
2018,8,Nou Barris,45,Porta,8023,1393,735,658
2018,8,Nou Barris,45,Porta,8024,1406,765,641
2018,8,Nou Barris,45,Porta,8025,1208,683,525
2018,8,Nou Barris,45,Porta,8026,1460,782,678
2018,8,Nou Barris,45,Porta,8027,1313,673,640
2018,8,Nou Barris,45,Porta,8028,1068,593,475
2018,8,Nou Barris,45,Porta,8029,1531,812,719
2018,8,Nou Barris,45,Porta,8030,1490,798,692
2018,8,Nou Barris,45,Porta,8031,1288,690,598
2018,8,Nou Barris,45,Porta,8032,1288,703,585
2018,8,Nou Barris,45,Porta,8033,1459,761,698
2018,8,Nou Barris,45,Porta,8034,1257,713,544
2018,8,Nou Barris,45,Porta,8035,2368,1182,1186
2018,8,Nou Barris,45,Porta,8036,1500,807,693
2018,8,Nou Barris,45,Porta,8037,1514,851,663
2018,8,Nou Barris,46,el Turó de la Peira,8038,1505,838,667
2018,8,Nou Barris,46,el Turó de la Peira,8039,1516,827,689
2018,8,Nou Barris,46,el Turó de la Peira,8040,1688,876,812
2018,8,Nou Barris,46,el Turó de la Peira,8041,2402,1247,1155
2018,8,Nou Barris,46,el Turó de la Peira,8042,1273,689,584
2018,8,Nou Barris,46,el Turó de la Peira,8043,1160,663,497
2018,8,Nou Barris,46,el Turó de la Peira,8044,1352,712,640
2018,8,Nou Barris,46,el Turó de la Peira,8045,1735,896,839
2018,8,Nou Barris,46,el Turó de la Peira,8046,1375,765,610
2018,8,Nou Barris,46,el Turó de la Peira,8047,1569,867,702
2018,8,Nou Barris,47,Can Peguera,8048,1007,532,475
2018,8,Nou Barris,47,Can Peguera,8049,1263,667,596
2018,8,Nou Barris,48,la Guineueta,8050,1423,754,669
2018,8,Nou Barris,48,la Guineueta,8051,1364,713,651
2018,8,Nou Barris,48,la Guineueta,8052,896,497,399
2018,8,Nou Barris,48,la Guineueta,8053,1171,616,555
2018,8,Nou Barris,48,la Guineueta,8054,1695,933,762
2018,8,Nou Barris,48,la Guineueta,8055,1850,968,882
2018,8,Nou Barris,48,la Guineueta,8056,1480,794,686
2018,8,Nou Barris,48,la Guineueta,8057,1333,716,617
2018,8,Nou Barris,48,la Guineueta,8058,1622,889,733
2018,8,Nou Barris,48,la Guineueta,8059,972,514,458
2018,8,Nou Barris,48,la Guineueta,8215,1487,828,659
2018,8,Nou Barris,49,Canyelles,8060,1205,645,560
2018,8,Nou Barris,49,Canyelles,8061,1631,843,788
2018,8,Nou Barris,49,Canyelles,8062,1172,617,555
2018,8,Nou Barris,49,Canyelles,8063,1115,574,541
2018,8,Nou Barris,49,Canyelles,8064,1762,941,821
2018,8,Nou Barris,50,les Roquetes,8065,1663,803,860
2018,8,Nou Barris,50,les Roquetes,8066,1556,796,760
2018,8,Nou Barris,50,les Roquetes,8067,1724,884,840
2018,8,Nou Barris,50,les Roquetes,8068,1861,985,876
2018,8,Nou Barris,50,les Roquetes,8069,1518,793,725
2018,8,Nou Barris,50,les Roquetes,8070,1463,787,676
2018,8,Nou Barris,50,les Roquetes,8071,1639,841,798
2018,8,Nou Barris,50,les Roquetes,8072,1227,649,578
2018,8,Nou Barris,50,les Roquetes,8073,1695,900,795
2018,8,Nou Barris,50,les Roquetes,8074,1418,744,674
2018,8,Nou Barris,51,Verdun,8075,1883,1011,872
2018,8,Nou Barris,51,Verdun,8076,1539,832,707
2018,8,Nou Barris,51,Verdun,8077,1389,749,640
2018,8,Nou Barris,51,Verdun,8078,1516,815,701
2018,8,Nou Barris,51,Verdun,8079,1418,756,662
2018,8,Nou Barris,51,Verdun,8080,1491,788,703
2018,8,Nou Barris,51,Verdun,8081,1638,852,786
2018,8,Nou Barris,51,Verdun,8082,1571,866,705
2018,8,Nou Barris,52,la Prosperitat,8083,1271,692,579
2018,8,Nou Barris,52,la Prosperitat,8084,1147,625,522
2018,8,Nou Barris,52,la Prosperitat,8085,1461,756,705
2018,8,Nou Barris,52,la Prosperitat,8086,1690,911,779
2018,8,Nou Barris,52,la Prosperitat,8087,1221,660,561
2018,8,Nou Barris,52,la Prosperitat,8088,1258,673,585
2018,8,Nou Barris,52,la Prosperitat,8089,1238,656,582
2018,8,Nou Barris,52,la Prosperitat,8090,1251,666,585
2018,8,Nou Barris,52,la Prosperitat,8091,1223,632,591
2018,8,Nou Barris,52,la Prosperitat,8092,1005,512,493
2018,8,Nou Barris,52,la Prosperitat,8093,1255,640,615
2018,8,Nou Barris,52,la Prosperitat,8094,1487,784,703
2018,8,Nou Barris,52,la Prosperitat,8095,1093,571,522
2018,8,Nou Barris,52,la Prosperitat,8096,1519,772,747
2018,8,Nou Barris,52,la Prosperitat,8097,1374,713,661
2018,8,Nou Barris,52,la Prosperitat,8098,1285,683,602
2018,8,Nou Barris,52,la Prosperitat,8099,1333,685,648
2018,8,Nou Barris,52,la Prosperitat,8100,1269,703,566
2018,8,Nou Barris,52,la Prosperitat,8101,1722,933,789
2018,8,Nou Barris,52,la Prosperitat,8102,1470,811,659
2018,8,Nou Barris,53,la Trinitat Nova,8103,1615,811,804
2018,8,Nou Barris,53,la Trinitat Nova,8104,1242,678,564
2018,8,Nou Barris,53,la Trinitat Nova,8105,1498,797,701
2018,8,Nou Barris,53,la Trinitat Nova,8106,1201,626,575
2018,8,Nou Barris,53,la Trinitat Nova,8107,1809,952,857
2018,8,Nou Barris,54,Torre Baró,8108,1892,956,936
2018,8,Nou Barris,54,Torre Baró,8109,1001,486,515
2018,8,Nou Barris,55,Ciutat Meridiana,8110,1908,963,945
2018,8,Nou Barris,55,Ciutat Meridiana,8111,1657,889,768
2018,8,Nou Barris,55,Ciutat Meridiana,8112,1732,887,845
2018,8,Nou Barris,55,Ciutat Meridiana,8113,1747,897,850
2018,8,Nou Barris,55,Ciutat Meridiana,8114,1894,964,930
2018,8,Nou Barris,55,Ciutat Meridiana,8115,1684,875,809
2018,8,Nou Barris,56,Vallbona,8116,1400,711,689
2018,9,Sant Andreu,57,la Trinitat Vella,9001,2596,1217,1379
2018,9,Sant Andreu,57,la Trinitat Vella,9002,2136,1035,1101
2018,9,Sant Andreu,57,la Trinitat Vella,9003,2111,1016,1095
2018,9,Sant Andreu,57,la Trinitat Vella,9004,1630,819,811
2018,9,Sant Andreu,57,la Trinitat Vella,9005,1598,810,788
2018,9,Sant Andreu,58,Baró de Viver,9006,1240,638,602
2018,9,Sant Andreu,58,Baró de Viver,9007,1295,669,626
2018,9,Sant Andreu,59,el Bon Pastor,9008,1946,964,982
2018,9,Sant Andreu,59,el Bon Pastor,9009,1443,739,704
2018,9,Sant Andreu,59,el Bon Pastor,9010,1777,913,864
2018,9,Sant Andreu,59,el Bon Pastor,9011,1749,908,841
2018,9,Sant Andreu,59,el Bon Pastor,9013,1899,1000,899
2018,9,Sant Andreu,59,el Bon Pastor,9014,2113,993,1120
2018,9,Sant Andreu,59,el Bon Pastor,9015,1813,927,886
2018,9,Sant Andreu,60,Sant Andreu,9016,1381,738,643
2018,9,Sant Andreu,60,Sant Andreu,9017,1539,791,748
2018,9,Sant Andreu,60,Sant Andreu,9018,1464,759,705
2018,9,Sant Andreu,60,Sant Andreu,9019,2647,1335,1312
2018,9,Sant Andreu,60,Sant Andreu,9020,1143,624,519
2018,9,Sant Andreu,60,Sant Andreu,9021,1397,731,666
2018,9,Sant Andreu,60,Sant Andreu,9022,1212,636,576
2018,9,Sant Andreu,60,Sant Andreu,9023,1219,629,590
2018,9,Sant Andreu,60,Sant Andreu,9024,1153,630,523
2018,9,Sant Andreu,60,Sant Andreu,9025,1182,634,548
2018,9,Sant Andreu,60,Sant Andreu,9026,1561,822,739
2018,9,Sant Andreu,60,Sant Andreu,9027,1318,685,633
2018,9,Sant Andreu,60,Sant Andreu,9028,1622,828,794
2018,9,Sant Andreu,60,Sant Andreu,9029,1154,594,560
2018,9,Sant Andreu,60,Sant Andreu,9030,1503,799,704
2018,9,Sant Andreu,60,Sant Andreu,9031,1175,610,565
2018,9,Sant Andreu,60,Sant Andreu,9032,2167,1146,1021
2018,9,Sant Andreu,60,Sant Andreu,9033,3210,1656,1554
2018,9,Sant Andreu,60,Sant Andreu,9034,1388,743,645
2018,9,Sant Andreu,60,Sant Andreu,9035,1528,809,719
2018,9,Sant Andreu,60,Sant Andreu,9036,1457,791,666
2018,9,Sant Andreu,60,Sant Andreu,9037,1467,781,686
2018,9,Sant Andreu,60,Sant Andreu,9038,1532,820,712
2018,9,Sant Andreu,60,Sant Andreu,9039,1565,821,744
2018,9,Sant Andreu,60,Sant Andreu,9040,1550,845,705
2018,9,Sant Andreu,60,Sant Andreu,9041,1417,777,640
2018,9,Sant Andreu,60,Sant Andreu,9042,1226,665,561
2018,9,Sant Andreu,60,Sant Andreu,9043,1322,716,606
2018,9,Sant Andreu,60,Sant Andreu,9044,1464,756,708
2018,9,Sant Andreu,60,Sant Andreu,9045,1414,748,666
2018,9,Sant Andreu,60,Sant Andreu,9046,1322,688,634
2018,9,Sant Andreu,60,Sant Andreu,9047,1526,809,717
2018,9,Sant Andreu,60,Sant Andreu,9048,1428,746,682
2018,9,Sant Andreu,60,Sant Andreu,9049,1314,723,591
2018,9,Sant Andreu,60,Sant Andreu,9050,1592,851,741
2018,9,Sant Andreu,60,Sant Andreu,9051,1227,651,576
2018,9,Sant Andreu,60,Sant Andreu,9052,1167,614,553
2018,9,Sant Andreu,60,Sant Andreu,9053,1572,858,714
2018,9,Sant Andreu,60,Sant Andreu,9054,1137,613,524
2018,9,Sant Andreu,61,la Sagrera,9055,1750,932,818
2018,9,Sant Andreu,61,la Sagrera,9056,1144,604,540
2018,9,Sant Andreu,61,la Sagrera,9057,1563,809,754
2018,9,Sant Andreu,61,la Sagrera,9058,1491,802,689
2018,9,Sant Andreu,61,la Sagrera,9059,1405,716,689
2018,9,Sant Andreu,61,la Sagrera,9060,1331,723,608
2018,9,Sant Andreu,61,la Sagrera,9061,1695,888,807
2018,9,Sant Andreu,61,la Sagrera,9062,1140,583,557
2018,9,Sant Andreu,61,la Sagrera,9063,1154,592,562
2018,9,Sant Andreu,61,la Sagrera,9064,1197,629,568
2018,9,Sant Andreu,61,la Sagrera,9065,2066,1118,948
2018,9,Sant Andreu,61,la Sagrera,9066,1443,750,693
2018,9,Sant Andreu,61,la Sagrera,9067,1497,820,677
2018,9,Sant Andreu,61,la Sagrera,9068,1569,805,764
2018,9,Sant Andreu,61,la Sagrera,9069,904,510,394
2018,9,Sant Andreu,61,la Sagrera,9070,1774,972,802
2018,9,Sant Andreu,61,la Sagrera,9071,1880,1016,864
2018,9,Sant Andreu,61,la Sagrera,9072,1502,807,695
2018,9,Sant Andreu,61,la Sagrera,9073,1521,796,725
2018,9,Sant Andreu,61,la Sagrera,9156,1264,659,605
2018,9,Sant Andreu,62,el Congrés i els Indians,9074,1620,882,738
2018,9,Sant Andreu,62,el Congrés i els Indians,9075,1531,817,714
2018,9,Sant Andreu,62,el Congrés i els Indians,9076,1419,776,643
2018,9,Sant Andreu,62,el Congrés i els Indians,9077,1588,892,696
2018,9,Sant Andreu,62,el Congrés i els Indians,9078,1443,781,662
2018,9,Sant Andreu,62,el Congrés i els Indians,9079,1609,876,733
2018,9,Sant Andreu,62,el Congrés i els Indians,9080,1330,678,652
2018,9,Sant Andreu,62,el Congrés i els Indians,9081,1723,947,776
2018,9,Sant Andreu,62,el Congrés i els Indians,9082,1933,1028,905
2018,9,Sant Andreu,63,Navas,9083,1619,863,756
2018,9,Sant Andreu,63,Navas,9084,1740,896,844
2018,9,Sant Andreu,63,Navas,9085,1697,918,779
2018,9,Sant Andreu,63,Navas,9086,1444,773,671
2018,9,Sant Andreu,63,Navas,9087,1317,700,617
2018,9,Sant Andreu,63,Navas,9088,1929,1067,862
2018,9,Sant Andreu,63,Navas,9089,1484,809,675
2018,9,Sant Andreu,63,Navas,9090,1643,880,763
2018,9,Sant Andreu,63,Navas,9091,1874,980,894
2018,9,Sant Andreu,63,Navas,9092,1933,1004,929
2018,9,Sant Andreu,63,Navas,9093,1324,697,627
2018,9,Sant Andreu,63,Navas,9094,2061,1062,999
2018,9,Sant Andreu,63,Navas,9095,2094,1098,996
2018,10,Sant Martí,64,Camp de l'Arpa del Clot,10001,1583,813,770
2018,10,Sant Martí,64,Camp de l'Arpa del Clot,10002,1730,898,832
2018,10,Sant Martí,64,Camp de l'Arpa del Clot,10003,1594,838,756
2018,10,Sant Martí,64,Camp de l'Arpa del Clot,10004,1547,838,709
2018,10,Sant Martí,64,Camp de l'Arpa del Clot,10005,1572,854,718
2018,10,Sant Martí,64,Camp de l'Arpa del Clot,10006,1791,971,820
2018,10,Sant Martí,64,Camp de l'Arpa del Clot,10007,1289,662,627
2018,10,Sant Martí,64,Camp de l'Arpa del Clot,10008,1704,933,771
2018,10,Sant Martí,64,Camp de l'Arpa del Clot,10009,1543,837,706
2018,10,Sant Martí,64,Camp de l'Arpa del Clot,10010,1708,919,789
2018,10,Sant Martí,64,Camp de l'Arpa del Clot,10011,1206,643,563
2018,10,Sant Martí,64,Camp de l'Arpa del Clot,10012,1844,988,856
2018,10,Sant Martí,64,Camp de l'Arpa del Clot,10013,1359,734,625
2018,10,Sant Martí,64,Camp de l'Arpa del Clot,10014,1435,767,668
2018,10,Sant Martí,64,Camp de l'Arpa del Clot,10015,1835,961,874
2018,10,Sant Martí,64,Camp de l'Arpa del Clot,10016,1265,643,622
2018,10,Sant Martí,64,Camp de l'Arpa del Clot,10017,1728,926,802
2018,10,Sant Martí,64,Camp de l'Arpa del Clot,10018,1414,733,681
2018,10,Sant Martí,64,Camp de l'Arpa del Clot,10019,1638,867,771
2018,10,Sant Martí,64,Camp de l'Arpa del Clot,10020,1497,791,706
2018,10,Sant Martí,64,Camp de l'Arpa del Clot,10021,1347,701,646
2018,10,Sant Martí,64,Camp de l'Arpa del Clot,10022,1325,706,619
2018,10,Sant Martí,64,Camp de l'Arpa del Clot,10023,1474,803,671
2018,10,Sant Martí,64,Camp de l'Arpa del Clot,10024,1500,780,720
2018,10,Sant Martí,64,Camp de l'Arpa del Clot,10025,1399,766,633
2018,10,Sant Martí,65,el Clot,10026,1519,791,728
2018,10,Sant Martí,65,el Clot,10027,1534,807,727
2018,10,Sant Martí,65,el Clot,10028,1833,957,876
2018,10,Sant Martí,65,el Clot,10029,1531,809,722
2018,10,Sant Martí,65,el Clot,10030,1752,920,832
2018,10,Sant Martí,65,el Clot,10031,1553,797,756
2018,10,Sant Martí,65,el Clot,10032,1404,746,658
2018,10,Sant Martí,65,el Clot,10033,883,490,393
2018,10,Sant Martí,65,el Clot,10034,1719,888,831
2018,10,Sant Martí,65,el Clot,10035,1995,1020,975
2018,10,Sant Martí,65,el Clot,10036,1450,721,729
2018,10,Sant Martí,65,el Clot,10037,1072,551,521
2018,10,Sant Martí,65,el Clot,10038,1644,856,788
2018,10,Sant Martí,65,el Clot,10039,1806,960,846
2018,10,Sant Martí,65,el Clot,10040,1862,953,909
2018,10,Sant Martí,65,el Clot,10041,1618,814,804
2018,10,Sant Martí,65,el Clot,10234,1875,1015,860
2018,10,Sant Martí,66,el Parc i la Llacuna del Poblenou,10042,2648,1373,1275
2018,10,Sant Martí,66,el Parc i la Llacuna del Poblenou,10043,2230,1092,1138
2018,10,Sant Martí,66,el Parc i la Llacuna del Poblenou,10044,1572,818,754
2018,10,Sant Martí,66,el Parc i la Llacuna del Poblenou,10045,1290,701,589
2018,10,Sant Martí,66,el Parc i la Llacuna del Poblenou,10046,1239,650,589
2018,10,Sant Martí,66,el Parc i la Llacuna del Poblenou,10047,1896,970,926
2018,10,Sant Martí,66,el Parc i la Llacuna del Poblenou,10048,1652,833,819
2018,10,Sant Martí,66,el Parc i la Llacuna del Poblenou,10049,1275,658,617
2018,10,Sant Martí,66,el Parc i la Llacuna del Poblenou,10050,1623,860,763
2018,10,Sant Martí,67,la Vila Olímpica del Poblenou,10051,1581,838,743
2018,10,Sant Martí,67,la Vila Olímpica del Poblenou,10052,2397,1198,1199
2018,10,Sant Martí,67,la Vila Olímpica del Poblenou,10053,1758,892,866
2018,10,Sant Martí,67,la Vila Olímpica del Poblenou,10054,986,521,465
2018,10,Sant Martí,67,la Vila Olímpica del Poblenou,10055,2590,1317,1273
2018,10,Sant Martí,68,el Poblenou,10056,1929,999,930
2018,10,Sant Martí,68,el Poblenou,10057,1404,709,695
2018,10,Sant Martí,68,el Poblenou,10058,1163,592,571
2018,10,Sant Martí,68,el Poblenou,10059,1722,896,826
2018,10,Sant Martí,68,el Poblenou,10060,1624,824,800
2018,10,Sant Martí,68,el Poblenou,10061,1809,947,862
2018,10,Sant Martí,68,el Poblenou,10062,1513,777,736
2018,10,Sant Martí,68,el Poblenou,10063,1195,626,569
2018,10,Sant Martí,68,el Poblenou,10064,1704,880,824
2018,10,Sant Martí,68,el Poblenou,10065,1594,823,771
2018,10,Sant Martí,68,el Poblenou,10066,2143,1089,1054
2018,10,Sant Martí,68,el Poblenou,10067,1950,1028,922
2018,10,Sant Martí,68,el Poblenou,10068,1610,811,799
2018,10,Sant Martí,68,el Poblenou,10069,2492,1312,1180
2018,10,Sant Martí,68,el Poblenou,10070,1655,886,769
2018,10,Sant Martí,68,el Poblenou,10071,1816,928,888
2018,10,Sant Martí,68,el Poblenou,10072,2026,1022,1004
2018,10,Sant Martí,68,el Poblenou,10073,1485,776,709
2018,10,Sant Martí,68,el Poblenou,10074,1664,866,798
2018,10,Sant Martí,68,el Poblenou,10075,1488,759,729
2018,10,Sant Martí,69,Diagonal Mar i el Front Marítim del Poblenou,10076,2186,1119,1067
2018,10,Sant Martí,69,Diagonal Mar i el Front Marítim del Poblenou,10077,1844,897,947
2018,10,Sant Martí,69,Diagonal Mar i el Front Marítim del Poblenou,10078,2432,1243,1189
2018,10,Sant Martí,69,Diagonal Mar i el Front Marítim del Poblenou,10079,1809,944,865
2018,10,Sant Martí,69,Diagonal Mar i el Front Marítim del Poblenou,10080,2352,1159,1193
2018,10,Sant Martí,69,Diagonal Mar i el Front Marítim del Poblenou,10235,1375,730,645
2018,10,Sant Martí,69,Diagonal Mar i el Front Marítim del Poblenou,10236,1646,872,774
2018,10,Sant Martí,70,el Besòs i el Maresme,10081,1950,964,986
2018,10,Sant Martí,70,el Besòs i el Maresme,10082,2004,946,1058
2018,10,Sant Martí,70,el Besòs i el Maresme,10083,2244,955,1289
2018,10,Sant Martí,70,el Besòs i el Maresme,10084,1632,815,817
2018,10,Sant Martí,70,el Besòs i el Maresme,10085,2042,998,1044
2018,10,Sant Martí,70,el Besòs i el Maresme,10086,1987,1007,980
2018,10,Sant Martí,70,el Besòs i el Maresme,10087,1796,921,875
2018,10,Sant Martí,70,el Besòs i el Maresme,10088,1643,849,794
2018,10,Sant Martí,70,el Besòs i el Maresme,10089,2538,1168,1370
2018,10,Sant Martí,70,el Besòs i el Maresme,10090,1429,744,685
2018,10,Sant Martí,70,el Besòs i el Maresme,10091,1925,992,933
2018,10,Sant Martí,70,el Besòs i el Maresme,10092,1483,785,698
2018,10,Sant Martí,70,el Besòs i el Maresme,10093,1048,531,517
2018,10,Sant Martí,71,Provençals del Poblenou,10094,2859,1462,1397
2018,10,Sant Martí,71,Provençals del Poblenou,10095,1282,639,643
2018,10,Sant Martí,71,Provençals del Poblenou,10096,1625,866,759
2018,10,Sant Martí,71,Provençals del Poblenou,10097,1586,832,754
2018,10,Sant Martí,71,Provençals del Poblenou,10098,1856,969,887
2018,10,Sant Martí,71,Provençals del Poblenou,10099,1123,585,538
2018,10,Sant Martí,71,Provençals del Poblenou,10100,1600,865,735
2018,10,Sant Martí,71,Provençals del Poblenou,10101,1579,774,805
2018,10,Sant Martí,71,Provençals del Poblenou,10102,2550,1338,1212
2018,10,Sant Martí,71,Provençals del Poblenou,10103,2202,1151,1051
2018,10,Sant Martí,71,Provençals del Poblenou,10104,1611,836,775
2018,10,Sant Martí,71,Provençals del Poblenou,10237,755,413,342
2018,10,Sant Martí,72,Sant Martí de Provençals,10105,2294,1233,1061
2018,10,Sant Martí,72,Sant Martí de Provençals,10106,1004,531,473
2018,10,Sant Martí,72,Sant Martí de Provençals,10107,1576,827,749
2018,10,Sant Martí,72,Sant Martí de Provençals,10108,1320,712,608
2018,10,Sant Martí,72,Sant Martí de Provençals,10109,1554,826,728
2018,10,Sant Martí,72,Sant Martí de Provençals,10110,1631,905,726
2018,10,Sant Martí,72,Sant Martí de Provençals,10111,1261,667,594
2018,10,Sant Martí,72,Sant Martí de Provençals,10112,1540,790,750
2018,10,Sant Martí,72,Sant Martí de Provençals,10113,1198,630,568
2018,10,Sant Martí,72,Sant Martí de Provençals,10114,1428,747,681
2018,10,Sant Martí,72,Sant Martí de Provençals,10115,1475,743,732
2018,10,Sant Martí,72,Sant Martí de Provençals,10116,1846,987,859
2018,10,Sant Martí,72,Sant Martí de Provençals,10117,1280,669,611
2018,10,Sant Martí,72,Sant Martí de Provençals,10118,1003,534,469
2018,10,Sant Martí,72,Sant Martí de Provençals,10119,1121,613,508
2018,10,Sant Martí,72,Sant Martí de Provençals,10120,1448,806,642
2018,10,Sant Martí,72,Sant Martí de Provençals,10121,1592,821,771
2018,10,Sant Martí,72,Sant Martí de Provençals,10122,1521,791,730
2018,10,Sant Martí,73,la Verneda i la Pau,10123,1399,722,677
2018,10,Sant Martí,73,la Verneda i la Pau,10124,1103,570,533
2018,10,Sant Martí,73,la Verneda i la Pau,10125,1108,581,527
2018,10,Sant Martí,73,la Verneda i la Pau,10126,1030,535,495
2018,10,Sant Martí,73,la Verneda i la Pau,10127,1028,514,514
2018,10,Sant Martí,73,la Verneda i la Pau,10128,1581,847,734
2018,10,Sant Martí,73,la Verneda i la Pau,10129,1210,618,592
2018,10,Sant Martí,73,la Verneda i la Pau,10130,1204,638,566
2018,10,Sant Martí,73,la Verneda i la Pau,10131,1187,643,544
2018,10,Sant Martí,73,la Verneda i la Pau,10132,1270,670,600
2018,10,Sant Martí,73,la Verneda i la Pau,10133,1677,903,774
2018,10,Sant Martí,73,la Verneda i la Pau,10134,1501,827,674
2018,10,Sant Martí,73,la Verneda i la Pau,10135,1229,645,584
2018,10,Sant Martí,73,la Verneda i la Pau,10136,1338,698,640
2018,10,Sant Martí,73,la Verneda i la Pau,10137,1572,813,759
2018,10,Sant Martí,73,la Verneda i la Pau,10138,1566,821,745
2018,10,Sant Martí,73,la Verneda i la Pau,10139,1680,865,815
2018,10,Sant Martí,73,la Verneda i la Pau,10140,1627,835,792
2018,10,Sant Martí,73,la Verneda i la Pau,10141,1063,555,508
2018,10,Sant Martí,73,la Verneda i la Pau,10142,1665,869,796
2018,10,Sant Martí,73,la Verneda i la Pau,10143,1776,937,839
2019,1,Ciutat Vella,1,el Raval,1001,1345,596,749
2019,1,Ciutat Vella,1,el Raval,1002,1524,702,822
2019,1,Ciutat Vella,1,el Raval,1003,3580,1664,1916
2019,1,Ciutat Vella,1,el Raval,1004,2877,1288,1589
2019,1,Ciutat Vella,1,el Raval,1005,2478,1118,1360
2019,1,Ciutat Vella,1,el Raval,1006,1626,710,916
2019,1,Ciutat Vella,1,el Raval,1007,1983,789,1194
2019,1,Ciutat Vella,1,el Raval,1008,3318,1306,2012
2019,1,Ciutat Vella,1,el Raval,1009,2278,1006,1272
2019,1,Ciutat Vella,1,el Raval,1010,2441,1076,1365
2019,1,Ciutat Vella,1,el Raval,1011,3209,1382,1827
2019,1,Ciutat Vella,1,el Raval,1012,1931,952,979
2019,1,Ciutat Vella,1,el Raval,1013,1447,738,709
2019,1,Ciutat Vella,1,el Raval,1014,2075,929,1146
2019,1,Ciutat Vella,1,el Raval,1015,2398,1149,1249
2019,1,Ciutat Vella,1,el Raval,1016,2248,1082,1166
2019,1,Ciutat Vella,1,el Raval,1017,2590,1325,1265
2019,1,Ciutat Vella,1,el Raval,1018,1605,780,825
2019,1,Ciutat Vella,1,el Raval,1019,2995,1385,1610
2019,1,Ciutat Vella,1,el Raval,1020,2144,1126,1018
2019,1,Ciutat Vella,1,el Raval,1021,2118,1049,1069
2019,1,Ciutat Vella,2,el Barri Gòtic,1022,1298,668,630
2019,1,Ciutat Vella,2,el Barri Gòtic,1023,2131,1079,1052
2019,1,Ciutat Vella,2,el Barri Gòtic,1025,1301,635,666
2019,1,Ciutat Vella,2,el Barri Gòtic,1026,5331,1460,3871
2019,1,Ciutat Vella,2,el Barri Gòtic,1027,1646,846,800
2019,1,Ciutat Vella,2,el Barri Gòtic,1028,1923,990,933
2019,1,Ciutat Vella,2,el Barri Gòtic,1029,1457,744,713
2019,1,Ciutat Vella,2,el Barri Gòtic,1030,2498,1235,1263
2019,1,Ciutat Vella,2,el Barri Gòtic,1031,1595,733,862
2019,1,Ciutat Vella,3,la Barceloneta,1032,1844,900,944
2019,1,Ciutat Vella,3,la Barceloneta,1033,1167,548,619
2019,1,Ciutat Vella,3,la Barceloneta,1034,955,498,457
2019,1,Ciutat Vella,3,la Barceloneta,1035,1320,638,682
2019,1,Ciutat Vella,3,la Barceloneta,1036,1205,648,557
2019,1,Ciutat Vella,3,la Barceloneta,1037,1431,751,680
2019,1,Ciutat Vella,3,la Barceloneta,1038,1500,666,834
2019,1,Ciutat Vella,3,la Barceloneta,1039,1315,653,662
2019,1,Ciutat Vella,3,la Barceloneta,1040,1102,564,538
2019,1,Ciutat Vella,3,la Barceloneta,1041,1531,744,787
2019,1,Ciutat Vella,3,la Barceloneta,1042,1803,969,834
2019,1,Ciutat Vella,4,"Sant Pere, Santa Caterina i la Ribera",1043,1675,827,848
2019,1,Ciutat Vella,4,"Sant Pere, Santa Caterina i la Ribera",1044,1455,773,682
2019,1,Ciutat Vella,4,"Sant Pere, Santa Caterina i la Ribera",1045,1973,999,974
2019,1,Ciutat Vella,4,"Sant Pere, Santa Caterina i la Ribera",1046,1832,892,940
2019,1,Ciutat Vella,4,"Sant Pere, Santa Caterina i la Ribera",1047,1742,889,853
2019,1,Ciutat Vella,4,"Sant Pere, Santa Caterina i la Ribera",1048,2103,1078,1025
2019,1,Ciutat Vella,4,"Sant Pere, Santa Caterina i la Ribera",1049,1600,841,759
2019,1,Ciutat Vella,4,"Sant Pere, Santa Caterina i la Ribera",1050,1582,789,793
2019,1,Ciutat Vella,4,"Sant Pere, Santa Caterina i la Ribera",1051,1823,904,919
2019,1,Ciutat Vella,4,"Sant Pere, Santa Caterina i la Ribera",1052,2861,1236,1625
2019,1,Ciutat Vella,4,"Sant Pere, Santa Caterina i la Ribera",1053,1841,964,877
2019,1,Ciutat Vella,4,"Sant Pere, Santa Caterina i la Ribera",1054,1322,647,675
2019,1,Ciutat Vella,4,"Sant Pere, Santa Caterina i la Ribera",1055,1361,701,660
2019,2,Eixample,5,el Fort Pienc,2001,1309,677,632
2019,2,Eixample,5,el Fort Pienc,2002,2835,1348,1487
2019,2,Eixample,5,el Fort Pienc,2003,1253,705,548
2019,2,Eixample,5,el Fort Pienc,2004,1500,766,734
2019,2,Eixample,5,el Fort Pienc,2005,2044,1114,930
2019,2,Eixample,5,el Fort Pienc,2006,1688,875,813
2019,2,Eixample,5,el Fort Pienc,2007,1308,736,572
2019,2,Eixample,5,el Fort Pienc,2008,1943,1054,889
2019,2,Eixample,5,el Fort Pienc,2009,1794,955,839
2019,2,Eixample,5,el Fort Pienc,2010,1195,641,554
2019,2,Eixample,5,el Fort Pienc,2011,1102,554,548
2019,2,Eixample,5,el Fort Pienc,2012,1536,797,739
2019,2,Eixample,5,el Fort Pienc,2013,1156,593,563
2019,2,Eixample,5,el Fort Pienc,2014,1374,699,675
2019,2,Eixample,5,el Fort Pienc,2015,1561,809,752
2019,2,Eixample,5,el Fort Pienc,2016,1886,1035,851
2019,2,Eixample,5,el Fort Pienc,2017,1994,1074,920
2019,2,Eixample,5,el Fort Pienc,2018,1854,977,877
2019,2,Eixample,5,el Fort Pienc,2019,1937,1025,912
2019,2,Eixample,5,el Fort Pienc,2020,1469,782,687
2019,2,Eixample,6,la Sagrada Família,2021,1518,826,692
2019,2,Eixample,6,la Sagrada Família,2022,1288,668,620
2019,2,Eixample,6,la Sagrada Família,2023,1094,594,500
2019,2,Eixample,6,la Sagrada Família,2024,1138,630,508
2019,2,Eixample,6,la Sagrada Família,2025,1165,608,557
2019,2,Eixample,6,la Sagrada Família,2026,2165,1174,991
2019,2,Eixample,6,la Sagrada Família,2027,2003,1095,908
2019,2,Eixample,6,la Sagrada Família,2028,2102,1131,971
2019,2,Eixample,6,la Sagrada Família,2029,1303,706,597
2019,2,Eixample,6,la Sagrada Família,2030,1335,707,628
2019,2,Eixample,6,la Sagrada Família,2031,1074,584,490
2019,2,Eixample,6,la Sagrada Família,2032,1203,684,519
2019,2,Eixample,6,la Sagrada Família,2033,1187,654,533
2019,2,Eixample,6,la Sagrada Família,2034,1251,696,555
2019,2,Eixample,6,la Sagrada Família,2035,1335,727,608
2019,2,Eixample,6,la Sagrada Família,2036,1221,675,546
2019,2,Eixample,6,la Sagrada Família,2037,1221,643,578
2019,2,Eixample,6,la Sagrada Família,2038,1576,820,756
2019,2,Eixample,6,la Sagrada Família,2039,1731,968,763
2019,2,Eixample,6,la Sagrada Família,2040,1644,869,775
2019,2,Eixample,6,la Sagrada Família,2041,1669,916,753
2019,2,Eixample,6,la Sagrada Família,2042,1614,876,738
2019,2,Eixample,6,la Sagrada Família,2043,1434,772,662
2019,2,Eixample,6,la Sagrada Família,2044,1240,691,549
2019,2,Eixample,6,la Sagrada Família,2045,1165,628,537
2019,2,Eixample,6,la Sagrada Família,2046,1914,1031,883
2019,2,Eixample,6,la Sagrada Família,2047,1949,1045,904
2019,2,Eixample,6,la Sagrada Família,2048,1296,726,570
2019,2,Eixample,6,la Sagrada Família,2049,2121,1152,969
2019,2,Eixample,6,la Sagrada Família,2050,1608,883,725
2019,2,Eixample,6,la Sagrada Família,2051,1873,984,889
2019,2,Eixample,6,la Sagrada Família,2052,1823,982,841
2019,2,Eixample,6,la Sagrada Família,2053,1802,981,821
2019,2,Eixample,6,la Sagrada Família,2054,1855,1004,851
2019,2,Eixample,7,la Dreta de l'Eixample,2055,1830,971,859
2019,2,Eixample,7,la Dreta de l'Eixample,2056,1473,826,647
2019,2,Eixample,7,la Dreta de l'Eixample,2057,1305,709,596
2019,2,Eixample,7,la Dreta de l'Eixample,2058,1388,752,636
2019,2,Eixample,7,la Dreta de l'Eixample,2059,1680,948,732
2019,2,Eixample,7,la Dreta de l'Eixample,2060,1756,970,786
2019,2,Eixample,7,la Dreta de l'Eixample,2061,1367,751,616
2019,2,Eixample,7,la Dreta de l'Eixample,2062,1540,810,730
2019,2,Eixample,7,la Dreta de l'Eixample,2063,1232,738,494
2019,2,Eixample,7,la Dreta de l'Eixample,2064,1335,708,627
2019,2,Eixample,7,la Dreta de l'Eixample,2065,1925,1008,917
2019,2,Eixample,7,la Dreta de l'Eixample,2066,1816,961,855
2019,2,Eixample,7,la Dreta de l'Eixample,2067,1696,904,792
2019,2,Eixample,7,la Dreta de l'Eixample,2068,1658,881,777
2019,2,Eixample,7,la Dreta de l'Eixample,2069,1390,733,657
2019,2,Eixample,7,la Dreta de l'Eixample,2070,1290,695,595
2019,2,Eixample,7,la Dreta de l'Eixample,2071,1712,895,817
2019,2,Eixample,7,la Dreta de l'Eixample,2072,1216,620,596
2019,2,Eixample,7,la Dreta de l'Eixample,2073,1694,907,787
2019,2,Eixample,7,la Dreta de l'Eixample,2074,1253,633,620
2019,2,Eixample,7,la Dreta de l'Eixample,2075,1295,673,622
2019,2,Eixample,7,la Dreta de l'Eixample,2076,1667,867,800
2019,2,Eixample,7,la Dreta de l'Eixample,2077,1624,795,829
2019,2,Eixample,7,la Dreta de l'Eixample,2078,1391,762,629
2019,2,Eixample,7,la Dreta de l'Eixample,2079,1332,687,645
2019,2,Eixample,7,la Dreta de l'Eixample,2080,1493,762,731
2019,2,Eixample,7,la Dreta de l'Eixample,2081,2086,1125,961
2019,2,Eixample,7,la Dreta de l'Eixample,2082,893,480,413
2019,2,Eixample,7,la Dreta de l'Eixample,2083,1852,1007,845
2019,2,Eixample,8,l'Antiga Esquerra de l'Eixample,2084,2108,1170,938
2019,2,Eixample,8,l'Antiga Esquerra de l'Eixample,2085,1460,796,664
2019,2,Eixample,8,l'Antiga Esquerra de l'Eixample,2086,1448,792,656
2019,2,Eixample,8,l'Antiga Esquerra de l'Eixample,2087,1463,806,657
2019,2,Eixample,8,l'Antiga Esquerra de l'Eixample,2088,1671,888,783
2019,2,Eixample,8,l'Antiga Esquerra de l'Eixample,2089,1905,1005,900
2019,2,Eixample,8,l'Antiga Esquerra de l'Eixample,2090,1704,901,803
2019,2,Eixample,8,l'Antiga Esquerra de l'Eixample,2091,1912,961,951
2019,2,Eixample,8,l'Antiga Esquerra de l'Eixample,2092,2390,1035,1355
2019,2,Eixample,8,l'Antiga Esquerra de l'Eixample,2093,1637,862,775
2019,2,Eixample,8,l'Antiga Esquerra de l'Eixample,2094,1511,796,715
2019,2,Eixample,8,l'Antiga Esquerra de l'Eixample,2095,1523,792,731
2019,2,Eixample,8,l'Antiga Esquerra de l'Eixample,2096,1426,745,681
2019,2,Eixample,8,l'Antiga Esquerra de l'Eixample,2097,1105,577,528
2019,2,Eixample,8,l'Antiga Esquerra de l'Eixample,2098,1536,860,676
2019,2,Eixample,8,l'Antiga Esquerra de l'Eixample,2099,1593,851,742
2019,2,Eixample,8,l'Antiga Esquerra de l'Eixample,2100,1349,726,623
2019,2,Eixample,8,l'Antiga Esquerra de l'Eixample,2101,2236,1193,1043
2019,2,Eixample,8,l'Antiga Esquerra de l'Eixample,2102,1364,760,604
2019,2,Eixample,8,l'Antiga Esquerra de l'Eixample,2103,1641,878,763
2019,2,Eixample,8,l'Antiga Esquerra de l'Eixample,2104,1148,621,527
2019,2,Eixample,8,l'Antiga Esquerra de l'Eixample,2105,2136,1188,948
2019,2,Eixample,8,l'Antiga Esquerra de l'Eixample,2106,1438,774,664
2019,2,Eixample,8,l'Antiga Esquerra de l'Eixample,2107,1640,898,742
2019,2,Eixample,8,l'Antiga Esquerra de l'Eixample,2108,1625,908,717
2019,2,Eixample,8,l'Antiga Esquerra de l'Eixample,2109,2070,1129,941
2019,2,Eixample,9,la Nova Esquerra de l'Eixample,2110,1945,1036,909
2019,2,Eixample,9,la Nova Esquerra de l'Eixample,2111,1881,1021,860
2019,2,Eixample,9,la Nova Esquerra de l'Eixample,2112,1338,721,617
2019,2,Eixample,9,la Nova Esquerra de l'Eixample,2113,2257,1204,1053
2019,2,Eixample,9,la Nova Esquerra de l'Eixample,2114,1697,940,757
2019,2,Eixample,9,la Nova Esquerra de l'Eixample,2115,1359,746,613
2019,2,Eixample,9,la Nova Esquerra de l'Eixample,2116,1032,562,470
2019,2,Eixample,9,la Nova Esquerra de l'Eixample,2117,1189,659,530
2019,2,Eixample,9,la Nova Esquerra de l'Eixample,2118,1494,818,676
2019,2,Eixample,9,la Nova Esquerra de l'Eixample,2119,1262,670,592
2019,2,Eixample,9,la Nova Esquerra de l'Eixample,2120,1190,613,577
2019,2,Eixample,9,la Nova Esquerra de l'Eixample,2121,1254,673,581
2019,2,Eixample,9,la Nova Esquerra de l'Eixample,2122,1080,593,487
2019,2,Eixample,9,la Nova Esquerra de l'Eixample,2123,1167,594,573
2019,2,Eixample,9,la Nova Esquerra de l'Eixample,2124,1079,590,489
2019,2,Eixample,9,la Nova Esquerra de l'Eixample,2125,1720,956,764
2019,2,Eixample,9,la Nova Esquerra de l'Eixample,2126,1432,775,657
2019,2,Eixample,9,la Nova Esquerra de l'Eixample,2127,1153,613,540
2019,2,Eixample,9,la Nova Esquerra de l'Eixample,2128,1308,721,587
2019,2,Eixample,9,la Nova Esquerra de l'Eixample,2129,1557,848,709
2019,2,Eixample,9,la Nova Esquerra de l'Eixample,2130,1167,609,558
2019,2,Eixample,9,la Nova Esquerra de l'Eixample,2131,1185,641,544
2019,2,Eixample,9,la Nova Esquerra de l'Eixample,2132,1149,595,554
2019,2,Eixample,9,la Nova Esquerra de l'Eixample,2133,851,464,387
2019,2,Eixample,9,la Nova Esquerra de l'Eixample,2134,1474,788,686
2019,2,Eixample,9,la Nova Esquerra de l'Eixample,2135,2210,1191,1019
2019,2,Eixample,9,la Nova Esquerra de l'Eixample,2136,924,507,417
2019,2,Eixample,9,la Nova Esquerra de l'Eixample,2137,1482,779,703
2019,2,Eixample,9,la Nova Esquerra de l'Eixample,2138,1957,1043,914
2019,2,Eixample,9,la Nova Esquerra de l'Eixample,2139,1662,885,777
2019,2,Eixample,9,la Nova Esquerra de l'Eixample,2140,1928,1043,885
2019,2,Eixample,9,la Nova Esquerra de l'Eixample,2141,1267,679,588
2019,2,Eixample,9,la Nova Esquerra de l'Eixample,2142,2012,1058,954
2019,2,Eixample,9,la Nova Esquerra de l'Eixample,2143,1378,682,696
2019,2,Eixample,9,la Nova Esquerra de l'Eixample,2144,1580,830,750
2019,2,Eixample,9,la Nova Esquerra de l'Eixample,2145,1274,648,626
2019,2,Eixample,9,la Nova Esquerra de l'Eixample,2146,1181,635,546
2019,2,Eixample,9,la Nova Esquerra de l'Eixample,2147,2178,1167,1011
2019,2,Eixample,9,la Nova Esquerra de l'Eixample,2148,1590,858,732
2019,2,Eixample,9,la Nova Esquerra de l'Eixample,2149,1825,969,856
2019,2,Eixample,10,Sant Antoni,2150,1521,787,734
2019,2,Eixample,10,Sant Antoni,2151,1512,790,722
2019,2,Eixample,10,Sant Antoni,2152,1263,690,573
2019,2,Eixample,10,Sant Antoni,2153,1320,705,615
2019,2,Eixample,10,Sant Antoni,2154,1084,565,519
2019,2,Eixample,10,Sant Antoni,2155,1847,994,853
2019,2,Eixample,10,Sant Antoni,2156,1269,660,609
2019,2,Eixample,10,Sant Antoni,2157,1256,675,581
2019,2,Eixample,10,Sant Antoni,2158,1663,882,781
2019,2,Eixample,10,Sant Antoni,2159,1945,1001,944
2019,2,Eixample,10,Sant Antoni,2160,1991,1027,964
2019,2,Eixample,10,Sant Antoni,2161,1155,606,549
2019,2,Eixample,10,Sant Antoni,2162,1433,751,682
2019,2,Eixample,10,Sant Antoni,2163,1835,968,867
2019,2,Eixample,10,Sant Antoni,2164,1508,802,706
2019,2,Eixample,10,Sant Antoni,2165,1698,885,813
2019,2,Eixample,10,Sant Antoni,2166,2133,1119,1014
2019,2,Eixample,10,Sant Antoni,2167,2142,1120,1022
2019,2,Eixample,10,Sant Antoni,2168,2246,1174,1072
2019,2,Eixample,10,Sant Antoni,2169,1562,791,771
2019,2,Eixample,10,Sant Antoni,2170,1531,806,725
2019,2,Eixample,10,Sant Antoni,2171,1658,869,789
2019,2,Eixample,10,Sant Antoni,2172,1536,797,739
2019,2,Eixample,10,Sant Antoni,2173,1514,804,710
2019,3,Sants-Montjuïc,11,el Poble-sec,3001,1719,922,797
2019,3,Sants-Montjuïc,11,el Poble-sec,3002,1920,990,930
2019,3,Sants-Montjuïc,11,el Poble-sec,3003,1713,895,818
2019,3,Sants-Montjuïc,11,el Poble-sec,3004,1652,862,790
2019,3,Sants-Montjuïc,11,el Poble-sec,3005,1250,639,611
2019,3,Sants-Montjuïc,11,el Poble-sec,3006,1450,704,746
2019,3,Sants-Montjuïc,11,el Poble-sec,3007,1739,892,847
2019,3,Sants-Montjuïc,11,el Poble-sec,3008,1191,628,563
2019,3,Sants-Montjuïc,11,el Poble-sec,3009,1222,640,582
2019,3,Sants-Montjuïc,11,el Poble-sec,3010,1954,944,1010
2019,3,Sants-Montjuïc,11,el Poble-sec,3011,1840,920,920
2019,3,Sants-Montjuïc,11,el Poble-sec,3012,2206,1141,1065
2019,3,Sants-Montjuïc,11,el Poble-sec,3013,1825,894,931
2019,3,Sants-Montjuïc,11,el Poble-sec,3014,1813,888,925
2019,3,Sants-Montjuïc,11,el Poble-sec,3015,2960,1506,1454
2019,3,Sants-Montjuïc,11,el Poble-sec,3016,1205,623,582
2019,3,Sants-Montjuïc,11,el Poble-sec,3017,1656,812,844
2019,3,Sants-Montjuïc,11,el Poble-sec,3018,1741,857,884
2019,3,Sants-Montjuïc,11,el Poble-sec,3019,1543,827,716
2019,3,Sants-Montjuïc,11,el Poble-sec,3020,1193,579,614
2019,3,Sants-Montjuïc,11,el Poble-sec,3021,1113,590,523
2019,3,Sants-Montjuïc,11,el Poble-sec,3022,1496,757,739
2019,3,Sants-Montjuïc,11,el Poble-sec,3023,1937,1000,937
2019,3,Sants-Montjuïc,11,el Poble-sec,3024,2102,1059,1043
2019,3,Sants-Montjuïc,12,la Marina del Prat Vermell,3025,1199,576,623
2019,3,Sants-Montjuïc,13,la Marina de Port,3026,986,513,473
2019,3,Sants-Montjuïc,13,la Marina de Port,3027,1768,930,838
2019,3,Sants-Montjuïc,13,la Marina de Port,3028,2668,1397,1271
2019,3,Sants-Montjuïc,13,la Marina de Port,3029,1313,685,628
2019,3,Sants-Montjuïc,13,la Marina de Port,3030,1591,851,740
2019,3,Sants-Montjuïc,13,la Marina de Port,3031,2475,1293,1182
2019,3,Sants-Montjuïc,13,la Marina de Port,3032,1659,852,807
2019,3,Sants-Montjuïc,13,la Marina de Port,3033,1441,717,724
2019,3,Sants-Montjuïc,13,la Marina de Port,3034,1539,793,746
2019,3,Sants-Montjuïc,13,la Marina de Port,3035,2286,1199,1087
2019,3,Sants-Montjuïc,13,la Marina de Port,3036,2345,1235,1110
2019,3,Sants-Montjuïc,13,la Marina de Port,3037,1081,565,516
2019,3,Sants-Montjuïc,13,la Marina de Port,3038,996,531,465
2019,3,Sants-Montjuïc,13,la Marina de Port,3039,2543,1307,1236
2019,3,Sants-Montjuïc,13,la Marina de Port,3211,1518,770,748
2019,3,Sants-Montjuïc,13,la Marina de Port,3212,2445,1293,1152
2019,3,Sants-Montjuïc,13,la Marina de Port,3213,2433,1268,1165
2019,3,Sants-Montjuïc,14,la Font de la Guatlla,3040,1522,805,717
2019,3,Sants-Montjuïc,14,la Font de la Guatlla,3041,1409,749,660
2019,3,Sants-Montjuïc,14,la Font de la Guatlla,3042,1384,717,667
2019,3,Sants-Montjuïc,14,la Font de la Guatlla,3043,1652,895,757
2019,3,Sants-Montjuïc,14,la Font de la Guatlla,3044,1932,992,940
2019,3,Sants-Montjuïc,14,la Font de la Guatlla,3045,1057,539,518
2019,3,Sants-Montjuïc,14,la Font de la Guatlla,3046,1417,766,651
2019,3,Sants-Montjuïc,15,Hostafrancs,3047,1810,946,864
2019,3,Sants-Montjuïc,15,Hostafrancs,3048,1338,695,643
2019,3,Sants-Montjuïc,15,Hostafrancs,3049,1654,873,781
2019,3,Sants-Montjuïc,15,Hostafrancs,3050,1657,868,789
2019,3,Sants-Montjuïc,15,Hostafrancs,3051,1954,969,985
2019,3,Sants-Montjuïc,15,Hostafrancs,3052,1310,682,628
2019,3,Sants-Montjuïc,15,Hostafrancs,3053,2182,1145,1037
2019,3,Sants-Montjuïc,15,Hostafrancs,3054,1763,905,858
2019,3,Sants-Montjuïc,15,Hostafrancs,3055,1603,816,787
2019,3,Sants-Montjuïc,15,Hostafrancs,3056,884,482,402
2019,3,Sants-Montjuïc,16,la Bordeta,3057,1513,809,704
2019,3,Sants-Montjuïc,16,la Bordeta,3058,1594,884,710
2019,3,Sants-Montjuïc,16,la Bordeta,3059,1249,651,598
2019,3,Sants-Montjuïc,16,la Bordeta,3060,1404,699,705
2019,3,Sants-Montjuïc,16,la Bordeta,3061,1146,584,562
2019,3,Sants-Montjuïc,16,la Bordeta,3062,1608,857,751
2019,3,Sants-Montjuïc,16,la Bordeta,3063,1865,966,899
2019,3,Sants-Montjuïc,16,la Bordeta,3064,1251,672,579
2019,3,Sants-Montjuïc,16,la Bordeta,3065,1377,718,659
2019,3,Sants-Montjuïc,16,la Bordeta,3066,2312,1215,1097
2019,3,Sants-Montjuïc,16,la Bordeta,3067,1756,920,836
2019,3,Sants-Montjuïc,16,la Bordeta,3068,1163,617,546
2019,3,Sants-Montjuïc,16,la Bordeta,3069,1205,618,587
2019,3,Sants-Montjuïc,17,Sants - Badal,3070,1281,662,619
2019,3,Sants-Montjuïc,17,Sants - Badal,3071,1283,673,610
2019,3,Sants-Montjuïc,17,Sants - Badal,3072,1384,736,648
2019,3,Sants-Montjuïc,17,Sants - Badal,3073,1612,841,771
2019,3,Sants-Montjuïc,17,Sants - Badal,3074,1797,946,851
2019,3,Sants-Montjuïc,17,Sants - Badal,3075,1723,903,820
2019,3,Sants-Montjuïc,17,Sants - Badal,3076,1055,572,483
2019,3,Sants-Montjuïc,17,Sants - Badal,3077,1307,712,595
2019,3,Sants-Montjuïc,17,Sants - Badal,3078,1712,899,813
2019,3,Sants-Montjuïc,17,Sants - Badal,3079,1826,950,876
2019,3,Sants-Montjuïc,17,Sants - Badal,3080,1586,877,709
2019,3,Sants-Montjuïc,17,Sants - Badal,3081,1809,973,836
2019,3,Sants-Montjuïc,17,Sants - Badal,3082,1941,1036,905
2019,3,Sants-Montjuïc,17,Sants - Badal,3083,1391,752,639
2019,3,Sants-Montjuïc,17,Sants - Badal,3084,1452,788,664
2019,3,Sants-Montjuïc,17,Sants - Badal,3085,1315,702,613
2019,3,Sants-Montjuïc,18,Sants,3086,1220,632,588
2019,3,Sants-Montjuïc,18,Sants,3087,1468,797,671
2019,3,Sants-Montjuïc,18,Sants,3088,1354,727,627
2019,3,Sants-Montjuïc,18,Sants,3089,1268,690,578
2019,3,Sants-Montjuïc,18,Sants,3090,1029,550,479
2019,3,Sants-Montjuïc,18,Sants,3091,1479,767,712
2019,3,Sants-Montjuïc,18,Sants,3092,1232,640,592
2019,3,Sants-Montjuïc,18,Sants,3093,1512,804,708
2019,3,Sants-Montjuïc,18,Sants,3094,1183,636,547
2019,3,Sants-Montjuïc,18,Sants,3095,1633,873,760
2019,3,Sants-Montjuïc,18,Sants,3096,1585,831,754
2019,3,Sants-Montjuïc,18,Sants,3097,1640,856,784
2019,3,Sants-Montjuïc,18,Sants,3098,1393,735,658
2019,3,Sants-Montjuïc,18,Sants,3099,979,519,460
2019,3,Sants-Montjuïc,18,Sants,3100,1292,702,590
2019,3,Sants-Montjuïc,18,Sants,3101,3033,1338,1695
2019,3,Sants-Montjuïc,18,Sants,3102,1354,704,650
2019,3,Sants-Montjuïc,18,Sants,3103,1191,640,551
2019,3,Sants-Montjuïc,18,Sants,3104,1432,763,669
2019,3,Sants-Montjuïc,18,Sants,3105,1147,637,510
2019,3,Sants-Montjuïc,18,Sants,3106,1268,684,584
2019,3,Sants-Montjuïc,18,Sants,3107,1597,799,798
2019,3,Sants-Montjuïc,18,Sants,3108,1605,842,763
2019,3,Sants-Montjuïc,18,Sants,3109,1546,828,718
2019,3,Sants-Montjuïc,18,Sants,3110,1523,811,712
2019,3,Sants-Montjuïc,18,Sants,3111,1295,694,601
2019,3,Sants-Montjuïc,18,Sants,3112,1900,1022,878
2019,3,Sants-Montjuïc,18,Sants,3113,1663,873,790
2019,3,Sants-Montjuïc,18,Sants,3114,1489,802,687
2019,4,Les Corts,19,les Corts,4001,1294,682,612
2019,4,Les Corts,19,les Corts,4002,1977,1048,929
2019,4,Les Corts,19,les Corts,4003,1078,551,527
2019,4,Les Corts,19,les Corts,4004,998,541,457
2019,4,Les Corts,19,les Corts,4005,1213,655,558
2019,4,Les Corts,19,les Corts,4006,1152,627,525
2019,4,Les Corts,19,les Corts,4007,1072,593,479
2019,4,Les Corts,19,les Corts,4008,1029,549,480
2019,4,Les Corts,19,les Corts,4009,1459,794,665
2019,4,Les Corts,19,les Corts,4010,909,494,415
2019,4,Les Corts,19,les Corts,4011,1765,924,841
2019,4,Les Corts,19,les Corts,4012,1442,776,666
2019,4,Les Corts,19,les Corts,4013,1272,686,586
2019,4,Les Corts,19,les Corts,4014,860,462,398
2019,4,Les Corts,19,les Corts,4015,1905,1057,848
2019,4,Les Corts,19,les Corts,4016,1085,587,498
2019,4,Les Corts,19,les Corts,4017,1209,649,560
2019,4,Les Corts,19,les Corts,4018,1570,864,706
2019,4,Les Corts,19,les Corts,4019,1357,723,634
2019,4,Les Corts,19,les Corts,4020,1443,766,677
2019,4,Les Corts,19,les Corts,4021,1317,710,607
2019,4,Les Corts,19,les Corts,4022,1611,837,774
2019,4,Les Corts,19,les Corts,4023,1077,570,507
2019,4,Les Corts,19,les Corts,4024,1060,569,491
2019,4,Les Corts,19,les Corts,4025,1166,631,535
2019,4,Les Corts,19,les Corts,4026,1229,682,547
2019,4,Les Corts,19,les Corts,4027,1317,708,609
2019,4,Les Corts,19,les Corts,4028,1325,716,609
2019,4,Les Corts,19,les Corts,4029,1161,626,535
2019,4,Les Corts,19,les Corts,4030,1831,997,834
2019,4,Les Corts,19,les Corts,4031,1845,926,919
2019,4,Les Corts,19,les Corts,4032,1540,859,681
2019,4,Les Corts,19,les Corts,4033,1150,617,533
2019,4,Les Corts,19,les Corts,4034,1485,766,719
2019,4,Les Corts,19,les Corts,4035,1396,755,641
2019,4,Les Corts,20,la Maternitat i Sant Ramon,4036,1725,939,786
2019,4,Les Corts,20,la Maternitat i Sant Ramon,4037,2144,1178,966
2019,4,Les Corts,20,la Maternitat i Sant Ramon,4038,1288,692,596
2019,4,Les Corts,20,la Maternitat i Sant Ramon,4039,1217,647,570
2019,4,Les Corts,20,la Maternitat i Sant Ramon,4040,1618,834,784
2019,4,Les Corts,20,la Maternitat i Sant Ramon,4041,1353,710,643
2019,4,Les Corts,20,la Maternitat i Sant Ramon,4042,1727,927,800
2019,4,Les Corts,20,la Maternitat i Sant Ramon,4043,1630,904,726
2019,4,Les Corts,20,la Maternitat i Sant Ramon,4044,1585,855,730
2019,4,Les Corts,20,la Maternitat i Sant Ramon,4045,1372,733,639
2019,4,Les Corts,20,la Maternitat i Sant Ramon,4046,2444,1259,1185
2019,4,Les Corts,20,la Maternitat i Sant Ramon,4047,1784,954,830
2019,4,Les Corts,20,la Maternitat i Sant Ramon,4048,1520,827,693
2019,4,Les Corts,20,la Maternitat i Sant Ramon,4049,1184,634,550
2019,4,Les Corts,20,la Maternitat i Sant Ramon,4084,1401,758,643
2019,4,Les Corts,21,Pedralbes,4050,2036,1086,950
2019,4,Les Corts,21,Pedralbes,4051,1671,920,751
2019,4,Les Corts,21,Pedralbes,4052,2197,1203,994
2019,4,Les Corts,21,Pedralbes,4053,1698,876,822
2019,4,Les Corts,21,Pedralbes,4054,1064,567,497
2019,4,Les Corts,21,Pedralbes,4055,1522,777,745
2019,4,Les Corts,21,Pedralbes,4056,1812,947,865
2019,5,Sarrià-Sant Gervasi,22,"Vallvidrera, el Tibidabo i les Planes",5001,1770,864,906
2019,5,Sarrià-Sant Gervasi,22,"Vallvidrera, el Tibidabo i les Planes",5002,1571,802,769
2019,5,Sarrià-Sant Gervasi,22,"Vallvidrera, el Tibidabo i les Planes",5003,1386,703,683
2019,5,Sarrià-Sant Gervasi,23,Sarrià,5004,1137,648,489
2019,5,Sarrià-Sant Gervasi,23,Sarrià,5005,1242,631,611
2019,5,Sarrià-Sant Gervasi,23,Sarrià,5006,1824,917,907
2019,5,Sarrià-Sant Gervasi,23,Sarrià,5007,1805,885,920
2019,5,Sarrià-Sant Gervasi,23,Sarrià,5008,1672,893,779
2019,5,Sarrià-Sant Gervasi,23,Sarrià,5009,1689,924,765
2019,5,Sarrià-Sant Gervasi,23,Sarrià,5010,1565,857,708
2019,5,Sarrià-Sant Gervasi,23,Sarrià,5011,1382,748,634
2019,5,Sarrià-Sant Gervasi,23,Sarrià,5012,1371,741,630
2019,5,Sarrià-Sant Gervasi,23,Sarrià,5013,1673,871,802
2019,5,Sarrià-Sant Gervasi,23,Sarrià,5014,1655,881,774
2019,5,Sarrià-Sant Gervasi,23,Sarrià,5015,1605,878,727
2019,5,Sarrià-Sant Gervasi,23,Sarrià,5016,1934,1044,890
2019,5,Sarrià-Sant Gervasi,23,Sarrià,5017,1596,861,735
2019,5,Sarrià-Sant Gervasi,23,Sarrià,5018,1264,696,568
2019,5,Sarrià-Sant Gervasi,23,Sarrià,5019,1723,930,793
2019,5,Sarrià-Sant Gervasi,24,les Tres Torres,5020,1127,606,521
2019,5,Sarrià-Sant Gervasi,24,les Tres Torres,5021,1328,717,611
2019,5,Sarrià-Sant Gervasi,24,les Tres Torres,5022,1798,1021,777
2019,5,Sarrià-Sant Gervasi,24,les Tres Torres,5023,1494,822,672
2019,5,Sarrià-Sant Gervasi,24,les Tres Torres,5024,1943,1030,913
2019,5,Sarrià-Sant Gervasi,24,les Tres Torres,5025,1292,688,604
2019,5,Sarrià-Sant Gervasi,24,les Tres Torres,5026,1427,747,680
2019,5,Sarrià-Sant Gervasi,24,les Tres Torres,5027,1449,758,691
2019,5,Sarrià-Sant Gervasi,24,les Tres Torres,5028,1700,847,853
2019,5,Sarrià-Sant Gervasi,24,les Tres Torres,5029,1727,899,828
2019,5,Sarrià-Sant Gervasi,24,les Tres Torres,5030,1410,760,650
2019,5,Sarrià-Sant Gervasi,25,Sant Gervasi - la Bonanova,5031,1696,911,785
2019,5,Sarrià-Sant Gervasi,25,Sant Gervasi - la Bonanova,5032,1879,1023,856
2019,5,Sarrià-Sant Gervasi,25,Sant Gervasi - la Bonanova,5033,1401,744,657
2019,5,Sarrià-Sant Gervasi,25,Sant Gervasi - la Bonanova,5034,1284,689,595
2019,5,Sarrià-Sant Gervasi,25,Sant Gervasi - la Bonanova,5035,1078,551,527
2019,5,Sarrià-Sant Gervasi,25,Sant Gervasi - la Bonanova,5036,1763,941,822
2019,5,Sarrià-Sant Gervasi,25,Sant Gervasi - la Bonanova,5037,1453,826,627
2019,5,Sarrià-Sant Gervasi,25,Sant Gervasi - la Bonanova,5038,1354,736,618
2019,5,Sarrià-Sant Gervasi,25,Sant Gervasi - la Bonanova,5039,1527,817,710
2019,5,Sarrià-Sant Gervasi,25,Sant Gervasi - la Bonanova,5040,1429,798,631
2019,5,Sarrià-Sant Gervasi,25,Sant Gervasi - la Bonanova,5041,1895,973,922
2019,5,Sarrià-Sant Gervasi,25,Sant Gervasi - la Bonanova,5042,1311,689,622
2019,5,Sarrià-Sant Gervasi,25,Sant Gervasi - la Bonanova,5043,1466,802,664
2019,5,Sarrià-Sant Gervasi,25,Sant Gervasi - la Bonanova,5044,1295,720,575
2019,5,Sarrià-Sant Gervasi,25,Sant Gervasi - la Bonanova,5045,1607,878,729
2019,5,Sarrià-Sant Gervasi,25,Sant Gervasi - la Bonanova,5046,1127,638,489
2019,5,Sarrià-Sant Gervasi,25,Sant Gervasi - la Bonanova,5047,1257,696,561
2019,5,Sarrià-Sant Gervasi,25,Sant Gervasi - la Bonanova,5048,1286,711,575
2019,5,Sarrià-Sant Gervasi,26,Sant Gervasi - Galvany,5049,1663,926,737
2019,5,Sarrià-Sant Gervasi,26,Sant Gervasi - Galvany,5050,1636,884,752
2019,5,Sarrià-Sant Gervasi,26,Sant Gervasi - Galvany,5051,1653,890,763
2019,5,Sarrià-Sant Gervasi,26,Sant Gervasi - Galvany,5052,1508,826,682
2019,5,Sarrià-Sant Gervasi,26,Sant Gervasi - Galvany,5053,1496,784,712
2019,5,Sarrià-Sant Gervasi,26,Sant Gervasi - Galvany,5054,1055,594,461
2019,5,Sarrià-Sant Gervasi,26,Sant Gervasi - Galvany,5055,1469,797,672
2019,5,Sarrià-Sant Gervasi,26,Sant Gervasi - Galvany,5056,1244,716,528
2019,5,Sarrià-Sant Gervasi,26,Sant Gervasi - Galvany,5057,1685,899,786
2019,5,Sarrià-Sant Gervasi,26,Sant Gervasi - Galvany,5058,1568,847,721
2019,5,Sarrià-Sant Gervasi,26,Sant Gervasi - Galvany,5059,1589,891,698
2019,5,Sarrià-Sant Gervasi,26,Sant Gervasi - Galvany,5060,1153,638,515
2019,5,Sarrià-Sant Gervasi,26,Sant Gervasi - Galvany,5061,1497,839,658
2019,5,Sarrià-Sant Gervasi,26,Sant Gervasi - Galvany,5062,1588,905,683
2019,5,Sarrià-Sant Gervasi,26,Sant Gervasi - Galvany,5063,1591,861,730
2019,5,Sarrià-Sant Gervasi,26,Sant Gervasi - Galvany,5064,1588,892,696
2019,5,Sarrià-Sant Gervasi,26,Sant Gervasi - Galvany,5065,1720,935,785
2019,5,Sarrià-Sant Gervasi,26,Sant Gervasi - Galvany,5066,1305,732,573
2019,5,Sarrià-Sant Gervasi,26,Sant Gervasi - Galvany,5067,1303,720,583
2019,5,Sarrià-Sant Gervasi,26,Sant Gervasi - Galvany,5068,1520,818,702
2019,5,Sarrià-Sant Gervasi,26,Sant Gervasi - Galvany,5069,1767,960,807
2019,5,Sarrià-Sant Gervasi,26,Sant Gervasi - Galvany,5070,1461,821,640
2019,5,Sarrià-Sant Gervasi,26,Sant Gervasi - Galvany,5071,1669,939,730
2019,5,Sarrià-Sant Gervasi,26,Sant Gervasi - Galvany,5072,1742,970,772
2019,5,Sarrià-Sant Gervasi,26,Sant Gervasi - Galvany,5073,1629,897,732
2019,5,Sarrià-Sant Gervasi,26,Sant Gervasi - Galvany,5074,1690,916,774
2019,5,Sarrià-Sant Gervasi,26,Sant Gervasi - Galvany,5075,1855,1035,820
2019,5,Sarrià-Sant Gervasi,26,Sant Gervasi - Galvany,5076,1390,751,639
2019,5,Sarrià-Sant Gervasi,26,Sant Gervasi - Galvany,5077,1511,829,682
2019,5,Sarrià-Sant Gervasi,26,Sant Gervasi - Galvany,5078,2161,1147,1014
2019,5,Sarrià-Sant Gervasi,26,Sant Gervasi - Galvany,5079,1287,697,590
2019,5,Sarrià-Sant Gervasi,27,el Putget i Farró,5080,1405,780,625
2019,5,Sarrià-Sant Gervasi,27,el Putget i Farró,5081,1587,878,709
2019,5,Sarrià-Sant Gervasi,27,el Putget i Farró,5082,1664,913,751
2019,5,Sarrià-Sant Gervasi,27,el Putget i Farró,5083,1297,715,582
2019,5,Sarrià-Sant Gervasi,27,el Putget i Farró,5084,1299,724,575
2019,5,Sarrià-Sant Gervasi,27,el Putget i Farró,5085,1340,718,622
2019,5,Sarrià-Sant Gervasi,27,el Putget i Farró,5086,1299,694,605
2019,5,Sarrià-Sant Gervasi,27,el Putget i Farró,5087,1541,853,688
2019,5,Sarrià-Sant Gervasi,27,el Putget i Farró,5088,1776,919,857
2019,5,Sarrià-Sant Gervasi,27,el Putget i Farró,5089,1727,896,831
2019,5,Sarrià-Sant Gervasi,27,el Putget i Farró,5090,1916,1017,899
2019,5,Sarrià-Sant Gervasi,27,el Putget i Farró,5091,1552,858,694
2019,5,Sarrià-Sant Gervasi,27,el Putget i Farró,5092,1573,838,735
2019,5,Sarrià-Sant Gervasi,27,el Putget i Farró,5093,1125,648,477
2019,5,Sarrià-Sant Gervasi,27,el Putget i Farró,5094,2681,1486,1195
2019,5,Sarrià-Sant Gervasi,27,el Putget i Farró,5095,1663,928,735
2019,5,Sarrià-Sant Gervasi,27,el Putget i Farró,5096,1133,632,501
2019,5,Sarrià-Sant Gervasi,27,el Putget i Farró,5097,1654,868,786
2019,5,Sarrià-Sant Gervasi,27,el Putget i Farró,5098,1554,868,686
2019,6,Gràcia,28,Vallcarca i els Penitents,6001,1226,696,530
2019,6,Gràcia,28,Vallcarca i els Penitents,6002,1498,806,692
2019,6,Gràcia,28,Vallcarca i els Penitents,6003,2302,1184,1118
2019,6,Gràcia,28,Vallcarca i els Penitents,6004,1432,728,704
2019,6,Gràcia,28,Vallcarca i els Penitents,6006,1024,547,477
2019,6,Gràcia,28,Vallcarca i els Penitents,6007,1903,1020,883
2019,6,Gràcia,28,Vallcarca i els Penitents,6008,1978,1096,882
2019,6,Gràcia,28,Vallcarca i els Penitents,6009,1238,663,575
2019,6,Gràcia,28,Vallcarca i els Penitents,6010,1076,576,500
2019,6,Gràcia,28,Vallcarca i els Penitents,6011,1295,684,611
2019,6,Gràcia,28,Vallcarca i els Penitents,6012,1137,603,534
2019,6,Gràcia,29,el Coll,6013,1734,930,804
2019,6,Gràcia,29,el Coll,6014,1389,760,629
2019,6,Gràcia,29,el Coll,6015,1409,744,665
2019,6,Gràcia,29,el Coll,6016,1610,866,744
2019,6,Gràcia,29,el Coll,6017,1376,728,648
2019,6,Gràcia,30,la Salut,6018,1300,669,631
2019,6,Gràcia,30,la Salut,6019,1525,821,704
2019,6,Gràcia,30,la Salut,6020,1168,634,534
2019,6,Gràcia,30,la Salut,6021,1372,737,635
2019,6,Gràcia,30,la Salut,6022,1406,680,726
2019,6,Gràcia,30,la Salut,6023,1335,725,610
2019,6,Gràcia,30,la Salut,6024,1702,951,751
2019,6,Gràcia,30,la Salut,6025,1434,773,661
2019,6,Gràcia,30,la Salut,6026,996,555,441
2019,6,Gràcia,30,la Salut,6027,1193,674,519
2019,6,Gràcia,31,Vila de Gràcia,6028,1328,683,645
2019,6,Gràcia,31,Vila de Gràcia,6029,1285,683,602
2019,6,Gràcia,31,Vila de Gràcia,6030,1316,708,608
2019,6,Gràcia,31,Vila de Gràcia,6031,1108,603,505
2019,6,Gràcia,31,Vila de Gràcia,6032,1200,656,544
2019,6,Gràcia,31,Vila de Gràcia,6033,1294,714,580
2019,6,Gràcia,31,Vila de Gràcia,6034,1258,696,562
2019,6,Gràcia,31,Vila de Gràcia,6035,1042,569,473
2019,6,Gràcia,31,Vila de Gràcia,6036,1500,848,652
2019,6,Gràcia,31,Vila de Gràcia,6037,1122,585,537
2019,6,Gràcia,31,Vila de Gràcia,6038,1476,838,638
2019,6,Gràcia,31,Vila de Gràcia,6039,1632,905,727
2019,6,Gràcia,31,Vila de Gràcia,6040,1646,935,711
2019,6,Gràcia,31,Vila de Gràcia,6041,1808,1005,803
2019,6,Gràcia,31,Vila de Gràcia,6042,1780,951,829
2019,6,Gràcia,31,Vila de Gràcia,6043,1283,690,593
2019,6,Gràcia,31,Vila de Gràcia,6044,1575,837,738
2019,6,Gràcia,31,Vila de Gràcia,6045,1300,719,581
2019,6,Gràcia,31,Vila de Gràcia,6046,1180,622,558
2019,6,Gràcia,31,Vila de Gràcia,6047,1284,721,563
2019,6,Gràcia,31,Vila de Gràcia,6048,1394,748,646
2019,6,Gràcia,31,Vila de Gràcia,6049,1188,641,547
2019,6,Gràcia,31,Vila de Gràcia,6050,1283,685,598
2019,6,Gràcia,31,Vila de Gràcia,6051,1261,718,543
2019,6,Gràcia,31,Vila de Gràcia,6052,1543,845,698
2019,6,Gràcia,31,Vila de Gràcia,6053,1525,837,688
2019,6,Gràcia,31,Vila de Gràcia,6054,1606,855,751
2019,6,Gràcia,31,Vila de Gràcia,6055,1457,817,640
2019,6,Gràcia,31,Vila de Gràcia,6056,1553,845,708
2019,6,Gràcia,31,Vila de Gràcia,6057,1516,853,663
2019,6,Gràcia,31,Vila de Gràcia,6058,1685,938,747
2019,6,Gràcia,31,Vila de Gràcia,6059,1521,808,713
2019,6,Gràcia,31,Vila de Gràcia,6060,1771,955,816
2019,6,Gràcia,31,Vila de Gràcia,6061,1316,698,618
2019,6,Gràcia,31,Vila de Gràcia,6062,1250,678,572
2019,6,Gràcia,31,Vila de Gràcia,6063,1517,801,716
2019,6,Gràcia,32,el Camp d'en Grassot i Gràcia Nova,6064,1888,1032,856
2019,6,Gràcia,32,el Camp d'en Grassot i Gràcia Nova,6065,1196,654,542
2019,6,Gràcia,32,el Camp d'en Grassot i Gràcia Nova,6066,990,567,423
2019,6,Gràcia,32,el Camp d'en Grassot i Gràcia Nova,6067,1799,986,813
2019,6,Gràcia,32,el Camp d'en Grassot i Gràcia Nova,6068,1592,874,718
2019,6,Gràcia,32,el Camp d'en Grassot i Gràcia Nova,6069,1073,589,484
2019,6,Gràcia,32,el Camp d'en Grassot i Gràcia Nova,6070,1874,1036,838
2019,6,Gràcia,32,el Camp d'en Grassot i Gràcia Nova,6071,1088,589,499
2019,6,Gràcia,32,el Camp d'en Grassot i Gràcia Nova,6072,1614,872,742
2019,6,Gràcia,32,el Camp d'en Grassot i Gràcia Nova,6073,1357,736,621
2019,6,Gràcia,32,el Camp d'en Grassot i Gràcia Nova,6074,1120,586,534
2019,6,Gràcia,32,el Camp d'en Grassot i Gràcia Nova,6075,1078,576,502
2019,6,Gràcia,32,el Camp d'en Grassot i Gràcia Nova,6076,1333,671,662
2019,6,Gràcia,32,el Camp d'en Grassot i Gràcia Nova,6077,1208,687,521
2019,6,Gràcia,32,el Camp d'en Grassot i Gràcia Nova,6078,1359,726,633
2019,6,Gràcia,32,el Camp d'en Grassot i Gràcia Nova,6079,1116,604,512
2019,6,Gràcia,32,el Camp d'en Grassot i Gràcia Nova,6080,1190,635,555
2019,6,Gràcia,32,el Camp d'en Grassot i Gràcia Nova,6081,1327,730,597
2019,6,Gràcia,32,el Camp d'en Grassot i Gràcia Nova,6082,2426,1252,1174
2019,6,Gràcia,32,el Camp d'en Grassot i Gràcia Nova,6083,1733,906,827
2019,6,Gràcia,32,el Camp d'en Grassot i Gràcia Nova,6084,1499,816,683
2019,6,Gràcia,32,el Camp d'en Grassot i Gràcia Nova,6085,1257,692,565
2019,6,Gràcia,32,el Camp d'en Grassot i Gràcia Nova,6086,1004,524,480
2019,6,Gràcia,32,el Camp d'en Grassot i Gràcia Nova,6087,1824,980,844
2019,6,Gràcia,32,el Camp d'en Grassot i Gràcia Nova,6088,1254,696,558
2019,7,Horta-Guinardó,33,el Baix Guinardó,7001,1583,879,704
2019,7,Horta-Guinardó,33,el Baix Guinardó,7002,1154,636,518
2019,7,Horta-Guinardó,33,el Baix Guinardó,7003,1343,720,623
2019,7,Horta-Guinardó,33,el Baix Guinardó,7004,1548,827,721
2019,7,Horta-Guinardó,33,el Baix Guinardó,7005,1495,782,713
2019,7,Horta-Guinardó,33,el Baix Guinardó,7006,963,504,459
2019,7,Horta-Guinardó,33,el Baix Guinardó,7007,1429,787,642
2019,7,Horta-Guinardó,33,el Baix Guinardó,7008,1478,797,681
2019,7,Horta-Guinardó,33,el Baix Guinardó,7009,1173,652,521
2019,7,Horta-Guinardó,33,el Baix Guinardó,7010,1322,696,626
2019,7,Horta-Guinardó,33,el Baix Guinardó,7011,1167,641,526
2019,7,Horta-Guinardó,33,el Baix Guinardó,7012,1577,850,727
2019,7,Horta-Guinardó,33,el Baix Guinardó,7013,1238,658,580
2019,7,Horta-Guinardó,33,el Baix Guinardó,7014,891,485,406
2019,7,Horta-Guinardó,33,el Baix Guinardó,7015,1352,709,643
2019,7,Horta-Guinardó,33,el Baix Guinardó,7016,1373,708,665
2019,7,Horta-Guinardó,33,el Baix Guinardó,7017,1739,953,786
2019,7,Horta-Guinardó,33,el Baix Guinardó,7018,1704,940,764
2019,7,Horta-Guinardó,33,el Baix Guinardó,7019,1461,782,679
2019,7,Horta-Guinardó,34,Can Baró,7020,1728,925,803
2019,7,Horta-Guinardó,34,Can Baró,7021,1040,537,503
2019,7,Horta-Guinardó,34,Can Baró,7022,1149,609,540
2019,7,Horta-Guinardó,34,Can Baró,7023,1320,680,640
2019,7,Horta-Guinardó,34,Can Baró,7024,1467,783,684
2019,7,Horta-Guinardó,34,Can Baró,7025,1440,765,675
2019,7,Horta-Guinardó,34,Can Baró,7026,1103,594,509
2019,7,Horta-Guinardó,35,el Guinardó,7027,2113,1132,981
2019,7,Horta-Guinardó,35,el Guinardó,7028,1496,769,727
2019,7,Horta-Guinardó,35,el Guinardó,7029,1293,658,635
2019,7,Horta-Guinardó,35,el Guinardó,7030,1413,778,635
2019,7,Horta-Guinardó,35,el Guinardó,7031,1566,797,769
2019,7,Horta-Guinardó,35,el Guinardó,7032,1441,731,710
2019,7,Horta-Guinardó,35,el Guinardó,7033,1450,785,665
2019,7,Horta-Guinardó,35,el Guinardó,7034,1889,995,894
2019,7,Horta-Guinardó,35,el Guinardó,7035,1772,957,815
2019,7,Horta-Guinardó,35,el Guinardó,7036,1397,764,633
2019,7,Horta-Guinardó,35,el Guinardó,7037,1492,815,677
2019,7,Horta-Guinardó,35,el Guinardó,7038,1279,684,595
2019,7,Horta-Guinardó,35,el Guinardó,7039,1591,845,746
2019,7,Horta-Guinardó,35,el Guinardó,7040,1446,783,663
2019,7,Horta-Guinardó,35,el Guinardó,7041,1387,747,640
2019,7,Horta-Guinardó,35,el Guinardó,7042,1531,835,696
2019,7,Horta-Guinardó,35,el Guinardó,7043,1419,764,655
2019,7,Horta-Guinardó,35,el Guinardó,7044,1306,690,616
2019,7,Horta-Guinardó,35,el Guinardó,7045,1554,808,746
2019,7,Horta-Guinardó,35,el Guinardó,7046,1396,737,659
2019,7,Horta-Guinardó,35,el Guinardó,7047,1507,785,722
2019,7,Horta-Guinardó,35,el Guinardó,7048,1298,713,585
2019,7,Horta-Guinardó,35,el Guinardó,7049,1204,619,585
2019,7,Horta-Guinardó,35,el Guinardó,7050,1196,626,570
2019,7,Horta-Guinardó,35,el Guinardó,7051,1780,967,813
2019,7,Horta-Guinardó,36,la Font d'en Fargues,7052,1242,651,591
2019,7,Horta-Guinardó,36,la Font d'en Fargues,7053,1487,794,693
2019,7,Horta-Guinardó,36,la Font d'en Fargues,7054,1593,857,736
2019,7,Horta-Guinardó,36,la Font d'en Fargues,7055,1188,640,548
2019,7,Horta-Guinardó,36,la Font d'en Fargues,7056,1179,603,576
2019,7,Horta-Guinardó,36,la Font d'en Fargues,7057,1447,764,683
2019,7,Horta-Guinardó,36,la Font d'en Fargues,7058,1370,703,667
2019,7,Horta-Guinardó,37,el Carmel,7059,1313,692,621
2019,7,Horta-Guinardó,37,el Carmel,7060,1869,963,906
2019,7,Horta-Guinardó,37,el Carmel,7061,1225,615,610
2019,7,Horta-Guinardó,37,el Carmel,7062,1341,710,631
2019,7,Horta-Guinardó,37,el Carmel,7063,1470,770,700
2019,7,Horta-Guinardó,37,el Carmel,7064,1654,864,790
2019,7,Horta-Guinardó,37,el Carmel,7065,1693,891,802
2019,7,Horta-Guinardó,37,el Carmel,7066,1824,955,869
2019,7,Horta-Guinardó,37,el Carmel,7067,1524,820,704
2019,7,Horta-Guinardó,37,el Carmel,7068,1279,687,592
2019,7,Horta-Guinardó,37,el Carmel,7069,1384,715,669
2019,7,Horta-Guinardó,37,el Carmel,7070,1464,769,695
2019,7,Horta-Guinardó,37,el Carmel,7071,1356,724,632
2019,7,Horta-Guinardó,37,el Carmel,7072,1392,735,657
2019,7,Horta-Guinardó,37,el Carmel,7073,1149,643,506
2019,7,Horta-Guinardó,37,el Carmel,7074,1730,919,811
2019,7,Horta-Guinardó,37,el Carmel,7075,1187,615,572
2019,7,Horta-Guinardó,37,el Carmel,7076,1350,700,650
2019,7,Horta-Guinardó,37,el Carmel,7077,1349,699,650
2019,7,Horta-Guinardó,37,el Carmel,7078,1390,716,674
2019,7,Horta-Guinardó,37,el Carmel,7079,1399,725,674
2019,7,Horta-Guinardó,37,el Carmel,7080,1833,969,864
2019,7,Horta-Guinardó,38,la Teixonera,7081,1968,1019,949
2019,7,Horta-Guinardó,38,la Teixonera,7082,1294,671,623
2019,7,Horta-Guinardó,38,la Teixonera,7083,1294,683,611
2019,7,Horta-Guinardó,38,la Teixonera,7084,1304,676,628
2019,7,Horta-Guinardó,38,la Teixonera,7085,1281,661,620
2019,7,Horta-Guinardó,38,la Teixonera,7086,1408,724,684
2019,7,Horta-Guinardó,38,la Teixonera,7087,1616,856,760
2019,7,Horta-Guinardó,38,la Teixonera,7088,1624,836,788
2019,7,Horta-Guinardó,39,Sant Genís dels Agudells,7089,1363,758,605
2019,7,Horta-Guinardó,39,Sant Genís dels Agudells,7090,1435,742,693
2019,7,Horta-Guinardó,39,Sant Genís dels Agudells,7091,1199,648,551
2019,7,Horta-Guinardó,39,Sant Genís dels Agudells,7092,1484,823,661
2019,7,Horta-Guinardó,39,Sant Genís dels Agudells,7093,1765,880,885
2019,7,Horta-Guinardó,40,Montbau,7094,1215,666,549
2019,7,Horta-Guinardó,40,Montbau,7095,1572,839,733
2019,7,Horta-Guinardó,40,Montbau,7096,1413,782,631
2019,7,Horta-Guinardó,40,Montbau,7097,926,526,400
2019,7,Horta-Guinardó,41,la Vall d'Hebron,7098,2138,1150,988
2019,7,Horta-Guinardó,41,la Vall d'Hebron,7099,1050,535,515
2019,7,Horta-Guinardó,41,la Vall d'Hebron,7100,1196,637,559
2019,7,Horta-Guinardó,41,la Vall d'Hebron,7101,1419,740,679
2019,7,Horta-Guinardó,42,la Clota,7102,686,331,355
2019,7,Horta-Guinardó,43,Horta,7103,1611,867,744
2019,7,Horta-Guinardó,43,Horta,7104,1600,864,736
2019,7,Horta-Guinardó,43,Horta,7105,1080,563,517
2019,7,Horta-Guinardó,43,Horta,7106,1193,653,540
2019,7,Horta-Guinardó,43,Horta,7107,1222,631,591
2019,7,Horta-Guinardó,43,Horta,7108,1227,647,580
2019,7,Horta-Guinardó,43,Horta,7109,1596,827,769
2019,7,Horta-Guinardó,43,Horta,7110,1036,585,451
2019,7,Horta-Guinardó,43,Horta,7111,898,500,398
2019,7,Horta-Guinardó,43,Horta,7112,1269,663,606
2019,7,Horta-Guinardó,43,Horta,7113,1209,628,581
2019,7,Horta-Guinardó,43,Horta,7114,1200,636,564
2019,7,Horta-Guinardó,43,Horta,7115,1067,573,494
2019,7,Horta-Guinardó,43,Horta,7116,1522,817,705
2019,7,Horta-Guinardó,43,Horta,7117,2077,1033,1044
2019,7,Horta-Guinardó,43,Horta,7118,1274,710,564
2019,7,Horta-Guinardó,43,Horta,7119,1228,667,561
2019,7,Horta-Guinardó,43,Horta,7120,1236,666,570
2019,7,Horta-Guinardó,43,Horta,7121,1177,656,521
2019,7,Horta-Guinardó,43,Horta,7122,1327,728,599
2019,7,Horta-Guinardó,43,Horta,7123,1433,741,692
2019,8,Nou Barris,44,Vilapicina i la Torre Llobeta,8001,1249,660,589
2019,8,Nou Barris,44,Vilapicina i la Torre Llobeta,8002,1261,666,595
2019,8,Nou Barris,44,Vilapicina i la Torre Llobeta,8003,1264,660,604
2019,8,Nou Barris,44,Vilapicina i la Torre Llobeta,8004,1440,784,656
2019,8,Nou Barris,44,Vilapicina i la Torre Llobeta,8005,1184,631,553
2019,8,Nou Barris,44,Vilapicina i la Torre Llobeta,8006,1529,804,725
2019,8,Nou Barris,44,Vilapicina i la Torre Llobeta,8007,1229,702,527
2019,8,Nou Barris,44,Vilapicina i la Torre Llobeta,8008,1621,862,759
2019,8,Nou Barris,44,Vilapicina i la Torre Llobeta,8009,1763,923,840
2019,8,Nou Barris,44,Vilapicina i la Torre Llobeta,8010,1080,592,488
2019,8,Nou Barris,44,Vilapicina i la Torre Llobeta,8011,1198,660,538
2019,8,Nou Barris,44,Vilapicina i la Torre Llobeta,8012,1334,752,582
2019,8,Nou Barris,44,Vilapicina i la Torre Llobeta,8013,1196,645,551
2019,8,Nou Barris,44,Vilapicina i la Torre Llobeta,8014,1267,676,591
2019,8,Nou Barris,44,Vilapicina i la Torre Llobeta,8015,1433,807,626
2019,8,Nou Barris,44,Vilapicina i la Torre Llobeta,8016,1152,636,516
2019,8,Nou Barris,44,Vilapicina i la Torre Llobeta,8017,1331,701,630
2019,8,Nou Barris,44,Vilapicina i la Torre Llobeta,8018,1575,848,727
2019,8,Nou Barris,44,Vilapicina i la Torre Llobeta,8019,1789,969,820
2019,8,Nou Barris,45,Porta,8020,1377,747,630
2019,8,Nou Barris,45,Porta,8021,1506,817,689
2019,8,Nou Barris,45,Porta,8022,1253,681,572
2019,8,Nou Barris,45,Porta,8023,1418,742,676
2019,8,Nou Barris,45,Porta,8024,1396,751,645
2019,8,Nou Barris,45,Porta,8025,1232,697,535
2019,8,Nou Barris,45,Porta,8026,1426,767,659
2019,8,Nou Barris,45,Porta,8027,1412,722,690
2019,8,Nou Barris,45,Porta,8028,1085,599,486
2019,8,Nou Barris,45,Porta,8029,1540,823,717
2019,8,Nou Barris,45,Porta,8030,1531,812,719
2019,8,Nou Barris,45,Porta,8031,1315,698,617
2019,8,Nou Barris,45,Porta,8032,1298,711,587
2019,8,Nou Barris,45,Porta,8033,1458,774,684
2019,8,Nou Barris,45,Porta,8034,1245,716,529
2019,8,Nou Barris,45,Porta,8035,2973,1468,1505
2019,8,Nou Barris,45,Porta,8036,1531,825,706
2019,8,Nou Barris,45,Porta,8037,1561,864,697
2019,8,Nou Barris,46,el Turó de la Peira,8038,1533,849,684
2019,8,Nou Barris,46,el Turó de la Peira,8039,1517,817,700
2019,8,Nou Barris,46,el Turó de la Peira,8040,1757,922,835
2019,8,Nou Barris,46,el Turó de la Peira,8041,2448,1282,1166
2019,8,Nou Barris,46,el Turó de la Peira,8042,1283,694,589
2019,8,Nou Barris,46,el Turó de la Peira,8043,1133,645,488
2019,8,Nou Barris,46,el Turó de la Peira,8044,1384,743,641
2019,8,Nou Barris,46,el Turó de la Peira,8045,1759,912,847
2019,8,Nou Barris,46,el Turó de la Peira,8046,1374,763,611
2019,8,Nou Barris,46,el Turó de la Peira,8047,1595,856,739
2019,8,Nou Barris,47,Can Peguera,8048,1007,527,480
2019,8,Nou Barris,47,Can Peguera,8049,1282,682,600
2019,8,Nou Barris,48,la Guineueta,8050,1441,776,665
2019,8,Nou Barris,48,la Guineueta,8051,1380,723,657
2019,8,Nou Barris,48,la Guineueta,8052,888,487,401
2019,8,Nou Barris,48,la Guineueta,8053,1157,616,541
2019,8,Nou Barris,48,la Guineueta,8054,1696,932,764
2019,8,Nou Barris,48,la Guineueta,8055,1854,982,872
2019,8,Nou Barris,48,la Guineueta,8056,1505,805,700
2019,8,Nou Barris,48,la Guineueta,8057,1332,718,614
2019,8,Nou Barris,48,la Guineueta,8058,1631,893,738
2019,8,Nou Barris,48,la Guineueta,8059,994,534,460
2019,8,Nou Barris,48,la Guineueta,8215,1520,861,659
2019,8,Nou Barris,49,Canyelles,8060,1189,639,550
2019,8,Nou Barris,49,Canyelles,8061,1630,832,798
2019,8,Nou Barris,49,Canyelles,8062,1165,618,547
2019,8,Nou Barris,49,Canyelles,8063,1098,569,529
2019,8,Nou Barris,49,Canyelles,8064,1802,956,846
2019,8,Nou Barris,50,les Roquetes,8065,1751,853,898
2019,8,Nou Barris,50,les Roquetes,8066,1622,831,791
2019,8,Nou Barris,50,les Roquetes,8067,1782,904,878
2019,8,Nou Barris,50,les Roquetes,8068,1949,1038,911
2019,8,Nou Barris,50,les Roquetes,8069,1523,797,726
2019,8,Nou Barris,50,les Roquetes,8070,1498,816,682
2019,8,Nou Barris,50,les Roquetes,8071,1698,867,831
2019,8,Nou Barris,50,les Roquetes,8072,1213,643,570
2019,8,Nou Barris,50,les Roquetes,8073,1690,899,791
2019,8,Nou Barris,50,les Roquetes,8074,1503,778,725
2019,8,Nou Barris,51,Verdun,8075,1909,1024,885
2019,8,Nou Barris,51,Verdun,8076,1574,854,720
2019,8,Nou Barris,51,Verdun,8077,1390,749,641
2019,8,Nou Barris,51,Verdun,8078,1552,824,728
2019,8,Nou Barris,51,Verdun,8079,1427,759,668
2019,8,Nou Barris,51,Verdun,8080,1487,772,715
2019,8,Nou Barris,51,Verdun,8081,1667,865,802
2019,8,Nou Barris,51,Verdun,8082,1572,866,706
2019,8,Nou Barris,52,la Prosperitat,8083,1286,700,586
2019,8,Nou Barris,52,la Prosperitat,8084,1172,635,537
2019,8,Nou Barris,52,la Prosperitat,8085,1472,752,720
2019,8,Nou Barris,52,la Prosperitat,8086,1705,907,798
2019,8,Nou Barris,52,la Prosperitat,8087,1240,661,579
2019,8,Nou Barris,52,la Prosperitat,8088,1285,686,599
2019,8,Nou Barris,52,la Prosperitat,8089,1265,677,588
2019,8,Nou Barris,52,la Prosperitat,8090,1235,665,570
2019,8,Nou Barris,52,la Prosperitat,8091,1227,642,585
2019,8,Nou Barris,52,la Prosperitat,8092,991,513,478
2019,8,Nou Barris,52,la Prosperitat,8093,1293,658,635
2019,8,Nou Barris,52,la Prosperitat,8094,1471,777,694
2019,8,Nou Barris,52,la Prosperitat,8095,1071,560,511
2019,8,Nou Barris,52,la Prosperitat,8096,1531,791,740
2019,8,Nou Barris,52,la Prosperitat,8097,1371,716,655
2019,8,Nou Barris,52,la Prosperitat,8098,1291,679,612
2019,8,Nou Barris,52,la Prosperitat,8099,1389,701,688
2019,8,Nou Barris,52,la Prosperitat,8100,1279,712,567
2019,8,Nou Barris,52,la Prosperitat,8101,1749,941,808
2019,8,Nou Barris,52,la Prosperitat,8102,1532,856,676
2019,8,Nou Barris,53,la Trinitat Nova,8103,1691,851,840
2019,8,Nou Barris,53,la Trinitat Nova,8104,1306,686,620
2019,8,Nou Barris,53,la Trinitat Nova,8105,1507,793,714
2019,8,Nou Barris,53,la Trinitat Nova,8106,1268,659,609
2019,8,Nou Barris,53,la Trinitat Nova,8107,1848,979,869
2019,8,Nou Barris,54,Torre Baró,8108,1939,975,964
2019,8,Nou Barris,54,Torre Baró,8109,992,482,510
2019,8,Nou Barris,55,Ciutat Meridiana,8110,1944,983,961
2019,8,Nou Barris,55,Ciutat Meridiana,8111,1699,894,805
2019,8,Nou Barris,55,Ciutat Meridiana,8112,1763,896,867
2019,8,Nou Barris,55,Ciutat Meridiana,8113,1817,929,888
2019,8,Nou Barris,55,Ciutat Meridiana,8114,1923,978,945
2019,8,Nou Barris,55,Ciutat Meridiana,8115,1718,897,821
2019,8,Nou Barris,56,Vallbona,8116,1407,724,683
2019,9,Sant Andreu,57,la Trinitat Vella,9001,2662,1263,1399
2019,9,Sant Andreu,57,la Trinitat Vella,9002,2168,1060,1108
2019,9,Sant Andreu,57,la Trinitat Vella,9003,2205,1067,1138
2019,9,Sant Andreu,57,la Trinitat Vella,9004,1684,852,832
2019,9,Sant Andreu,57,la Trinitat Vella,9005,1618,818,800
2019,9,Sant Andreu,58,Baró de Viver,9006,1277,640,637
2019,9,Sant Andreu,58,Baró de Viver,9007,1327,699,628
2019,9,Sant Andreu,59,el Bon Pastor,9008,1907,938,969
2019,9,Sant Andreu,59,el Bon Pastor,9009,1441,741,700
2019,9,Sant Andreu,59,el Bon Pastor,9010,1814,944,870
2019,9,Sant Andreu,59,el Bon Pastor,9011,1750,905,845
2019,9,Sant Andreu,59,el Bon Pastor,9013,1957,1033,924
2019,9,Sant Andreu,59,el Bon Pastor,9014,2416,1160,1256
2019,9,Sant Andreu,59,el Bon Pastor,9015,1841,939,902
2019,9,Sant Andreu,60,Sant Andreu,9016,1368,733,635
2019,9,Sant Andreu,60,Sant Andreu,9017,1541,796,745
2019,9,Sant Andreu,60,Sant Andreu,9018,1468,762,706
2019,9,Sant Andreu,60,Sant Andreu,9019,2667,1354,1313
2019,9,Sant Andreu,60,Sant Andreu,9020,1140,626,514
2019,9,Sant Andreu,60,Sant Andreu,9021,1415,745,670
2019,9,Sant Andreu,60,Sant Andreu,9022,1254,652,602
2019,9,Sant Andreu,60,Sant Andreu,9023,1219,622,597
2019,9,Sant Andreu,60,Sant Andreu,9024,1156,642,514
2019,9,Sant Andreu,60,Sant Andreu,9025,1224,662,562
2019,9,Sant Andreu,60,Sant Andreu,9026,1572,822,750
2019,9,Sant Andreu,60,Sant Andreu,9027,1292,669,623
2019,9,Sant Andreu,60,Sant Andreu,9028,1619,826,793
2019,9,Sant Andreu,60,Sant Andreu,9029,1131,587,544
2019,9,Sant Andreu,60,Sant Andreu,9030,1492,791,701
2019,9,Sant Andreu,60,Sant Andreu,9031,1186,612,574
2019,9,Sant Andreu,60,Sant Andreu,9032,2206,1171,1035
2019,9,Sant Andreu,60,Sant Andreu,9033,3204,1646,1558
2019,9,Sant Andreu,60,Sant Andreu,9034,1428,767,661
2019,9,Sant Andreu,60,Sant Andreu,9035,1520,807,713
2019,9,Sant Andreu,60,Sant Andreu,9036,1390,750,640
2019,9,Sant Andreu,60,Sant Andreu,9037,1477,768,709
2019,9,Sant Andreu,60,Sant Andreu,9038,1658,892,766
2019,9,Sant Andreu,60,Sant Andreu,9039,1541,804,737
2019,9,Sant Andreu,60,Sant Andreu,9040,1577,848,729
2019,9,Sant Andreu,60,Sant Andreu,9041,1405,769,636
2019,9,Sant Andreu,60,Sant Andreu,9042,1246,673,573
2019,9,Sant Andreu,60,Sant Andreu,9043,1329,718,611
2019,9,Sant Andreu,60,Sant Andreu,9044,1463,752,711
2019,9,Sant Andreu,60,Sant Andreu,9045,1453,775,678
2019,9,Sant Andreu,60,Sant Andreu,9046,1325,692,633
2019,9,Sant Andreu,60,Sant Andreu,9047,1574,829,745
2019,9,Sant Andreu,60,Sant Andreu,9048,1397,741,656
2019,9,Sant Andreu,60,Sant Andreu,9049,1306,716,590
2019,9,Sant Andreu,60,Sant Andreu,9050,1594,832,762
2019,9,Sant Andreu,60,Sant Andreu,9051,1228,639,589
2019,9,Sant Andreu,60,Sant Andreu,9052,1183,629,554
2019,9,Sant Andreu,60,Sant Andreu,9053,1589,857,732
2019,9,Sant Andreu,60,Sant Andreu,9054,1124,606,518
2019,9,Sant Andreu,61,la Sagrera,9055,1739,927,812
2019,9,Sant Andreu,61,la Sagrera,9056,1148,619,529
2019,9,Sant Andreu,61,la Sagrera,9057,1599,831,768
2019,9,Sant Andreu,61,la Sagrera,9058,1511,822,689
2019,9,Sant Andreu,61,la Sagrera,9059,1450,741,709
2019,9,Sant Andreu,61,la Sagrera,9060,1324,721,603
2019,9,Sant Andreu,61,la Sagrera,9061,1702,891,811
2019,9,Sant Andreu,61,la Sagrera,9062,1165,603,562
2019,9,Sant Andreu,61,la Sagrera,9063,1155,595,560
2019,9,Sant Andreu,61,la Sagrera,9064,1210,634,576
2019,9,Sant Andreu,61,la Sagrera,9065,2105,1132,973
2019,9,Sant Andreu,61,la Sagrera,9066,1447,745,702
2019,9,Sant Andreu,61,la Sagrera,9067,1497,820,677
2019,9,Sant Andreu,61,la Sagrera,9068,1567,795,772
2019,9,Sant Andreu,61,la Sagrera,9069,916,513,403
2019,9,Sant Andreu,61,la Sagrera,9070,1715,960,755
2019,9,Sant Andreu,61,la Sagrera,9071,1905,1038,867
2019,9,Sant Andreu,61,la Sagrera,9072,1521,827,694
2019,9,Sant Andreu,61,la Sagrera,9073,1547,811,736
2019,9,Sant Andreu,61,la Sagrera,9156,1266,663,603
2019,9,Sant Andreu,62,el Congrés i els Indians,9074,1632,877,755
2019,9,Sant Andreu,62,el Congrés i els Indians,9075,1576,824,752
2019,9,Sant Andreu,62,el Congrés i els Indians,9076,1463,800,663
2019,9,Sant Andreu,62,el Congrés i els Indians,9077,1609,893,716
2019,9,Sant Andreu,62,el Congrés i els Indians,9078,1496,801,695
2019,9,Sant Andreu,62,el Congrés i els Indians,9079,1644,878,766
2019,9,Sant Andreu,62,el Congrés i els Indians,9080,1363,693,670
2019,9,Sant Andreu,62,el Congrés i els Indians,9081,1755,964,791
2019,9,Sant Andreu,62,el Congrés i els Indians,9082,2019,1071,948
2019,9,Sant Andreu,63,Navas,9083,1616,869,747
2019,9,Sant Andreu,63,Navas,9084,1777,914,863
2019,9,Sant Andreu,63,Navas,9085,1734,931,803
2019,9,Sant Andreu,63,Navas,9086,1448,780,668
2019,9,Sant Andreu,63,Navas,9087,1316,695,621
2019,9,Sant Andreu,63,Navas,9088,1929,1072,857
2019,9,Sant Andreu,63,Navas,9089,1500,821,679
2019,9,Sant Andreu,63,Navas,9090,1617,867,750
2019,9,Sant Andreu,63,Navas,9091,1882,990,892
2019,9,Sant Andreu,63,Navas,9092,1964,1029,935
2019,9,Sant Andreu,63,Navas,9093,1338,711,627
2019,9,Sant Andreu,63,Navas,9094,2074,1073,1001
2019,9,Sant Andreu,63,Navas,9095,2084,1099,985
2019,10,Sant Martí,64,Camp de l'Arpa del Clot,10001,1613,833,780
2019,10,Sant Martí,64,Camp de l'Arpa del Clot,10002,1798,916,882
2019,10,Sant Martí,64,Camp de l'Arpa del Clot,10003,1596,832,764
2019,10,Sant Martí,64,Camp de l'Arpa del Clot,10004,1569,846,723
2019,10,Sant Martí,64,Camp de l'Arpa del Clot,10005,1676,914,762
2019,10,Sant Martí,64,Camp de l'Arpa del Clot,10006,1805,964,841
2019,10,Sant Martí,64,Camp de l'Arpa del Clot,10007,1312,680,632
2019,10,Sant Martí,64,Camp de l'Arpa del Clot,10008,1717,938,779
2019,10,Sant Martí,64,Camp de l'Arpa del Clot,10009,1579,859,720
2019,10,Sant Martí,64,Camp de l'Arpa del Clot,10010,1746,936,810
2019,10,Sant Martí,64,Camp de l'Arpa del Clot,10011,1203,651,552
2019,10,Sant Martí,64,Camp de l'Arpa del Clot,10012,1835,982,853
2019,10,Sant Martí,64,Camp de l'Arpa del Clot,10013,1442,788,654
2019,10,Sant Martí,64,Camp de l'Arpa del Clot,10014,1463,771,692
2019,10,Sant Martí,64,Camp de l'Arpa del Clot,10015,1895,983,912
2019,10,Sant Martí,64,Camp de l'Arpa del Clot,10016,1270,650,620
2019,10,Sant Martí,64,Camp de l'Arpa del Clot,10017,1721,920,801
2019,10,Sant Martí,64,Camp de l'Arpa del Clot,10018,1463,765,698
2019,10,Sant Martí,64,Camp de l'Arpa del Clot,10019,1619,848,771
2019,10,Sant Martí,64,Camp de l'Arpa del Clot,10020,1489,780,709
2019,10,Sant Martí,64,Camp de l'Arpa del Clot,10021,1380,717,663
2019,10,Sant Martí,64,Camp de l'Arpa del Clot,10022,1355,741,614
2019,10,Sant Martí,64,Camp de l'Arpa del Clot,10023,1493,815,678
2019,10,Sant Martí,64,Camp de l'Arpa del Clot,10024,1504,781,723
2019,10,Sant Martí,64,Camp de l'Arpa del Clot,10025,1369,749,620
2019,10,Sant Martí,65,el Clot,10026,1541,807,734
2019,10,Sant Martí,65,el Clot,10027,1515,792,723
2019,10,Sant Martí,65,el Clot,10028,1853,971,882
2019,10,Sant Martí,65,el Clot,10029,1509,798,711
2019,10,Sant Martí,65,el Clot,10030,1790,949,841
2019,10,Sant Martí,65,el Clot,10031,1590,807,783
2019,10,Sant Martí,65,el Clot,10032,1424,738,686
2019,10,Sant Martí,65,el Clot,10033,886,489,397
2019,10,Sant Martí,65,el Clot,10034,1705,882,823
2019,10,Sant Martí,65,el Clot,10035,2005,1025,980
2019,10,Sant Martí,65,el Clot,10036,1455,718,737
2019,10,Sant Martí,65,el Clot,10037,1087,573,514
2019,10,Sant Martí,65,el Clot,10038,1629,858,771
2019,10,Sant Martí,65,el Clot,10039,1842,976,866
2019,10,Sant Martí,65,el Clot,10040,1848,950,898
2019,10,Sant Martí,65,el Clot,10041,1654,846,808
2019,10,Sant Martí,65,el Clot,10234,1850,999,851
2019,10,Sant Martí,66,el Parc i la Llacuna del Poblenou,10042,2850,1499,1351
2019,10,Sant Martí,66,el Parc i la Llacuna del Poblenou,10043,2284,1127,1157
2019,10,Sant Martí,66,el Parc i la Llacuna del Poblenou,10044,1587,833,754
2019,10,Sant Martí,66,el Parc i la Llacuna del Poblenou,10045,1291,675,616
2019,10,Sant Martí,66,el Parc i la Llacuna del Poblenou,10046,1224,635,589
2019,10,Sant Martí,66,el Parc i la Llacuna del Poblenou,10047,1871,972,899
2019,10,Sant Martí,66,el Parc i la Llacuna del Poblenou,10048,1714,870,844
2019,10,Sant Martí,66,el Parc i la Llacuna del Poblenou,10049,1284,655,629
2019,10,Sant Martí,66,el Parc i la Llacuna del Poblenou,10050,1608,856,752
2019,10,Sant Martí,67,la Vila Olímpica del Poblenou,10051,1598,841,757
2019,10,Sant Martí,67,la Vila Olímpica del Poblenou,10052,2438,1217,1221
2019,10,Sant Martí,67,la Vila Olímpica del Poblenou,10053,1728,876,852
2019,10,Sant Martí,67,la Vila Olímpica del Poblenou,10054,981,516,465
2019,10,Sant Martí,67,la Vila Olímpica del Poblenou,10055,2603,1322,1281
2019,10,Sant Martí,68,el Poblenou,10056,1946,999,947
2019,10,Sant Martí,68,el Poblenou,10057,1409,713,696
2019,10,Sant Martí,68,el Poblenou,10058,1164,590,574
2019,10,Sant Martí,68,el Poblenou,10059,1713,911,802
2019,10,Sant Martí,68,el Poblenou,10060,1652,832,820
2019,10,Sant Martí,68,el Poblenou,10061,1792,938,854
2019,10,Sant Martí,68,el Poblenou,10062,1514,791,723
2019,10,Sant Martí,68,el Poblenou,10063,1218,634,584
2019,10,Sant Martí,68,el Poblenou,10064,1723,886,837
2019,10,Sant Martí,68,el Poblenou,10065,1618,831,787
2019,10,Sant Martí,68,el Poblenou,10066,2142,1084,1058
2019,10,Sant Martí,68,el Poblenou,10067,1940,1005,935
2019,10,Sant Martí,68,el Poblenou,10068,1609,820,789
2019,10,Sant Martí,68,el Poblenou,10069,2560,1327,1233
2019,10,Sant Martí,68,el Poblenou,10070,1675,902,773
2019,10,Sant Martí,68,el Poblenou,10071,1800,916,884
2019,10,Sant Martí,68,el Poblenou,10072,2024,1027,997
2019,10,Sant Martí,68,el Poblenou,10073,1481,772,709
2019,10,Sant Martí,68,el Poblenou,10074,1701,896,805
2019,10,Sant Martí,68,el Poblenou,10075,1489,764,725
2019,10,Sant Martí,69,Diagonal Mar i el Front Marítim del Poblenou,10076,2227,1141,1086
2019,10,Sant Martí,69,Diagonal Mar i el Front Marítim del Poblenou,10077,1842,904,938
2019,10,Sant Martí,69,Diagonal Mar i el Front Marítim del Poblenou,10078,2422,1223,1199
2019,10,Sant Martí,69,Diagonal Mar i el Front Marítim del Poblenou,10079,1811,932,879
2019,10,Sant Martí,69,Diagonal Mar i el Front Marítim del Poblenou,10080,2300,1144,1156
2019,10,Sant Martí,69,Diagonal Mar i el Front Marítim del Poblenou,10235,1349,718,631
2019,10,Sant Martí,69,Diagonal Mar i el Front Marítim del Poblenou,10236,1674,882,792
2019,10,Sant Martí,70,el Besòs i el Maresme,10081,2005,998,1007
2019,10,Sant Martí,70,el Besòs i el Maresme,10082,2077,991,1086
2019,10,Sant Martí,70,el Besòs i el Maresme,10083,2271,979,1292
2019,10,Sant Martí,70,el Besòs i el Maresme,10084,1708,855,853
2019,10,Sant Martí,70,el Besòs i el Maresme,10085,2100,1024,1076
2019,10,Sant Martí,70,el Besòs i el Maresme,10086,2005,1014,991
2019,10,Sant Martí,70,el Besòs i el Maresme,10087,1819,932,887
2019,10,Sant Martí,70,el Besòs i el Maresme,10088,1697,870,827
2019,10,Sant Martí,70,el Besòs i el Maresme,10089,3151,1373,1778
2019,10,Sant Martí,70,el Besòs i el Maresme,10090,1472,758,714
2019,10,Sant Martí,70,el Besòs i el Maresme,10091,1992,1026,966
2019,10,Sant Martí,70,el Besòs i el Maresme,10092,1477,788,689
2019,10,Sant Martí,70,el Besòs i el Maresme,10093,1073,543,530
2019,10,Sant Martí,71,Provençals del Poblenou,10094,2966,1502,1464
2019,10,Sant Martí,71,Provençals del Poblenou,10095,1303,646,657
2019,10,Sant Martí,71,Provençals del Poblenou,10096,1670,896,774
2019,10,Sant Martí,71,Provençals del Poblenou,10097,1611,850,761
2019,10,Sant Martí,71,Provençals del Poblenou,10098,1837,961,876
2019,10,Sant Martí,71,Provençals del Poblenou,10099,1147,603,544
2019,10,Sant Martí,71,Provençals del Poblenou,10100,1674,903,771
2019,10,Sant Martí,71,Provençals del Poblenou,10101,1645,810,835
2019,10,Sant Martí,71,Provençals del Poblenou,10102,2616,1378,1238
2019,10,Sant Martí,71,Provençals del Poblenou,10103,2211,1163,1048
2019,10,Sant Martí,71,Provençals del Poblenou,10104,1583,832,751
2019,10,Sant Martí,71,Provençals del Poblenou,10237,853,462,391
2019,10,Sant Martí,72,Sant Martí de Provençals,10105,2281,1230,1051
2019,10,Sant Martí,72,Sant Martí de Provençals,10106,1008,532,476
2019,10,Sant Martí,72,Sant Martí de Provençals,10107,1566,808,758
2019,10,Sant Martí,72,Sant Martí de Provençals,10108,1313,707,606
2019,10,Sant Martí,72,Sant Martí de Provençals,10109,1565,830,735
2019,10,Sant Martí,72,Sant Martí de Provençals,10110,1678,931,747
2019,10,Sant Martí,72,Sant Martí de Provençals,10111,1282,685,597
2019,10,Sant Martí,72,Sant Martí de Provençals,10112,1527,787,740
2019,10,Sant Martí,72,Sant Martí de Provençals,10113,1220,638,582
2019,10,Sant Martí,72,Sant Martí de Provençals,10114,1435,748,687
2019,10,Sant Martí,72,Sant Martí de Provençals,10115,1395,729,666
2019,10,Sant Martí,72,Sant Martí de Provençals,10116,1873,1009,864
2019,10,Sant Martí,72,Sant Martí de Provençals,10117,1262,667,595
2019,10,Sant Martí,72,Sant Martí de Provençals,10118,1009,538,471
2019,10,Sant Martí,72,Sant Martí de Provençals,10119,1170,637,533
2019,10,Sant Martí,72,Sant Martí de Provençals,10120,1481,817,664
2019,10,Sant Martí,72,Sant Martí de Provençals,10121,1603,826,777
2019,10,Sant Martí,72,Sant Martí de Provençals,10122,1500,778,722
2019,10,Sant Martí,73,la Verneda i la Pau,10123,1381,707,674
2019,10,Sant Martí,73,la Verneda i la Pau,10124,1107,573,534
2019,10,Sant Martí,73,la Verneda i la Pau,10125,1100,571,529
2019,10,Sant Martí,73,la Verneda i la Pau,10126,1002,518,484
2019,10,Sant Martí,73,la Verneda i la Pau,10127,1030,524,506
2019,10,Sant Martí,73,la Verneda i la Pau,10128,1582,847,735
2019,10,Sant Martí,73,la Verneda i la Pau,10129,1179,594,585
2019,10,Sant Martí,73,la Verneda i la Pau,10130,1221,652,569
2019,10,Sant Martí,73,la Verneda i la Pau,10131,1167,623,544
2019,10,Sant Martí,73,la Verneda i la Pau,10132,1275,681,594
2019,10,Sant Martí,73,la Verneda i la Pau,10133,1669,895,774
2019,10,Sant Martí,73,la Verneda i la Pau,10134,1537,854,683
2019,10,Sant Martí,73,la Verneda i la Pau,10135,1276,672,604
2019,10,Sant Martí,73,la Verneda i la Pau,10136,1322,702,620
2019,10,Sant Martí,73,la Verneda i la Pau,10137,1575,806,769
2019,10,Sant Martí,73,la Verneda i la Pau,10138,1609,839,770
2019,10,Sant Martí,73,la Verneda i la Pau,10139,1668,854,814
2019,10,Sant Martí,73,la Verneda i la Pau,10140,1648,837,811
2019,10,Sant Martí,73,la Verneda i la Pau,10141,1115,582,533
2019,10,Sant Martí,73,la Verneda i la Pau,10142,1642,864,778
2019,10,Sant Martí,73,la Verneda i la Pau,10143,1778,926,852
2020,1,Ciutat Vella,1,el Raval,1001,1289,578,711
2020,1,Ciutat Vella,1,el Raval,1002,1469,694,775
2020,1,Ciutat Vella,1,el Raval,1003,3699,1652,2047
2020,1,Ciutat Vella,1,el Raval,1004,2935,1336,1599
2020,1,Ciutat Vella,1,el Raval,1005,2389,1108,1281
2020,1,Ciutat Vella,1,el Raval,1006,1545,661,884
2020,1,Ciutat Vella,1,el Raval,1007,1994,806,1188
2020,1,Ciutat Vella,1,el Raval,1008,3278,1325,1953
2020,1,Ciutat Vella,1,el Raval,1009,2253,1014,1239
2020,1,Ciutat Vella,1,el Raval,1010,2439,1094,1345
2020,1,Ciutat Vella,1,el Raval,1011,3216,1404,1812
2020,1,Ciutat Vella,1,el Raval,1012,1938,949,989
2020,1,Ciutat Vella,1,el Raval,1013,1438,731,707
2020,1,Ciutat Vella,1,el Raval,1014,2126,947,1179
2020,1,Ciutat Vella,1,el Raval,1015,2385,1162,1223
2020,1,Ciutat Vella,1,el Raval,1016,2207,1093,1114
2020,1,Ciutat Vella,1,el Raval,1017,2639,1338,1301
2020,1,Ciutat Vella,1,el Raval,1018,1597,788,809
2020,1,Ciutat Vella,1,el Raval,1019,2977,1371,1606
2020,1,Ciutat Vella,1,el Raval,1020,2179,1130,1049
2020,1,Ciutat Vella,1,el Raval,1021,2188,1069,1119
2020,1,Ciutat Vella,2,el Barri Gòtic,1022,1432,683,749
2020,1,Ciutat Vella,2,el Barri Gòtic,1023,2116,1084,1032
2020,1,Ciutat Vella,2,el Barri Gòtic,1025,1357,669,688
2020,1,Ciutat Vella,2,el Barri Gòtic,1026,7840,1761,6079
2020,1,Ciutat Vella,2,el Barri Gòtic,1027,1587,802,785
2020,1,Ciutat Vella,2,el Barri Gòtic,1028,1917,978,939
2020,1,Ciutat Vella,2,el Barri Gòtic,1029,1467,739,728
2020,1,Ciutat Vella,2,el Barri Gòtic,1030,2431,1227,1204
2020,1,Ciutat Vella,2,el Barri Gòtic,1031,1568,731,837
2020,1,Ciutat Vella,3,la Barceloneta,1032,1822,892,930
2020,1,Ciutat Vella,3,la Barceloneta,1033,1114,546,568
2020,1,Ciutat Vella,3,la Barceloneta,1034,948,485,463
2020,1,Ciutat Vella,3,la Barceloneta,1035,1274,629,645
2020,1,Ciutat Vella,3,la Barceloneta,1036,1198,635,563
2020,1,Ciutat Vella,3,la Barceloneta,1037,1421,745,676
2020,1,Ciutat Vella,3,la Barceloneta,1038,1526,697,829
2020,1,Ciutat Vella,3,la Barceloneta,1039,1352,676,676
2020,1,Ciutat Vella,3,la Barceloneta,1040,1113,569,544
2020,1,Ciutat Vella,3,la Barceloneta,1041,1588,792,796
2020,1,Ciutat Vella,3,la Barceloneta,1042,1756,947,809
2020,1,Ciutat Vella,4,"Sant Pere, Santa Caterina i la Ribera",1043,1688,825,863
2020,1,Ciutat Vella,4,"Sant Pere, Santa Caterina i la Ribera",1044,1433,753,680
2020,1,Ciutat Vella,4,"Sant Pere, Santa Caterina i la Ribera",1045,1972,986,986
2020,1,Ciutat Vella,4,"Sant Pere, Santa Caterina i la Ribera",1046,1835,896,939
2020,1,Ciutat Vella,4,"Sant Pere, Santa Caterina i la Ribera",1047,1744,913,831
2020,1,Ciutat Vella,4,"Sant Pere, Santa Caterina i la Ribera",1048,2126,1078,1048
2020,1,Ciutat Vella,4,"Sant Pere, Santa Caterina i la Ribera",1049,1617,854,763
2020,1,Ciutat Vella,4,"Sant Pere, Santa Caterina i la Ribera",1050,1587,799,788
2020,1,Ciutat Vella,4,"Sant Pere, Santa Caterina i la Ribera",1051,1890,932,958
2020,1,Ciutat Vella,4,"Sant Pere, Santa Caterina i la Ribera",1052,2880,1236,1644
2020,1,Ciutat Vella,4,"Sant Pere, Santa Caterina i la Ribera",1053,1837,955,882
2020,1,Ciutat Vella,4,"Sant Pere, Santa Caterina i la Ribera",1054,1270,622,648
2020,1,Ciutat Vella,4,"Sant Pere, Santa Caterina i la Ribera",1055,1362,698,664
2020,2,Eixample,5,el Fort Pienc,2001,1279,653,626
2020,2,Eixample,5,el Fort Pienc,2002,3404,1545,1859
2020,2,Eixample,5,el Fort Pienc,2003,1209,685,524
2020,2,Eixample,5,el Fort Pienc,2004,1542,782,760
2020,2,Eixample,5,el Fort Pienc,2005,2050,1113,937
2020,2,Eixample,5,el Fort Pienc,2006,1680,887,793
2020,2,Eixample,5,el Fort Pienc,2007,1292,721,571
2020,2,Eixample,5,el Fort Pienc,2008,1944,1055,889
2020,2,Eixample,5,el Fort Pienc,2009,1804,967,837
2020,2,Eixample,5,el Fort Pienc,2010,1246,668,578
2020,2,Eixample,5,el Fort Pienc,2011,1144,576,568
2020,2,Eixample,5,el Fort Pienc,2012,1538,791,747
2020,2,Eixample,5,el Fort Pienc,2013,1170,595,575
2020,2,Eixample,5,el Fort Pienc,2014,1379,698,681
2020,2,Eixample,5,el Fort Pienc,2015,1604,839,765
2020,2,Eixample,5,el Fort Pienc,2016,1895,1037,858
2020,2,Eixample,5,el Fort Pienc,2017,1975,1066,909
2020,2,Eixample,5,el Fort Pienc,2018,1846,1000,846
2020,2,Eixample,5,el Fort Pienc,2019,1984,1053,931
2020,2,Eixample,5,el Fort Pienc,2020,1488,778,710
2020,2,Eixample,6,la Sagrada Família,2021,1534,813,721
2020,2,Eixample,6,la Sagrada Família,2022,1302,668,634
2020,2,Eixample,6,la Sagrada Família,2023,1054,566,488
2020,2,Eixample,6,la Sagrada Família,2024,1150,639,511
2020,2,Eixample,6,la Sagrada Família,2025,1164,599,565
2020,2,Eixample,6,la Sagrada Família,2026,2180,1189,991
2020,2,Eixample,6,la Sagrada Família,2027,2058,1110,948
2020,2,Eixample,6,la Sagrada Família,2028,2077,1138,939
2020,2,Eixample,6,la Sagrada Família,2029,1315,713,602
2020,2,Eixample,6,la Sagrada Família,2030,1372,726,646
2020,2,Eixample,6,la Sagrada Família,2031,1050,568,482
2020,2,Eixample,6,la Sagrada Família,2032,1190,673,517
2020,2,Eixample,6,la Sagrada Família,2033,1216,654,562
2020,2,Eixample,6,la Sagrada Família,2034,1236,700,536
2020,2,Eixample,6,la Sagrada Família,2035,1308,719,589
2020,2,Eixample,6,la Sagrada Família,2036,1199,659,540
2020,2,Eixample,6,la Sagrada Família,2037,1187,615,572
2020,2,Eixample,6,la Sagrada Família,2038,1570,818,752
2020,2,Eixample,6,la Sagrada Família,2039,1769,999,770
2020,2,Eixample,6,la Sagrada Família,2040,1674,889,785
2020,2,Eixample,6,la Sagrada Família,2041,1686,929,757
2020,2,Eixample,6,la Sagrada Família,2042,1608,883,725
2020,2,Eixample,6,la Sagrada Família,2043,1484,789,695
2020,2,Eixample,6,la Sagrada Família,2044,1285,709,576
2020,2,Eixample,6,la Sagrada Família,2045,1156,621,535
2020,2,Eixample,6,la Sagrada Família,2046,1956,1049,907
2020,2,Eixample,6,la Sagrada Família,2047,1966,1050,916
2020,2,Eixample,6,la Sagrada Família,2048,1289,701,588
2020,2,Eixample,6,la Sagrada Família,2049,2125,1158,967
2020,2,Eixample,6,la Sagrada Família,2050,1655,911,744
2020,2,Eixample,6,la Sagrada Família,2051,1885,990,895
2020,2,Eixample,6,la Sagrada Família,2052,1849,990,859
2020,2,Eixample,6,la Sagrada Família,2053,1824,981,843
2020,2,Eixample,6,la Sagrada Família,2054,1879,1011,868
2020,2,Eixample,7,la Dreta de l'Eixample,2055,1822,965,857
2020,2,Eixample,7,la Dreta de l'Eixample,2056,1483,830,653
2020,2,Eixample,7,la Dreta de l'Eixample,2057,1310,701,609
2020,2,Eixample,7,la Dreta de l'Eixample,2058,1386,743,643
2020,2,Eixample,7,la Dreta de l'Eixample,2059,1747,975,772
2020,2,Eixample,7,la Dreta de l'Eixample,2060,1746,957,789
2020,2,Eixample,7,la Dreta de l'Eixample,2061,1383,763,620
2020,2,Eixample,7,la Dreta de l'Eixample,2062,1516,795,721
2020,2,Eixample,7,la Dreta de l'Eixample,2063,1267,758,509
2020,2,Eixample,7,la Dreta de l'Eixample,2064,1333,718,615
2020,2,Eixample,7,la Dreta de l'Eixample,2065,1935,1014,921
2020,2,Eixample,7,la Dreta de l'Eixample,2066,1767,952,815
2020,2,Eixample,7,la Dreta de l'Eixample,2067,1696,898,798
2020,2,Eixample,7,la Dreta de l'Eixample,2068,1634,870,764
2020,2,Eixample,7,la Dreta de l'Eixample,2069,1407,741,666
2020,2,Eixample,7,la Dreta de l'Eixample,2070,1278,697,581
2020,2,Eixample,7,la Dreta de l'Eixample,2071,1684,886,798
2020,2,Eixample,7,la Dreta de l'Eixample,2072,1201,601,600
2020,2,Eixample,7,la Dreta de l'Eixample,2073,1671,908,763
2020,2,Eixample,7,la Dreta de l'Eixample,2074,1297,662,635
2020,2,Eixample,7,la Dreta de l'Eixample,2075,1287,672,615
2020,2,Eixample,7,la Dreta de l'Eixample,2076,1640,870,770
2020,2,Eixample,7,la Dreta de l'Eixample,2077,1674,812,862
2020,2,Eixample,7,la Dreta de l'Eixample,2078,1337,734,603
2020,2,Eixample,7,la Dreta de l'Eixample,2079,1367,709,658
2020,2,Eixample,7,la Dreta de l'Eixample,2080,1557,791,766
2020,2,Eixample,7,la Dreta de l'Eixample,2081,2131,1149,982
2020,2,Eixample,7,la Dreta de l'Eixample,2082,905,490,415
2020,2,Eixample,7,la Dreta de l'Eixample,2083,1837,988,849
2020,2,Eixample,8,l'Antiga Esquerra de l'Eixample,2084,2066,1147,919
2020,2,Eixample,8,l'Antiga Esquerra de l'Eixample,2085,1438,798,640
2020,2,Eixample,8,l'Antiga Esquerra de l'Eixample,2086,1472,796,676
2020,2,Eixample,8,l'Antiga Esquerra de l'Eixample,2087,1454,790,664
2020,2,Eixample,8,l'Antiga Esquerra de l'Eixample,2088,1669,898,771
2020,2,Eixample,8,l'Antiga Esquerra de l'Eixample,2089,1853,979,874
2020,2,Eixample,8,l'Antiga Esquerra de l'Eixample,2090,1667,908,759
2020,2,Eixample,8,l'Antiga Esquerra de l'Eixample,2091,1905,970,935
2020,2,Eixample,8,l'Antiga Esquerra de l'Eixample,2092,2505,1014,1491
2020,2,Eixample,8,l'Antiga Esquerra de l'Eixample,2093,1679,886,793
2020,2,Eixample,8,l'Antiga Esquerra de l'Eixample,2094,1513,786,727
2020,2,Eixample,8,l'Antiga Esquerra de l'Eixample,2095,1547,791,756
2020,2,Eixample,8,l'Antiga Esquerra de l'Eixample,2096,1442,765,677
2020,2,Eixample,8,l'Antiga Esquerra de l'Eixample,2097,1107,587,520
2020,2,Eixample,8,l'Antiga Esquerra de l'Eixample,2098,1546,835,711
2020,2,Eixample,8,l'Antiga Esquerra de l'Eixample,2099,1618,851,767
2020,2,Eixample,8,l'Antiga Esquerra de l'Eixample,2100,1348,712,636
2020,2,Eixample,8,l'Antiga Esquerra de l'Eixample,2101,2192,1173,1019
2020,2,Eixample,8,l'Antiga Esquerra de l'Eixample,2102,1392,772,620
2020,2,Eixample,8,l'Antiga Esquerra de l'Eixample,2103,1634,878,756
2020,2,Eixample,8,l'Antiga Esquerra de l'Eixample,2104,1164,636,528
2020,2,Eixample,8,l'Antiga Esquerra de l'Eixample,2105,2118,1165,953
2020,2,Eixample,8,l'Antiga Esquerra de l'Eixample,2106,1447,773,674
2020,2,Eixample,8,l'Antiga Esquerra de l'Eixample,2107,1652,905,747
2020,2,Eixample,8,l'Antiga Esquerra de l'Eixample,2108,1673,936,737
2020,2,Eixample,8,l'Antiga Esquerra de l'Eixample,2109,2042,1119,923
2020,2,Eixample,9,la Nova Esquerra de l'Eixample,2110,1925,1042,883
2020,2,Eixample,9,la Nova Esquerra de l'Eixample,2111,1876,1021,855
2020,2,Eixample,9,la Nova Esquerra de l'Eixample,2112,1342,715,627
2020,2,Eixample,9,la Nova Esquerra de l'Eixample,2113,2289,1198,1091
2020,2,Eixample,9,la Nova Esquerra de l'Eixample,2114,1669,924,745
2020,2,Eixample,9,la Nova Esquerra de l'Eixample,2115,1379,751,628
2020,2,Eixample,9,la Nova Esquerra de l'Eixample,2116,1040,558,482
2020,2,Eixample,9,la Nova Esquerra de l'Eixample,2117,1204,673,531
2020,2,Eixample,9,la Nova Esquerra de l'Eixample,2118,1494,812,682
2020,2,Eixample,9,la Nova Esquerra de l'Eixample,2119,1251,653,598
2020,2,Eixample,9,la Nova Esquerra de l'Eixample,2120,1169,608,561
2020,2,Eixample,9,la Nova Esquerra de l'Eixample,2121,1284,688,596
2020,2,Eixample,9,la Nova Esquerra de l'Eixample,2122,1058,577,481
2020,2,Eixample,9,la Nova Esquerra de l'Eixample,2123,1145,595,550
2020,2,Eixample,9,la Nova Esquerra de l'Eixample,2124,1088,598,490
2020,2,Eixample,9,la Nova Esquerra de l'Eixample,2125,1699,932,767
2020,2,Eixample,9,la Nova Esquerra de l'Eixample,2126,1462,792,670
2020,2,Eixample,9,la Nova Esquerra de l'Eixample,2127,1168,613,555
2020,2,Eixample,9,la Nova Esquerra de l'Eixample,2128,1319,727,592
2020,2,Eixample,9,la Nova Esquerra de l'Eixample,2129,1542,851,691
2020,2,Eixample,9,la Nova Esquerra de l'Eixample,2130,1157,615,542
2020,2,Eixample,9,la Nova Esquerra de l'Eixample,2131,1201,659,542
2020,2,Eixample,9,la Nova Esquerra de l'Eixample,2132,1107,566,541
2020,2,Eixample,9,la Nova Esquerra de l'Eixample,2133,847,470,377
2020,2,Eixample,9,la Nova Esquerra de l'Eixample,2134,1472,782,690
2020,2,Eixample,9,la Nova Esquerra de l'Eixample,2135,2203,1174,1029
2020,2,Eixample,9,la Nova Esquerra de l'Eixample,2136,913,496,417
2020,2,Eixample,9,la Nova Esquerra de l'Eixample,2137,1498,788,710
2020,2,Eixample,9,la Nova Esquerra de l'Eixample,2138,1956,1041,915
2020,2,Eixample,9,la Nova Esquerra de l'Eixample,2139,1683,897,786
2020,2,Eixample,9,la Nova Esquerra de l'Eixample,2140,1916,1040,876
2020,2,Eixample,9,la Nova Esquerra de l'Eixample,2141,1195,630,565
2020,2,Eixample,9,la Nova Esquerra de l'Eixample,2142,2039,1081,958
2020,2,Eixample,9,la Nova Esquerra de l'Eixample,2143,1388,688,700
2020,2,Eixample,9,la Nova Esquerra de l'Eixample,2144,1591,854,737
2020,2,Eixample,9,la Nova Esquerra de l'Eixample,2145,1254,649,605
2020,2,Eixample,9,la Nova Esquerra de l'Eixample,2146,1195,641,554
2020,2,Eixample,9,la Nova Esquerra de l'Eixample,2147,2203,1179,1024
2020,2,Eixample,9,la Nova Esquerra de l'Eixample,2148,1583,866,717
2020,2,Eixample,9,la Nova Esquerra de l'Eixample,2149,1844,961,883
2020,2,Eixample,10,Sant Antoni,2150,1518,786,732
2020,2,Eixample,10,Sant Antoni,2151,1529,803,726
2020,2,Eixample,10,Sant Antoni,2152,1273,694,579
2020,2,Eixample,10,Sant Antoni,2153,1374,736,638
2020,2,Eixample,10,Sant Antoni,2154,1092,565,527
2020,2,Eixample,10,Sant Antoni,2155,1880,1003,877
2020,2,Eixample,10,Sant Antoni,2156,1273,664,609
2020,2,Eixample,10,Sant Antoni,2157,1243,669,574
2020,2,Eixample,10,Sant Antoni,2158,1626,852,774
2020,2,Eixample,10,Sant Antoni,2159,1971,1022,949
2020,2,Eixample,10,Sant Antoni,2160,1979,1029,950
2020,2,Eixample,10,Sant Antoni,2161,1187,621,566
2020,2,Eixample,10,Sant Antoni,2162,1420,732,688
2020,2,Eixample,10,Sant Antoni,2163,1849,986,863
2020,2,Eixample,10,Sant Antoni,2164,1517,786,731
2020,2,Eixample,10,Sant Antoni,2165,1697,886,811
2020,2,Eixample,10,Sant Antoni,2166,2118,1100,1018
2020,2,Eixample,10,Sant Antoni,2167,2180,1133,1047
2020,2,Eixample,10,Sant Antoni,2168,2335,1229,1106
2020,2,Eixample,10,Sant Antoni,2169,1575,822,753
2020,2,Eixample,10,Sant Antoni,2170,1592,844,748
2020,2,Eixample,10,Sant Antoni,2171,1671,874,797
2020,2,Eixample,10,Sant Antoni,2172,1564,811,753
2020,2,Eixample,10,Sant Antoni,2173,1495,797,698
2020,3,Sants-Montjuïc,11,el Poble-sec,3001,1687,882,805
2020,3,Sants-Montjuïc,11,el Poble-sec,3002,1937,992,945
2020,3,Sants-Montjuïc,11,el Poble-sec,3003,1760,920,840
2020,3,Sants-Montjuïc,11,el Poble-sec,3004,1616,848,768
2020,3,Sants-Montjuïc,11,el Poble-sec,3005,1228,627,601
2020,3,Sants-Montjuïc,11,el Poble-sec,3006,1416,715,701
2020,3,Sants-Montjuïc,11,el Poble-sec,3007,1682,874,808
2020,3,Sants-Montjuïc,11,el Poble-sec,3008,1163,609,554
2020,3,Sants-Montjuïc,11,el Poble-sec,3009,1253,673,580
2020,3,Sants-Montjuïc,11,el Poble-sec,3010,1909,908,1001
2020,3,Sants-Montjuïc,11,el Poble-sec,3011,1772,893,879
2020,3,Sants-Montjuïc,11,el Poble-sec,3012,2176,1118,1058
2020,3,Sants-Montjuïc,11,el Poble-sec,3013,1838,919,919
2020,3,Sants-Montjuïc,11,el Poble-sec,3014,1770,872,898
2020,3,Sants-Montjuïc,11,el Poble-sec,3015,2990,1533,1457
2020,3,Sants-Montjuïc,11,el Poble-sec,3016,1214,636,578
2020,3,Sants-Montjuïc,11,el Poble-sec,3017,1658,814,844
2020,3,Sants-Montjuïc,11,el Poble-sec,3018,1748,855,893
2020,3,Sants-Montjuïc,11,el Poble-sec,3019,1588,841,747
2020,3,Sants-Montjuïc,11,el Poble-sec,3020,1220,589,631
2020,3,Sants-Montjuïc,11,el Poble-sec,3021,1131,596,535
2020,3,Sants-Montjuïc,11,el Poble-sec,3022,1438,720,718
2020,3,Sants-Montjuïc,11,el Poble-sec,3023,1924,976,948
2020,3,Sants-Montjuïc,11,el Poble-sec,3024,2070,1028,1042
2020,3,Sants-Montjuïc,12,la Marina del Prat Vermell,3025,1227,594,633
2020,3,Sants-Montjuïc,13,la Marina de Port,3026,1038,544,494
2020,3,Sants-Montjuïc,13,la Marina de Port,3027,1754,920,834
2020,3,Sants-Montjuïc,13,la Marina de Port,3028,2663,1373,1290
2020,3,Sants-Montjuïc,13,la Marina de Port,3029,1314,686,628
2020,3,Sants-Montjuïc,13,la Marina de Port,3030,1600,874,726
2020,3,Sants-Montjuïc,13,la Marina de Port,3031,2444,1268,1176
2020,3,Sants-Montjuïc,13,la Marina de Port,3032,1719,892,827
2020,3,Sants-Montjuïc,13,la Marina de Port,3033,1492,734,758
2020,3,Sants-Montjuïc,13,la Marina de Port,3034,1545,801,744
2020,3,Sants-Montjuïc,13,la Marina de Port,3035,2300,1201,1099
2020,3,Sants-Montjuïc,13,la Marina de Port,3036,2427,1273,1154
2020,3,Sants-Montjuïc,13,la Marina de Port,3037,1055,556,499
2020,3,Sants-Montjuïc,13,la Marina de Port,3038,964,508,456
2020,3,Sants-Montjuïc,13,la Marina de Port,3039,2567,1326,1241
2020,3,Sants-Montjuïc,13,la Marina de Port,3211,1526,768,758
2020,3,Sants-Montjuïc,13,la Marina de Port,3212,2489,1318,1171
2020,3,Sants-Montjuïc,13,la Marina de Port,3213,2455,1260,1195
2020,3,Sants-Montjuïc,14,la Font de la Guatlla,3040,1483,788,695
2020,3,Sants-Montjuïc,14,la Font de la Guatlla,3041,1425,761,664
2020,3,Sants-Montjuïc,14,la Font de la Guatlla,3042,1402,719,683
2020,3,Sants-Montjuïc,14,la Font de la Guatlla,3043,1677,911,766
2020,3,Sants-Montjuïc,14,la Font de la Guatlla,3044,1882,982,900
2020,3,Sants-Montjuïc,14,la Font de la Guatlla,3045,1090,565,525
2020,3,Sants-Montjuïc,14,la Font de la Guatlla,3046,1418,750,668
2020,3,Sants-Montjuïc,15,Hostafrancs,3047,1833,974,859
2020,3,Sants-Montjuïc,15,Hostafrancs,3048,1360,720,640
2020,3,Sants-Montjuïc,15,Hostafrancs,3049,1670,881,789
2020,3,Sants-Montjuïc,15,Hostafrancs,3050,1654,846,808
2020,3,Sants-Montjuïc,15,Hostafrancs,3051,1946,979,967
2020,3,Sants-Montjuïc,15,Hostafrancs,3052,1316,696,620
2020,3,Sants-Montjuïc,15,Hostafrancs,3053,2203,1162,1041
2020,3,Sants-Montjuïc,15,Hostafrancs,3054,1735,894,841
2020,3,Sants-Montjuïc,15,Hostafrancs,3055,1583,820,763
2020,3,Sants-Montjuïc,15,Hostafrancs,3056,903,495,408
2020,3,Sants-Montjuïc,16,la Bordeta,3057,1510,804,706
2020,3,Sants-Montjuïc,16,la Bordeta,3058,1746,957,789
2020,3,Sants-Montjuïc,16,la Bordeta,3059,1221,621,600
2020,3,Sants-Montjuïc,16,la Bordeta,3060,1403,716,687
2020,3,Sants-Montjuïc,16,la Bordeta,3061,1149,599,550
2020,3,Sants-Montjuïc,16,la Bordeta,3062,1584,850,734
2020,3,Sants-Montjuïc,16,la Bordeta,3063,1922,986,936
2020,3,Sants-Montjuïc,16,la Bordeta,3064,1206,645,561
2020,3,Sants-Montjuïc,16,la Bordeta,3065,1357,707,650
2020,3,Sants-Montjuïc,16,la Bordeta,3066,2332,1217,1115
2020,3,Sants-Montjuïc,16,la Bordeta,3067,1750,925,825
2020,3,Sants-Montjuïc,16,la Bordeta,3068,1175,625,550
2020,3,Sants-Montjuïc,16,la Bordeta,3069,1212,621,591
2020,3,Sants-Montjuïc,17,Sants - Badal,3070,1341,686,655
2020,3,Sants-Montjuïc,17,Sants - Badal,3071,1287,665,622
2020,3,Sants-Montjuïc,17,Sants - Badal,3072,1488,778,710
2020,3,Sants-Montjuïc,17,Sants - Badal,3073,1651,849,802
2020,3,Sants-Montjuïc,17,Sants - Badal,3074,1767,941,826
2020,3,Sants-Montjuïc,17,Sants - Badal,3075,1758,932,826
2020,3,Sants-Montjuïc,17,Sants - Badal,3076,1082,581,501
2020,3,Sants-Montjuïc,17,Sants - Badal,3077,1343,736,607
2020,3,Sants-Montjuïc,17,Sants - Badal,3078,1747,917,830
2020,3,Sants-Montjuïc,17,Sants - Badal,3079,1816,957,859
2020,3,Sants-Montjuïc,17,Sants - Badal,3080,1553,865,688
2020,3,Sants-Montjuïc,17,Sants - Badal,3081,1901,1013,888
2020,3,Sants-Montjuïc,17,Sants - Badal,3082,1978,1060,918
2020,3,Sants-Montjuïc,17,Sants - Badal,3083,1399,754,645
2020,3,Sants-Montjuïc,17,Sants - Badal,3084,1447,786,661
2020,3,Sants-Montjuïc,17,Sants - Badal,3085,1380,750,630
2020,3,Sants-Montjuïc,18,Sants,3086,1243,650,593
2020,3,Sants-Montjuïc,18,Sants,3087,1494,793,701
2020,3,Sants-Montjuïc,18,Sants,3088,1384,728,656
2020,3,Sants-Montjuïc,18,Sants,3089,1245,672,573
2020,3,Sants-Montjuïc,18,Sants,3090,1029,553,476
2020,3,Sants-Montjuïc,18,Sants,3091,1495,766,729
2020,3,Sants-Montjuïc,18,Sants,3092,1223,647,576
2020,3,Sants-Montjuïc,18,Sants,3093,1518,810,708
2020,3,Sants-Montjuïc,18,Sants,3094,1227,653,574
2020,3,Sants-Montjuïc,18,Sants,3095,1653,873,780
2020,3,Sants-Montjuïc,18,Sants,3096,1568,833,735
2020,3,Sants-Montjuïc,18,Sants,3097,1747,921,826
2020,3,Sants-Montjuïc,18,Sants,3098,1449,741,708
2020,3,Sants-Montjuïc,18,Sants,3099,982,535,447
2020,3,Sants-Montjuïc,18,Sants,3100,1343,728,615
2020,3,Sants-Montjuïc,18,Sants,3101,4046,1657,2389
2020,3,Sants-Montjuïc,18,Sants,3102,1323,681,642
2020,3,Sants-Montjuïc,18,Sants,3103,1199,648,551
2020,3,Sants-Montjuïc,18,Sants,3104,1449,760,689
2020,3,Sants-Montjuïc,18,Sants,3105,1151,638,513
2020,3,Sants-Montjuïc,18,Sants,3106,1273,683,590
2020,3,Sants-Montjuïc,18,Sants,3107,1601,816,785
2020,3,Sants-Montjuïc,18,Sants,3108,1683,891,792
2020,3,Sants-Montjuïc,18,Sants,3109,1580,809,771
2020,3,Sants-Montjuïc,18,Sants,3110,1509,814,695
2020,3,Sants-Montjuïc,18,Sants,3111,1287,692,595
2020,3,Sants-Montjuïc,18,Sants,3112,1892,996,896
2020,3,Sants-Montjuïc,18,Sants,3113,1687,896,791
2020,3,Sants-Montjuïc,18,Sants,3114,1483,783,700
2020,4,Les Corts,19,les Corts,4001,1269,670,599
2020,4,Les Corts,19,les Corts,4002,1961,1026,935
2020,4,Les Corts,19,les Corts,4003,1098,569,529
2020,4,Les Corts,19,les Corts,4004,1005,531,474
2020,4,Les Corts,19,les Corts,4005,1217,658,559
2020,4,Les Corts,19,les Corts,4006,1111,601,510
2020,4,Les Corts,19,les Corts,4007,1067,605,462
2020,4,Les Corts,19,les Corts,4008,1004,538,466
2020,4,Les Corts,19,les Corts,4009,1457,789,668
2020,4,Les Corts,19,les Corts,4010,926,510,416
2020,4,Les Corts,19,les Corts,4011,1762,932,830
2020,4,Les Corts,19,les Corts,4012,1438,763,675
2020,4,Les Corts,19,les Corts,4013,1225,652,573
2020,4,Les Corts,19,les Corts,4014,850,464,386
2020,4,Les Corts,19,les Corts,4015,1913,1049,864
2020,4,Les Corts,19,les Corts,4016,1077,577,500
2020,4,Les Corts,19,les Corts,4017,1214,658,556
2020,4,Les Corts,19,les Corts,4018,1550,848,702
2020,4,Les Corts,19,les Corts,4019,1380,731,649
2020,4,Les Corts,19,les Corts,4020,1504,809,695
2020,4,Les Corts,19,les Corts,4021,1331,719,612
2020,4,Les Corts,19,les Corts,4022,1632,845,787
2020,4,Les Corts,19,les Corts,4023,1051,560,491
2020,4,Les Corts,19,les Corts,4024,1047,563,484
2020,4,Les Corts,19,les Corts,4025,1179,647,532
2020,4,Les Corts,19,les Corts,4026,1237,685,552
2020,4,Les Corts,19,les Corts,4027,1332,713,619
2020,4,Les Corts,19,les Corts,4028,1326,706,620
2020,4,Les Corts,19,les Corts,4029,1126,615,511
2020,4,Les Corts,19,les Corts,4030,1849,1011,838
2020,4,Les Corts,19,les Corts,4031,1947,961,986
2020,4,Les Corts,19,les Corts,4032,1584,869,715
2020,4,Les Corts,19,les Corts,4033,1156,622,534
2020,4,Les Corts,19,les Corts,4034,1499,778,721
2020,4,Les Corts,19,les Corts,4035,1407,764,643
2020,4,Les Corts,20,la Maternitat i Sant Ramon,4036,1718,944,774
2020,4,Les Corts,20,la Maternitat i Sant Ramon,4037,2109,1142,967
2020,4,Les Corts,20,la Maternitat i Sant Ramon,4038,1252,675,577
2020,4,Les Corts,20,la Maternitat i Sant Ramon,4039,1203,648,555
2020,4,Les Corts,20,la Maternitat i Sant Ramon,4040,1641,844,797
2020,4,Les Corts,20,la Maternitat i Sant Ramon,4041,1334,708,626
2020,4,Les Corts,20,la Maternitat i Sant Ramon,4042,1759,944,815
2020,4,Les Corts,20,la Maternitat i Sant Ramon,4043,1645,893,752
2020,4,Les Corts,20,la Maternitat i Sant Ramon,4044,1609,856,753
2020,4,Les Corts,20,la Maternitat i Sant Ramon,4045,1416,758,658
2020,4,Les Corts,20,la Maternitat i Sant Ramon,4046,2435,1258,1177
2020,4,Les Corts,20,la Maternitat i Sant Ramon,4047,1805,966,839
2020,4,Les Corts,20,la Maternitat i Sant Ramon,4048,1510,815,695
2020,4,Les Corts,20,la Maternitat i Sant Ramon,4049,1188,631,557
2020,4,Les Corts,20,la Maternitat i Sant Ramon,4084,1344,723,621
2020,4,Les Corts,21,Pedralbes,4050,2046,1084,962
2020,4,Les Corts,21,Pedralbes,4051,1650,911,739
2020,4,Les Corts,21,Pedralbes,4052,2198,1197,1001
2020,4,Les Corts,21,Pedralbes,4053,1677,883,794
2020,4,Les Corts,21,Pedralbes,4054,1034,555,479
2020,4,Les Corts,21,Pedralbes,4055,1534,789,745
2020,4,Les Corts,21,Pedralbes,4056,1797,940,857
2020,5,Sarrià-Sant Gervasi,22,"Vallvidrera, el Tibidabo i les Planes",5001,1762,870,892
2020,5,Sarrià-Sant Gervasi,22,"Vallvidrera, el Tibidabo i les Planes",5002,1585,811,774
2020,5,Sarrià-Sant Gervasi,22,"Vallvidrera, el Tibidabo i les Planes",5003,1363,700,663
2020,5,Sarrià-Sant Gervasi,23,Sarrià,5004,1111,639,472
2020,5,Sarrià-Sant Gervasi,23,Sarrià,5005,1266,643,623
2020,5,Sarrià-Sant Gervasi,23,Sarrià,5006,1838,926,912
2020,5,Sarrià-Sant Gervasi,23,Sarrià,5007,1795,875,920
2020,5,Sarrià-Sant Gervasi,23,Sarrià,5008,1694,901,793
2020,5,Sarrià-Sant Gervasi,23,Sarrià,5009,1723,943,780
2020,5,Sarrià-Sant Gervasi,23,Sarrià,5010,1603,857,746
2020,5,Sarrià-Sant Gervasi,23,Sarrià,5011,1409,778,631
2020,5,Sarrià-Sant Gervasi,23,Sarrià,5012,1375,753,622
2020,5,Sarrià-Sant Gervasi,23,Sarrià,5013,1701,894,807
2020,5,Sarrià-Sant Gervasi,23,Sarrià,5014,1602,858,744
2020,5,Sarrià-Sant Gervasi,23,Sarrià,5015,1614,885,729
2020,5,Sarrià-Sant Gervasi,23,Sarrià,5016,1946,1042,904
2020,5,Sarrià-Sant Gervasi,23,Sarrià,5017,1582,854,728
2020,5,Sarrià-Sant Gervasi,23,Sarrià,5018,1277,698,579
2020,5,Sarrià-Sant Gervasi,23,Sarrià,5019,1706,923,783
2020,5,Sarrià-Sant Gervasi,24,les Tres Torres,5020,1157,617,540
2020,5,Sarrià-Sant Gervasi,24,les Tres Torres,5021,1349,721,628
2020,5,Sarrià-Sant Gervasi,24,les Tres Torres,5022,1778,999,779
2020,5,Sarrià-Sant Gervasi,24,les Tres Torres,5023,1468,801,667
2020,5,Sarrià-Sant Gervasi,24,les Tres Torres,5024,1948,1040,908
2020,5,Sarrià-Sant Gervasi,24,les Tres Torres,5025,1317,706,611
2020,5,Sarrià-Sant Gervasi,24,les Tres Torres,5026,1445,756,689
2020,5,Sarrià-Sant Gervasi,24,les Tres Torres,5027,1412,736,676
2020,5,Sarrià-Sant Gervasi,24,les Tres Torres,5028,1684,846,838
2020,5,Sarrià-Sant Gervasi,24,les Tres Torres,5029,1666,868,798
2020,5,Sarrià-Sant Gervasi,24,les Tres Torres,5030,1420,764,656
2020,5,Sarrià-Sant Gervasi,25,Sant Gervasi - la Bonanova,5031,1681,888,793
2020,5,Sarrià-Sant Gervasi,25,Sant Gervasi - la Bonanova,5032,1847,992,855
2020,5,Sarrià-Sant Gervasi,25,Sant Gervasi - la Bonanova,5033,1384,728,656
2020,5,Sarrià-Sant Gervasi,25,Sant Gervasi - la Bonanova,5034,1345,689,656
2020,5,Sarrià-Sant Gervasi,25,Sant Gervasi - la Bonanova,5035,1080,558,522
2020,5,Sarrià-Sant Gervasi,25,Sant Gervasi - la Bonanova,5036,1744,926,818
2020,5,Sarrià-Sant Gervasi,25,Sant Gervasi - la Bonanova,5037,1442,812,630
2020,5,Sarrià-Sant Gervasi,25,Sant Gervasi - la Bonanova,5038,1359,741,618
2020,5,Sarrià-Sant Gervasi,25,Sant Gervasi - la Bonanova,5039,1519,806,713
2020,5,Sarrià-Sant Gervasi,25,Sant Gervasi - la Bonanova,5040,1437,792,645
2020,5,Sarrià-Sant Gervasi,25,Sant Gervasi - la Bonanova,5041,1933,980,953
2020,5,Sarrià-Sant Gervasi,25,Sant Gervasi - la Bonanova,5042,1318,696,622
2020,5,Sarrià-Sant Gervasi,25,Sant Gervasi - la Bonanova,5043,1473,806,667
2020,5,Sarrià-Sant Gervasi,25,Sant Gervasi - la Bonanova,5044,1355,762,593
2020,5,Sarrià-Sant Gervasi,25,Sant Gervasi - la Bonanova,5045,1641,906,735
2020,5,Sarrià-Sant Gervasi,25,Sant Gervasi - la Bonanova,5046,1150,646,504
2020,5,Sarrià-Sant Gervasi,25,Sant Gervasi - la Bonanova,5047,1270,707,563
2020,5,Sarrià-Sant Gervasi,25,Sant Gervasi - la Bonanova,5048,1267,697,570
2020,5,Sarrià-Sant Gervasi,26,Sant Gervasi - Galvany,5049,1689,934,755
2020,5,Sarrià-Sant Gervasi,26,Sant Gervasi - Galvany,5050,1651,885,766
2020,5,Sarrià-Sant Gervasi,26,Sant Gervasi - Galvany,5051,1620,869,751
2020,5,Sarrià-Sant Gervasi,26,Sant Gervasi - Galvany,5052,1474,816,658
2020,5,Sarrià-Sant Gervasi,26,Sant Gervasi - Galvany,5053,1483,787,696
2020,5,Sarrià-Sant Gervasi,26,Sant Gervasi - Galvany,5054,1053,589,464
2020,5,Sarrià-Sant Gervasi,26,Sant Gervasi - Galvany,5055,1436,787,649
2020,5,Sarrià-Sant Gervasi,26,Sant Gervasi - Galvany,5056,1203,700,503
2020,5,Sarrià-Sant Gervasi,26,Sant Gervasi - Galvany,5057,1695,904,791
2020,5,Sarrià-Sant Gervasi,26,Sant Gervasi - Galvany,5058,1571,844,727
2020,5,Sarrià-Sant Gervasi,26,Sant Gervasi - Galvany,5059,1566,877,689
2020,5,Sarrià-Sant Gervasi,26,Sant Gervasi - Galvany,5060,1173,653,520
2020,5,Sarrià-Sant Gervasi,26,Sant Gervasi - Galvany,5061,1479,829,650
2020,5,Sarrià-Sant Gervasi,26,Sant Gervasi - Galvany,5062,1628,921,707
2020,5,Sarrià-Sant Gervasi,26,Sant Gervasi - Galvany,5063,1626,896,730
2020,5,Sarrià-Sant Gervasi,26,Sant Gervasi - Galvany,5064,1611,911,700
2020,5,Sarrià-Sant Gervasi,26,Sant Gervasi - Galvany,5065,1717,935,782
2020,5,Sarrià-Sant Gervasi,26,Sant Gervasi - Galvany,5066,1319,730,589
2020,5,Sarrià-Sant Gervasi,26,Sant Gervasi - Galvany,5067,1302,713,589
2020,5,Sarrià-Sant Gervasi,26,Sant Gervasi - Galvany,5068,1509,829,680
2020,5,Sarrià-Sant Gervasi,26,Sant Gervasi - Galvany,5069,1751,945,806
2020,5,Sarrià-Sant Gervasi,26,Sant Gervasi - Galvany,5070,1459,822,637
2020,5,Sarrià-Sant Gervasi,26,Sant Gervasi - Galvany,5071,1646,925,721
2020,5,Sarrià-Sant Gervasi,26,Sant Gervasi - Galvany,5072,1778,992,786
2020,5,Sarrià-Sant Gervasi,26,Sant Gervasi - Galvany,5073,1626,896,730
2020,5,Sarrià-Sant Gervasi,26,Sant Gervasi - Galvany,5074,1696,908,788
2020,5,Sarrià-Sant Gervasi,26,Sant Gervasi - Galvany,5075,1862,1054,808
2020,5,Sarrià-Sant Gervasi,26,Sant Gervasi - Galvany,5076,1418,779,639
2020,5,Sarrià-Sant Gervasi,26,Sant Gervasi - Galvany,5077,1476,806,670
2020,5,Sarrià-Sant Gervasi,26,Sant Gervasi - Galvany,5078,2153,1147,1006
2020,5,Sarrià-Sant Gervasi,26,Sant Gervasi - Galvany,5079,1306,711,595
2020,5,Sarrià-Sant Gervasi,27,el Putget i Farró,5080,1435,776,659
2020,5,Sarrià-Sant Gervasi,27,el Putget i Farró,5081,1601,883,718
2020,5,Sarrià-Sant Gervasi,27,el Putget i Farró,5082,1672,912,760
2020,5,Sarrià-Sant Gervasi,27,el Putget i Farró,5083,1269,695,574
2020,5,Sarrià-Sant Gervasi,27,el Putget i Farró,5084,1337,741,596
2020,5,Sarrià-Sant Gervasi,27,el Putget i Farró,5085,1336,703,633
2020,5,Sarrià-Sant Gervasi,27,el Putget i Farró,5086,1354,728,626
2020,5,Sarrià-Sant Gervasi,27,el Putget i Farró,5087,1568,861,707
2020,5,Sarrià-Sant Gervasi,27,el Putget i Farró,5088,1819,927,892
2020,5,Sarrià-Sant Gervasi,27,el Putget i Farró,5089,1771,909,862
2020,5,Sarrià-Sant Gervasi,27,el Putget i Farró,5090,1943,1035,908
2020,5,Sarrià-Sant Gervasi,27,el Putget i Farró,5091,1576,864,712
2020,5,Sarrià-Sant Gervasi,27,el Putget i Farró,5092,1630,871,759
2020,5,Sarrià-Sant Gervasi,27,el Putget i Farró,5093,1131,645,486
2020,5,Sarrià-Sant Gervasi,27,el Putget i Farró,5094,2778,1546,1232
2020,5,Sarrià-Sant Gervasi,27,el Putget i Farró,5095,1695,939,756
2020,5,Sarrià-Sant Gervasi,27,el Putget i Farró,5096,1145,627,518
2020,5,Sarrià-Sant Gervasi,27,el Putget i Farró,5097,1693,903,790
2020,5,Sarrià-Sant Gervasi,27,el Putget i Farró,5098,1587,884,703
2020,6,Gràcia,28,Vallcarca i els Penitents,6001,1174,667,507
2020,6,Gràcia,28,Vallcarca i els Penitents,6002,1488,806,682
2020,6,Gràcia,28,Vallcarca i els Penitents,6003,2333,1201,1132
2020,6,Gràcia,28,Vallcarca i els Penitents,6004,1445,730,715
2020,6,Gràcia,28,Vallcarca i els Penitents,6006,1054,556,498
2020,6,Gràcia,28,Vallcarca i els Penitents,6007,1992,1065,927
2020,6,Gràcia,28,Vallcarca i els Penitents,6008,2035,1133,902
2020,6,Gràcia,28,Vallcarca i els Penitents,6009,1298,679,619
2020,6,Gràcia,28,Vallcarca i els Penitents,6010,1067,566,501
2020,6,Gràcia,28,Vallcarca i els Penitents,6011,1302,684,618
2020,6,Gràcia,28,Vallcarca i els Penitents,6012,1160,606,554
2020,6,Gràcia,29,el Coll,6013,1785,960,825
2020,6,Gràcia,29,el Coll,6014,1432,776,656
2020,6,Gràcia,29,el Coll,6015,1425,752,673
2020,6,Gràcia,29,el Coll,6016,1588,843,745
2020,6,Gràcia,29,el Coll,6017,1387,732,655
2020,6,Gràcia,30,la Salut,6018,1317,694,623
2020,6,Gràcia,30,la Salut,6019,1506,798,708
2020,6,Gràcia,30,la Salut,6020,1176,640,536
2020,6,Gràcia,30,la Salut,6021,1372,740,632
2020,6,Gràcia,30,la Salut,6022,1392,676,716
2020,6,Gràcia,30,la Salut,6023,1305,705,600
2020,6,Gràcia,30,la Salut,6024,1740,973,767
2020,6,Gràcia,30,la Salut,6025,1420,772,648
2020,6,Gràcia,30,la Salut,6026,1022,564,458
2020,6,Gràcia,30,la Salut,6027,1228,691,537
2020,6,Gràcia,31,Vila de Gràcia,6028,1346,698,648
2020,6,Gràcia,31,Vila de Gràcia,6029,1296,686,610
2020,6,Gràcia,31,Vila de Gràcia,6030,1338,707,631
2020,6,Gràcia,31,Vila de Gràcia,6031,1106,601,505
2020,6,Gràcia,31,Vila de Gràcia,6032,1167,646,521
2020,6,Gràcia,31,Vila de Gràcia,6033,1330,727,603
2020,6,Gràcia,31,Vila de Gràcia,6034,1232,692,540
2020,6,Gràcia,31,Vila de Gràcia,6035,1081,592,489
2020,6,Gràcia,31,Vila de Gràcia,6036,1493,856,637
2020,6,Gràcia,31,Vila de Gràcia,6037,1134,596,538
2020,6,Gràcia,31,Vila de Gràcia,6038,1507,863,644
2020,6,Gràcia,31,Vila de Gràcia,6039,1603,872,731
2020,6,Gràcia,31,Vila de Gràcia,6040,1675,961,714
2020,6,Gràcia,31,Vila de Gràcia,6041,1763,975,788
2020,6,Gràcia,31,Vila de Gràcia,6042,1736,923,813
2020,6,Gràcia,31,Vila de Gràcia,6043,1279,688,591
2020,6,Gràcia,31,Vila de Gràcia,6044,1623,876,747
2020,6,Gràcia,31,Vila de Gràcia,6045,1295,703,592
2020,6,Gràcia,31,Vila de Gràcia,6046,1162,608,554
2020,6,Gràcia,31,Vila de Gràcia,6047,1265,702,563
2020,6,Gràcia,31,Vila de Gràcia,6048,1404,762,642
2020,6,Gràcia,31,Vila de Gràcia,6049,1183,647,536
2020,6,Gràcia,31,Vila de Gràcia,6050,1320,715,605
2020,6,Gràcia,31,Vila de Gràcia,6051,1247,719,528
2020,6,Gràcia,31,Vila de Gràcia,6052,1530,837,693
2020,6,Gràcia,31,Vila de Gràcia,6053,1510,811,699
2020,6,Gràcia,31,Vila de Gràcia,6054,1650,851,799
2020,6,Gràcia,31,Vila de Gràcia,6055,1487,828,659
2020,6,Gràcia,31,Vila de Gràcia,6056,1567,848,719
2020,6,Gràcia,31,Vila de Gràcia,6057,1511,854,657
2020,6,Gràcia,31,Vila de Gràcia,6058,1691,936,755
2020,6,Gràcia,31,Vila de Gràcia,6059,1545,830,715
2020,6,Gràcia,31,Vila de Gràcia,6060,1798,955,843
2020,6,Gràcia,31,Vila de Gràcia,6061,1313,694,619
2020,6,Gràcia,31,Vila de Gràcia,6062,1222,664,558
2020,6,Gràcia,31,Vila de Gràcia,6063,1517,813,704
2020,6,Gràcia,32,el Camp d'en Grassot i Gràcia Nova,6064,1901,1040,861
2020,6,Gràcia,32,el Camp d'en Grassot i Gràcia Nova,6065,1196,635,561
2020,6,Gràcia,32,el Camp d'en Grassot i Gràcia Nova,6066,981,553,428
2020,6,Gràcia,32,el Camp d'en Grassot i Gràcia Nova,6067,1776,978,798
2020,6,Gràcia,32,el Camp d'en Grassot i Gràcia Nova,6068,1597,883,714
2020,6,Gràcia,32,el Camp d'en Grassot i Gràcia Nova,6069,1065,571,494
2020,6,Gràcia,32,el Camp d'en Grassot i Gràcia Nova,6070,1885,1048,837
2020,6,Gràcia,32,el Camp d'en Grassot i Gràcia Nova,6071,1070,569,501
2020,6,Gràcia,32,el Camp d'en Grassot i Gràcia Nova,6072,1628,897,731
2020,6,Gràcia,32,el Camp d'en Grassot i Gràcia Nova,6073,1363,744,619
2020,6,Gràcia,32,el Camp d'en Grassot i Gràcia Nova,6074,1127,582,545
2020,6,Gràcia,32,el Camp d'en Grassot i Gràcia Nova,6075,1084,571,513
2020,6,Gràcia,32,el Camp d'en Grassot i Gràcia Nova,6076,1301,664,637
2020,6,Gràcia,32,el Camp d'en Grassot i Gràcia Nova,6077,1217,674,543
2020,6,Gràcia,32,el Camp d'en Grassot i Gràcia Nova,6078,1333,705,628
2020,6,Gràcia,32,el Camp d'en Grassot i Gràcia Nova,6079,1121,638,483
2020,6,Gràcia,32,el Camp d'en Grassot i Gràcia Nova,6080,1193,640,553
2020,6,Gràcia,32,el Camp d'en Grassot i Gràcia Nova,6081,1326,733,593
2020,6,Gràcia,32,el Camp d'en Grassot i Gràcia Nova,6082,2608,1347,1261
2020,6,Gràcia,32,el Camp d'en Grassot i Gràcia Nova,6083,1740,911,829
2020,6,Gràcia,32,el Camp d'en Grassot i Gràcia Nova,6084,1552,851,701
2020,6,Gràcia,32,el Camp d'en Grassot i Gràcia Nova,6085,1287,705,582
2020,6,Gràcia,32,el Camp d'en Grassot i Gràcia Nova,6086,990,523,467
2020,6,Gràcia,32,el Camp d'en Grassot i Gràcia Nova,6087,1891,1027,864
2020,6,Gràcia,32,el Camp d'en Grassot i Gràcia Nova,6088,1251,694,557
2020,7,Horta-Guinardó,33,el Baix Guinardó,7001,1597,882,715
2020,7,Horta-Guinardó,33,el Baix Guinardó,7002,1165,638,527
2020,7,Horta-Guinardó,33,el Baix Guinardó,7003,1319,722,597
2020,7,Horta-Guinardó,33,el Baix Guinardó,7004,1549,832,717
2020,7,Horta-Guinardó,33,el Baix Guinardó,7005,1489,782,707
2020,7,Horta-Guinardó,33,el Baix Guinardó,7006,957,503,454
2020,7,Horta-Guinardó,33,el Baix Guinardó,7007,1448,804,644
2020,7,Horta-Guinardó,33,el Baix Guinardó,7008,1456,769,687
2020,7,Horta-Guinardó,33,el Baix Guinardó,7009,1187,663,524
2020,7,Horta-Guinardó,33,el Baix Guinardó,7010,1359,713,646
2020,7,Horta-Guinardó,33,el Baix Guinardó,7011,1180,634,546
2020,7,Horta-Guinardó,33,el Baix Guinardó,7012,1575,858,717
2020,7,Horta-Guinardó,33,el Baix Guinardó,7013,1219,640,579
2020,7,Horta-Guinardó,33,el Baix Guinardó,7014,891,483,408
2020,7,Horta-Guinardó,33,el Baix Guinardó,7015,1427,747,680
2020,7,Horta-Guinardó,33,el Baix Guinardó,7016,1367,706,661
2020,7,Horta-Guinardó,33,el Baix Guinardó,7017,1783,986,797
2020,7,Horta-Guinardó,33,el Baix Guinardó,7018,1723,942,781
2020,7,Horta-Guinardó,33,el Baix Guinardó,7019,1489,779,710
2020,7,Horta-Guinardó,34,Can Baró,7020,1736,935,801
2020,7,Horta-Guinardó,34,Can Baró,7021,1059,539,520
2020,7,Horta-Guinardó,34,Can Baró,7022,1142,596,546
2020,7,Horta-Guinardó,34,Can Baró,7023,1320,672,648
2020,7,Horta-Guinardó,34,Can Baró,7024,1498,795,703
2020,7,Horta-Guinardó,34,Can Baró,7025,1468,773,695
2020,7,Horta-Guinardó,34,Can Baró,7026,1108,598,510
2020,7,Horta-Guinardó,35,el Guinardó,7027,2154,1152,1002
2020,7,Horta-Guinardó,35,el Guinardó,7028,1459,756,703
2020,7,Horta-Guinardó,35,el Guinardó,7029,1297,670,627
2020,7,Horta-Guinardó,35,el Guinardó,7030,1405,776,629
2020,7,Horta-Guinardó,35,el Guinardó,7031,1624,845,779
2020,7,Horta-Guinardó,35,el Guinardó,7032,1470,757,713
2020,7,Horta-Guinardó,35,el Guinardó,7033,1461,782,679
2020,7,Horta-Guinardó,35,el Guinardó,7034,1892,1000,892
2020,7,Horta-Guinardó,35,el Guinardó,7035,1781,937,844
2020,7,Horta-Guinardó,35,el Guinardó,7036,1433,790,643
2020,7,Horta-Guinardó,35,el Guinardó,7037,1536,824,712
2020,7,Horta-Guinardó,35,el Guinardó,7038,1278,677,601
2020,7,Horta-Guinardó,35,el Guinardó,7039,1635,882,753
2020,7,Horta-Guinardó,35,el Guinardó,7040,1480,805,675
2020,7,Horta-Guinardó,35,el Guinardó,7041,1377,727,650
2020,7,Horta-Guinardó,35,el Guinardó,7042,1504,827,677
2020,7,Horta-Guinardó,35,el Guinardó,7043,1402,743,659
2020,7,Horta-Guinardó,35,el Guinardó,7044,1294,692,602
2020,7,Horta-Guinardó,35,el Guinardó,7045,1614,834,780
2020,7,Horta-Guinardó,35,el Guinardó,7046,1451,777,674
2020,7,Horta-Guinardó,35,el Guinardó,7047,1476,765,711
2020,7,Horta-Guinardó,35,el Guinardó,7048,1330,720,610
2020,7,Horta-Guinardó,35,el Guinardó,7049,1223,645,578
2020,7,Horta-Guinardó,35,el Guinardó,7050,1203,634,569
2020,7,Horta-Guinardó,35,el Guinardó,7051,1805,974,831
2020,7,Horta-Guinardó,36,la Font d'en Fargues,7052,1270,655,615
2020,7,Horta-Guinardó,36,la Font d'en Fargues,7053,1482,795,687
2020,7,Horta-Guinardó,36,la Font d'en Fargues,7054,1575,837,738
2020,7,Horta-Guinardó,36,la Font d'en Fargues,7055,1200,645,555
2020,7,Horta-Guinardó,36,la Font d'en Fargues,7056,1196,612,584
2020,7,Horta-Guinardó,36,la Font d'en Fargues,7057,1432,756,676
2020,7,Horta-Guinardó,36,la Font d'en Fargues,7058,1389,723,666
2020,7,Horta-Guinardó,37,el Carmel,7059,1343,707,636
2020,7,Horta-Guinardó,37,el Carmel,7060,1865,954,911
2020,7,Horta-Guinardó,37,el Carmel,7061,1215,618,597
2020,7,Horta-Guinardó,37,el Carmel,7062,1355,708,647
2020,7,Horta-Guinardó,37,el Carmel,7063,1469,769,700
2020,7,Horta-Guinardó,37,el Carmel,7064,1693,876,817
2020,7,Horta-Guinardó,37,el Carmel,7065,1727,913,814
2020,7,Horta-Guinardó,37,el Carmel,7066,1852,965,887
2020,7,Horta-Guinardó,37,el Carmel,7067,1549,831,718
2020,7,Horta-Guinardó,37,el Carmel,7068,1316,712,604
2020,7,Horta-Guinardó,37,el Carmel,7069,1420,742,678
2020,7,Horta-Guinardó,37,el Carmel,7070,1459,767,692
2020,7,Horta-Guinardó,37,el Carmel,7071,1342,715,627
2020,7,Horta-Guinardó,37,el Carmel,7072,1406,749,657
2020,7,Horta-Guinardó,37,el Carmel,7073,1144,627,517
2020,7,Horta-Guinardó,37,el Carmel,7074,1693,887,806
2020,7,Horta-Guinardó,37,el Carmel,7075,1229,634,595
2020,7,Horta-Guinardó,37,el Carmel,7076,1374,713,661
2020,7,Horta-Guinardó,37,el Carmel,7077,1348,703,645
2020,7,Horta-Guinardó,37,el Carmel,7078,1422,728,694
2020,7,Horta-Guinardó,37,el Carmel,7079,1480,777,703
2020,7,Horta-Guinardó,37,el Carmel,7080,1811,956,855
2020,7,Horta-Guinardó,38,la Teixonera,7081,1976,1019,957
2020,7,Horta-Guinardó,38,la Teixonera,7082,1296,680,616
2020,7,Horta-Guinardó,38,la Teixonera,7083,1327,702,625
2020,7,Horta-Guinardó,38,la Teixonera,7084,1343,680,663
2020,7,Horta-Guinardó,38,la Teixonera,7085,1265,647,618
2020,7,Horta-Guinardó,38,la Teixonera,7086,1466,772,694
2020,7,Horta-Guinardó,38,la Teixonera,7087,1604,855,749
2020,7,Horta-Guinardó,38,la Teixonera,7088,1650,857,793
2020,7,Horta-Guinardó,39,Sant Genís dels Agudells,7089,1367,756,611
2020,7,Horta-Guinardó,39,Sant Genís dels Agudells,7090,1459,758,701
2020,7,Horta-Guinardó,39,Sant Genís dels Agudells,7091,1233,653,580
2020,7,Horta-Guinardó,39,Sant Genís dels Agudells,7092,1562,868,694
2020,7,Horta-Guinardó,39,Sant Genís dels Agudells,7093,1769,885,884
2020,7,Horta-Guinardó,40,Montbau,7094,1266,695,571
2020,7,Horta-Guinardó,40,Montbau,7095,1549,826,723
2020,7,Horta-Guinardó,40,Montbau,7096,1462,812,650
2020,7,Horta-Guinardó,40,Montbau,7097,895,509,386
2020,7,Horta-Guinardó,41,la Vall d'Hebron,7098,2211,1189,1022
2020,7,Horta-Guinardó,41,la Vall d'Hebron,7099,1022,531,491
2020,7,Horta-Guinardó,41,la Vall d'Hebron,7100,1223,662,561
2020,7,Horta-Guinardó,41,la Vall d'Hebron,7101,1430,758,672
2020,7,Horta-Guinardó,42,la Clota,7102,709,344,365
2020,7,Horta-Guinardó,43,Horta,7103,1644,870,774
2020,7,Horta-Guinardó,43,Horta,7104,1584,844,740
2020,7,Horta-Guinardó,43,Horta,7105,1057,562,495
2020,7,Horta-Guinardó,43,Horta,7106,1199,648,551
2020,7,Horta-Guinardó,43,Horta,7107,1204,626,578
2020,7,Horta-Guinardó,43,Horta,7108,1243,653,590
2020,7,Horta-Guinardó,43,Horta,7109,1645,865,780
2020,7,Horta-Guinardó,43,Horta,7110,1059,605,454
2020,7,Horta-Guinardó,43,Horta,7111,923,523,400
2020,7,Horta-Guinardó,43,Horta,7112,1295,682,613
2020,7,Horta-Guinardó,43,Horta,7113,1227,647,580
2020,7,Horta-Guinardó,43,Horta,7114,1210,646,564
2020,7,Horta-Guinardó,43,Horta,7115,1054,570,484
2020,7,Horta-Guinardó,43,Horta,7116,1510,818,692
2020,7,Horta-Guinardó,43,Horta,7117,2734,1321,1413
2020,7,Horta-Guinardó,43,Horta,7118,1280,700,580
2020,7,Horta-Guinardó,43,Horta,7119,1274,686,588
2020,7,Horta-Guinardó,43,Horta,7120,1274,699,575
2020,7,Horta-Guinardó,43,Horta,7121,1187,664,523
2020,7,Horta-Guinardó,43,Horta,7122,1336,738,598
2020,7,Horta-Guinardó,43,Horta,7123,1424,749,675
2020,8,Nou Barris,44,Vilapicina i la Torre Llobeta,8001,1252,669,583
2020,8,Nou Barris,44,Vilapicina i la Torre Llobeta,8002,1277,689,588
2020,8,Nou Barris,44,Vilapicina i la Torre Llobeta,8003,1249,652,597
2020,8,Nou Barris,44,Vilapicina i la Torre Llobeta,8004,1443,791,652
2020,8,Nou Barris,44,Vilapicina i la Torre Llobeta,8005,1163,620,543
2020,8,Nou Barris,44,Vilapicina i la Torre Llobeta,8006,1589,838,751
2020,8,Nou Barris,44,Vilapicina i la Torre Llobeta,8007,1203,676,527
2020,8,Nou Barris,44,Vilapicina i la Torre Llobeta,8008,1660,889,771
2020,8,Nou Barris,44,Vilapicina i la Torre Llobeta,8009,1752,916,836
2020,8,Nou Barris,44,Vilapicina i la Torre Llobeta,8010,1105,609,496
2020,8,Nou Barris,44,Vilapicina i la Torre Llobeta,8011,1200,648,552
2020,8,Nou Barris,44,Vilapicina i la Torre Llobeta,8012,1339,753,586
2020,8,Nou Barris,44,Vilapicina i la Torre Llobeta,8013,1184,645,539
2020,8,Nou Barris,44,Vilapicina i la Torre Llobeta,8014,1309,714,595
2020,8,Nou Barris,44,Vilapicina i la Torre Llobeta,8015,1452,823,629
2020,8,Nou Barris,44,Vilapicina i la Torre Llobeta,8016,1166,644,522
2020,8,Nou Barris,44,Vilapicina i la Torre Llobeta,8017,1370,725,645
2020,8,Nou Barris,44,Vilapicina i la Torre Llobeta,8018,1551,827,724
2020,8,Nou Barris,44,Vilapicina i la Torre Llobeta,8019,1819,981,838
2020,8,Nou Barris,45,Porta,8020,1406,758,648
2020,8,Nou Barris,45,Porta,8021,1499,810,689
2020,8,Nou Barris,45,Porta,8022,1278,689,589
2020,8,Nou Barris,45,Porta,8023,1402,748,654
2020,8,Nou Barris,45,Porta,8024,1368,745,623
2020,8,Nou Barris,45,Porta,8025,1194,665,529
2020,8,Nou Barris,45,Porta,8026,1420,764,656
2020,8,Nou Barris,45,Porta,8027,1408,717,691
2020,8,Nou Barris,45,Porta,8028,1123,622,501
2020,8,Nou Barris,45,Porta,8029,1553,835,718
2020,8,Nou Barris,45,Porta,8030,1514,795,719
2020,8,Nou Barris,45,Porta,8031,1306,695,611
2020,8,Nou Barris,45,Porta,8032,1305,708,597
2020,8,Nou Barris,45,Porta,8033,1456,774,682
2020,8,Nou Barris,45,Porta,8034,1311,747,564
2020,8,Nou Barris,45,Porta,8035,4142,2013,2129
2020,8,Nou Barris,45,Porta,8036,1564,843,721
2020,8,Nou Barris,45,Porta,8037,1564,871,693
2020,8,Nou Barris,46,el Turó de la Peira,8038,1580,859,721
2020,8,Nou Barris,46,el Turó de la Peira,8039,1558,821,737
2020,8,Nou Barris,46,el Turó de la Peira,8040,1931,1005,926
2020,8,Nou Barris,46,el Turó de la Peira,8041,2534,1314,1220
2020,8,Nou Barris,46,el Turó de la Peira,8042,1274,708,566
2020,8,Nou Barris,46,el Turó de la Peira,8043,1147,653,494
2020,8,Nou Barris,46,el Turó de la Peira,8044,1345,717,628
2020,8,Nou Barris,46,el Turó de la Peira,8045,1791,925,866
2020,8,Nou Barris,46,el Turó de la Peira,8046,1421,794,627
2020,8,Nou Barris,46,el Turó de la Peira,8047,1648,886,762
2020,8,Nou Barris,47,Can Peguera,8048,1008,537,471
2020,8,Nou Barris,47,Can Peguera,8049,1266,669,597
2020,8,Nou Barris,48,la Guineueta,8050,1425,753,672
2020,8,Nou Barris,48,la Guineueta,8051,1350,699,651
2020,8,Nou Barris,48,la Guineueta,8052,896,498,398
2020,8,Nou Barris,48,la Guineueta,8053,1162,622,540
2020,8,Nou Barris,48,la Guineueta,8054,1710,945,765
2020,8,Nou Barris,48,la Guineueta,8055,1841,969,872
2020,8,Nou Barris,48,la Guineueta,8056,1499,790,709
2020,8,Nou Barris,48,la Guineueta,8057,1344,727,617
2020,8,Nou Barris,48,la Guineueta,8058,1631,886,745
2020,8,Nou Barris,48,la Guineueta,8059,988,525,463
2020,8,Nou Barris,48,la Guineueta,8215,1574,889,685
2020,8,Nou Barris,49,Canyelles,8060,1200,653,547
2020,8,Nou Barris,49,Canyelles,8061,1645,852,793
2020,8,Nou Barris,49,Canyelles,8062,1165,614,551
2020,8,Nou Barris,49,Canyelles,8063,1067,557,510
2020,8,Nou Barris,49,Canyelles,8064,1792,944,848
2020,8,Nou Barris,50,les Roquetes,8065,1755,868,887
2020,8,Nou Barris,50,les Roquetes,8066,1629,832,797
2020,8,Nou Barris,50,les Roquetes,8067,1796,920,876
2020,8,Nou Barris,50,les Roquetes,8068,1944,1020,924
2020,8,Nou Barris,50,les Roquetes,8069,1584,837,747
2020,8,Nou Barris,50,les Roquetes,8070,1483,790,693
2020,8,Nou Barris,50,les Roquetes,8071,1753,898,855
2020,8,Nou Barris,50,les Roquetes,8072,1185,631,554
2020,8,Nou Barris,50,les Roquetes,8073,1753,930,823
2020,8,Nou Barris,50,les Roquetes,8074,1512,775,737
2020,8,Nou Barris,51,Verdun,8075,1949,1054,895
2020,8,Nou Barris,51,Verdun,8076,1618,878,740
2020,8,Nou Barris,51,Verdun,8077,1438,778,660
2020,8,Nou Barris,51,Verdun,8078,1566,822,744
2020,8,Nou Barris,51,Verdun,8079,1442,769,673
2020,8,Nou Barris,51,Verdun,8080,1541,795,746
2020,8,Nou Barris,51,Verdun,8081,1658,865,793
2020,8,Nou Barris,51,Verdun,8082,1586,871,715
2020,8,Nou Barris,52,la Prosperitat,8083,1326,721,605
2020,8,Nou Barris,52,la Prosperitat,8084,1159,630,529
2020,8,Nou Barris,52,la Prosperitat,8085,1475,759,716
2020,8,Nou Barris,52,la Prosperitat,8086,1718,921,797
2020,8,Nou Barris,52,la Prosperitat,8087,1279,688,591
2020,8,Nou Barris,52,la Prosperitat,8088,1284,679,605
2020,8,Nou Barris,52,la Prosperitat,8089,1244,666,578
2020,8,Nou Barris,52,la Prosperitat,8090,1244,670,574
2020,8,Nou Barris,52,la Prosperitat,8091,1216,647,569
2020,8,Nou Barris,52,la Prosperitat,8092,995,521,474
2020,8,Nou Barris,52,la Prosperitat,8093,1273,648,625
2020,8,Nou Barris,52,la Prosperitat,8094,1456,757,699
2020,8,Nou Barris,52,la Prosperitat,8095,1057,554,503
2020,8,Nou Barris,52,la Prosperitat,8096,1551,803,748
2020,8,Nou Barris,52,la Prosperitat,8097,1381,724,657
2020,8,Nou Barris,52,la Prosperitat,8098,1292,688,604
2020,8,Nou Barris,52,la Prosperitat,8099,1429,735,694
2020,8,Nou Barris,52,la Prosperitat,8100,1299,726,573
2020,8,Nou Barris,52,la Prosperitat,8101,1760,941,819
2020,8,Nou Barris,52,la Prosperitat,8102,1588,894,694
2020,8,Nou Barris,53,la Trinitat Nova,8103,1659,838,821
2020,8,Nou Barris,53,la Trinitat Nova,8104,1304,679,625
2020,8,Nou Barris,53,la Trinitat Nova,8105,1490,810,680
2020,8,Nou Barris,53,la Trinitat Nova,8106,1293,666,627
2020,8,Nou Barris,53,la Trinitat Nova,8107,1923,1024,899
2020,8,Nou Barris,54,Torre Baró,8108,1946,984,962
2020,8,Nou Barris,54,Torre Baró,8109,979,483,496
2020,8,Nou Barris,55,Ciutat Meridiana,8110,2001,1013,988
2020,8,Nou Barris,55,Ciutat Meridiana,8111,1706,895,811
2020,8,Nou Barris,55,Ciutat Meridiana,8112,1776,897,879
2020,8,Nou Barris,55,Ciutat Meridiana,8113,1808,928,880
2020,8,Nou Barris,55,Ciutat Meridiana,8114,2052,1043,1009
2020,8,Nou Barris,55,Ciutat Meridiana,8115,1748,899,849
2020,8,Nou Barris,56,Vallbona,8116,1421,735,686
2020,9,Sant Andreu,57,la Trinitat Vella,9001,2738,1296,1442
2020,9,Sant Andreu,57,la Trinitat Vella,9002,2129,1053,1076
2020,9,Sant Andreu,57,la Trinitat Vella,9003,2235,1087,1148
2020,9,Sant Andreu,57,la Trinitat Vella,9004,1735,878,857
2020,9,Sant Andreu,57,la Trinitat Vella,9005,1650,829,821
2020,9,Sant Andreu,58,Baró de Viver,9006,1283,647,636
2020,9,Sant Andreu,58,Baró de Viver,9007,1342,699,643
2020,9,Sant Andreu,59,el Bon Pastor,9008,1895,939,956
2020,9,Sant Andreu,59,el Bon Pastor,9009,1451,742,709
2020,9,Sant Andreu,59,el Bon Pastor,9010,1833,946,887
2020,9,Sant Andreu,59,el Bon Pastor,9011,1715,889,826
2020,9,Sant Andreu,59,el Bon Pastor,9013,2000,1045,955
2020,9,Sant Andreu,59,el Bon Pastor,9014,2934,1341,1593
2020,9,Sant Andreu,59,el Bon Pastor,9015,1824,931,893
2020,9,Sant Andreu,60,Sant Andreu,9016,1358,727,631
2020,9,Sant Andreu,60,Sant Andreu,9017,1531,797,734
2020,9,Sant Andreu,60,Sant Andreu,9018,1495,784,711
2020,9,Sant Andreu,60,Sant Andreu,9019,2719,1391,1328
2020,9,Sant Andreu,60,Sant Andreu,9020,1151,633,518
2020,9,Sant Andreu,60,Sant Andreu,9021,1386,730,656
2020,9,Sant Andreu,60,Sant Andreu,9022,1272,664,608
2020,9,Sant Andreu,60,Sant Andreu,9023,1222,620,602
2020,9,Sant Andreu,60,Sant Andreu,9024,1158,645,513
2020,9,Sant Andreu,60,Sant Andreu,9025,1229,670,559
2020,9,Sant Andreu,60,Sant Andreu,9026,1582,832,750
2020,9,Sant Andreu,60,Sant Andreu,9027,1306,672,634
2020,9,Sant Andreu,60,Sant Andreu,9028,1616,833,783
2020,9,Sant Andreu,60,Sant Andreu,9029,1135,592,543
2020,9,Sant Andreu,60,Sant Andreu,9030,1470,783,687
2020,9,Sant Andreu,60,Sant Andreu,9031,1197,609,588
2020,9,Sant Andreu,60,Sant Andreu,9032,2212,1177,1035
2020,9,Sant Andreu,60,Sant Andreu,9033,3234,1673,1561
2020,9,Sant Andreu,60,Sant Andreu,9034,1402,745,657
2020,9,Sant Andreu,60,Sant Andreu,9035,1577,825,752
2020,9,Sant Andreu,60,Sant Andreu,9036,1404,753,651
2020,9,Sant Andreu,60,Sant Andreu,9037,1585,813,772
2020,9,Sant Andreu,60,Sant Andreu,9038,1740,936,804
2020,9,Sant Andreu,60,Sant Andreu,9039,1564,832,732
2020,9,Sant Andreu,60,Sant Andreu,9040,1601,864,737
2020,9,Sant Andreu,60,Sant Andreu,9041,1405,766,639
2020,9,Sant Andreu,60,Sant Andreu,9042,1293,699,594
2020,9,Sant Andreu,60,Sant Andreu,9043,1344,730,614
2020,9,Sant Andreu,60,Sant Andreu,9044,1489,752,737
2020,9,Sant Andreu,60,Sant Andreu,9045,1439,775,664
2020,9,Sant Andreu,60,Sant Andreu,9046,1341,703,638
2020,9,Sant Andreu,60,Sant Andreu,9047,1578,830,748
2020,9,Sant Andreu,60,Sant Andreu,9048,1383,738,645
2020,9,Sant Andreu,60,Sant Andreu,9049,1338,727,611
2020,9,Sant Andreu,60,Sant Andreu,9050,1583,824,759
2020,9,Sant Andreu,60,Sant Andreu,9051,1245,650,595
2020,9,Sant Andreu,60,Sant Andreu,9052,1224,647,577
2020,9,Sant Andreu,60,Sant Andreu,9053,1595,856,739
2020,9,Sant Andreu,60,Sant Andreu,9054,1105,597,508
2020,9,Sant Andreu,61,la Sagrera,9055,1707,899,808
2020,9,Sant Andreu,61,la Sagrera,9056,1154,604,550
2020,9,Sant Andreu,61,la Sagrera,9057,1665,869,796
2020,9,Sant Andreu,61,la Sagrera,9058,1516,822,694
2020,9,Sant Andreu,61,la Sagrera,9059,1428,734,694
2020,9,Sant Andreu,61,la Sagrera,9060,1340,737,603
2020,9,Sant Andreu,61,la Sagrera,9061,1714,884,830
2020,9,Sant Andreu,61,la Sagrera,9062,1162,603,559
2020,9,Sant Andreu,61,la Sagrera,9063,1156,602,554
2020,9,Sant Andreu,61,la Sagrera,9064,1171,621,550
2020,9,Sant Andreu,61,la Sagrera,9065,2127,1142,985
2020,9,Sant Andreu,61,la Sagrera,9066,1493,768,725
2020,9,Sant Andreu,61,la Sagrera,9067,1561,852,709
2020,9,Sant Andreu,61,la Sagrera,9068,1595,815,780
2020,9,Sant Andreu,61,la Sagrera,9069,896,498,398
2020,9,Sant Andreu,61,la Sagrera,9070,1719,952,767
2020,9,Sant Andreu,61,la Sagrera,9071,1920,1060,860
2020,9,Sant Andreu,61,la Sagrera,9072,1503,822,681
2020,9,Sant Andreu,61,la Sagrera,9073,1528,807,721
2020,9,Sant Andreu,61,la Sagrera,9156,1253,664,589
2020,9,Sant Andreu,62,el Congrés i els Indians,9074,1679,890,789
2020,9,Sant Andreu,62,el Congrés i els Indians,9075,1588,835,753
2020,9,Sant Andreu,62,el Congrés i els Indians,9076,1506,831,675
2020,9,Sant Andreu,62,el Congrés i els Indians,9077,1645,917,728
2020,9,Sant Andreu,62,el Congrés i els Indians,9078,1443,767,676
2020,9,Sant Andreu,62,el Congrés i els Indians,9079,1663,867,796
2020,9,Sant Andreu,62,el Congrés i els Indians,9080,1381,703,678
2020,9,Sant Andreu,62,el Congrés i els Indians,9081,1763,951,812
2020,9,Sant Andreu,62,el Congrés i els Indians,9082,2058,1085,973
2020,9,Sant Andreu,63,Navas,9083,1631,867,764
2020,9,Sant Andreu,63,Navas,9084,1779,921,858
2020,9,Sant Andreu,63,Navas,9085,1772,957,815
2020,9,Sant Andreu,63,Navas,9086,1472,793,679
2020,9,Sant Andreu,63,Navas,9087,1344,703,641
2020,9,Sant Andreu,63,Navas,9088,1915,1064,851
2020,9,Sant Andreu,63,Navas,9089,1526,834,692
2020,9,Sant Andreu,63,Navas,9090,1627,884,743
2020,9,Sant Andreu,63,Navas,9091,1935,1030,905
2020,9,Sant Andreu,63,Navas,9092,1945,1013,932
2020,9,Sant Andreu,63,Navas,9093,1345,720,625
2020,9,Sant Andreu,63,Navas,9094,2073,1080,993
2020,9,Sant Andreu,63,Navas,9095,2093,1105,988
2020,10,Sant Martí,64,Camp de l'Arpa del Clot,10001,1598,815,783
2020,10,Sant Martí,64,Camp de l'Arpa del Clot,10002,1757,910,847
2020,10,Sant Martí,64,Camp de l'Arpa del Clot,10003,1582,824,758
2020,10,Sant Martí,64,Camp de l'Arpa del Clot,10004,1565,853,712
2020,10,Sant Martí,64,Camp de l'Arpa del Clot,10005,1678,931,747
2020,10,Sant Martí,64,Camp de l'Arpa del Clot,10006,1867,997,870
2020,10,Sant Martí,64,Camp de l'Arpa del Clot,10007,1331,687,644
2020,10,Sant Martí,64,Camp de l'Arpa del Clot,10008,1735,959,776
2020,10,Sant Martí,64,Camp de l'Arpa del Clot,10009,1640,876,764
2020,10,Sant Martí,64,Camp de l'Arpa del Clot,10010,1748,937,811
2020,10,Sant Martí,64,Camp de l'Arpa del Clot,10011,1212,655,557
2020,10,Sant Martí,64,Camp de l'Arpa del Clot,10012,1845,976,869
2020,10,Sant Martí,64,Camp de l'Arpa del Clot,10013,1429,777,652
2020,10,Sant Martí,64,Camp de l'Arpa del Clot,10014,1535,821,714
2020,10,Sant Martí,64,Camp de l'Arpa del Clot,10015,1980,1029,951
2020,10,Sant Martí,64,Camp de l'Arpa del Clot,10016,1273,645,628
2020,10,Sant Martí,64,Camp de l'Arpa del Clot,10017,1703,932,771
2020,10,Sant Martí,64,Camp de l'Arpa del Clot,10018,1470,767,703
2020,10,Sant Martí,64,Camp de l'Arpa del Clot,10019,1601,847,754
2020,10,Sant Martí,64,Camp de l'Arpa del Clot,10020,1466,761,705
2020,10,Sant Martí,64,Camp de l'Arpa del Clot,10021,1396,730,666
2020,10,Sant Martí,64,Camp de l'Arpa del Clot,10022,1381,756,625
2020,10,Sant Martí,64,Camp de l'Arpa del Clot,10023,1494,822,672
2020,10,Sant Martí,64,Camp de l'Arpa del Clot,10024,1486,761,725
2020,10,Sant Martí,64,Camp de l'Arpa del Clot,10025,1364,751,613
2020,10,Sant Martí,65,el Clot,10026,1545,809,736
2020,10,Sant Martí,65,el Clot,10027,1501,786,715
2020,10,Sant Martí,65,el Clot,10028,1800,921,879
2020,10,Sant Martí,65,el Clot,10029,1466,763,703
2020,10,Sant Martí,65,el Clot,10030,1793,955,838
2020,10,Sant Martí,65,el Clot,10031,1579,808,771
2020,10,Sant Martí,65,el Clot,10032,1390,725,665
2020,10,Sant Martí,65,el Clot,10033,872,480,392
2020,10,Sant Martí,65,el Clot,10034,1707,884,823
2020,10,Sant Martí,65,el Clot,10035,1999,1025,974
2020,10,Sant Martí,65,el Clot,10036,1472,734,738
2020,10,Sant Martí,65,el Clot,10037,1079,569,510
2020,10,Sant Martí,65,el Clot,10038,1611,847,764
2020,10,Sant Martí,65,el Clot,10039,1884,1005,879
2020,10,Sant Martí,65,el Clot,10040,1879,946,933
2020,10,Sant Martí,65,el Clot,10041,1659,871,788
2020,10,Sant Martí,65,el Clot,10234,1846,1002,844
2020,10,Sant Martí,66,el Parc i la Llacuna del Poblenou,10042,3021,1580,1441
2020,10,Sant Martí,66,el Parc i la Llacuna del Poblenou,10043,2369,1174,1195
2020,10,Sant Martí,66,el Parc i la Llacuna del Poblenou,10044,1587,836,751
2020,10,Sant Martí,66,el Parc i la Llacuna del Poblenou,10045,1300,676,624
2020,10,Sant Martí,66,el Parc i la Llacuna del Poblenou,10046,1242,644,598
2020,10,Sant Martí,66,el Parc i la Llacuna del Poblenou,10047,1825,949,876
2020,10,Sant Martí,66,el Parc i la Llacuna del Poblenou,10048,1728,872,856
2020,10,Sant Martí,66,el Parc i la Llacuna del Poblenou,10049,1293,644,649
2020,10,Sant Martí,66,el Parc i la Llacuna del Poblenou,10050,1578,835,743
2020,10,Sant Martí,67,la Vila Olímpica del Poblenou,10051,1597,836,761
2020,10,Sant Martí,67,la Vila Olímpica del Poblenou,10052,2437,1216,1221
2020,10,Sant Martí,67,la Vila Olímpica del Poblenou,10053,1763,901,862
2020,10,Sant Martí,67,la Vila Olímpica del Poblenou,10054,961,503,458
2020,10,Sant Martí,67,la Vila Olímpica del Poblenou,10055,2627,1331,1296
2020,10,Sant Martí,68,el Poblenou,10056,1929,980,949
2020,10,Sant Martí,68,el Poblenou,10057,1458,731,727
2020,10,Sant Martí,68,el Poblenou,10058,1166,592,574
2020,10,Sant Martí,68,el Poblenou,10059,1773,935,838
2020,10,Sant Martí,68,el Poblenou,10060,1631,816,815
2020,10,Sant Martí,68,el Poblenou,10061,1781,926,855
2020,10,Sant Martí,68,el Poblenou,10062,1528,790,738
2020,10,Sant Martí,68,el Poblenou,10063,1232,636,596
2020,10,Sant Martí,68,el Poblenou,10064,1696,884,812
2020,10,Sant Martí,68,el Poblenou,10065,1604,841,763
2020,10,Sant Martí,68,el Poblenou,10066,2141,1082,1059
2020,10,Sant Martí,68,el Poblenou,10067,1911,1001,910
2020,10,Sant Martí,68,el Poblenou,10068,1659,836,823
2020,10,Sant Martí,68,el Poblenou,10069,2744,1422,1322
2020,10,Sant Martí,68,el Poblenou,10070,1655,892,763
2020,10,Sant Martí,68,el Poblenou,10071,1816,928,888
2020,10,Sant Martí,68,el Poblenou,10072,1994,1004,990
2020,10,Sant Martí,68,el Poblenou,10073,1471,762,709
2020,10,Sant Martí,68,el Poblenou,10074,1688,875,813
2020,10,Sant Martí,68,el Poblenou,10075,1559,796,763
2020,10,Sant Martí,69,Diagonal Mar i el Front Marítim del Poblenou,10076,2220,1145,1075
2020,10,Sant Martí,69,Diagonal Mar i el Front Marítim del Poblenou,10077,1816,908,908
2020,10,Sant Martí,69,Diagonal Mar i el Front Marítim del Poblenou,10078,2449,1241,1208
2020,10,Sant Martí,69,Diagonal Mar i el Front Marítim del Poblenou,10079,1781,929,852
2020,10,Sant Martí,69,Diagonal Mar i el Front Marítim del Poblenou,10080,2297,1151,1146
2020,10,Sant Martí,69,Diagonal Mar i el Front Marítim del Poblenou,10235,1342,709,633
2020,10,Sant Martí,69,Diagonal Mar i el Front Marítim del Poblenou,10236,1621,869,752
2020,10,Sant Martí,70,el Besòs i el Maresme,10081,2083,1042,1041
2020,10,Sant Martí,70,el Besòs i el Maresme,10082,2042,991,1051
2020,10,Sant Martí,70,el Besòs i el Maresme,10083,2276,986,1290
2020,10,Sant Martí,70,el Besòs i el Maresme,10084,1662,825,837
2020,10,Sant Martí,70,el Besòs i el Maresme,10085,2116,1044,1072
2020,10,Sant Martí,70,el Besòs i el Maresme,10086,1961,983,978
2020,10,Sant Martí,70,el Besòs i el Maresme,10087,1821,930,891
2020,10,Sant Martí,70,el Besòs i el Maresme,10088,1681,850,831
2020,10,Sant Martí,70,el Besòs i el Maresme,10089,4092,1622,2470
2020,10,Sant Martí,70,el Besòs i el Maresme,10090,1464,768,696
2020,10,Sant Martí,70,el Besòs i el Maresme,10091,1976,1009,967
2020,10,Sant Martí,70,el Besòs i el Maresme,10092,1464,780,684
2020,10,Sant Martí,70,el Besòs i el Maresme,10093,1067,550,517
2020,10,Sant Martí,71,Provençals del Poblenou,10094,3026,1512,1514
2020,10,Sant Martí,71,Provençals del Poblenou,10095,1310,655,655
2020,10,Sant Martí,71,Provençals del Poblenou,10096,1660,883,777
2020,10,Sant Martí,71,Provençals del Poblenou,10097,1633,862,771
2020,10,Sant Martí,71,Provençals del Poblenou,10098,1830,954,876
2020,10,Sant Martí,71,Provençals del Poblenou,10099,1140,603,537
2020,10,Sant Martí,71,Provençals del Poblenou,10100,1693,911,782
2020,10,Sant Martí,71,Provençals del Poblenou,10101,1665,814,851
2020,10,Sant Martí,71,Provençals del Poblenou,10102,2647,1388,1259
2020,10,Sant Martí,71,Provençals del Poblenou,10103,2202,1156,1046
2020,10,Sant Martí,71,Provençals del Poblenou,10104,1595,839,756
2020,10,Sant Martí,71,Provençals del Poblenou,10237,918,503,415
2020,10,Sant Martí,72,Sant Martí de Provençals,10105,2241,1208,1033
2020,10,Sant Martí,72,Sant Martí de Provençals,10106,1030,551,479
2020,10,Sant Martí,72,Sant Martí de Provençals,10107,1577,818,759
2020,10,Sant Martí,72,Sant Martí de Provençals,10108,1307,709,598
2020,10,Sant Martí,72,Sant Martí de Provençals,10109,1610,864,746
2020,10,Sant Martí,72,Sant Martí de Provençals,10110,1663,934,729
2020,10,Sant Martí,72,Sant Martí de Provençals,10111,1309,695,614
2020,10,Sant Martí,72,Sant Martí de Provençals,10112,1559,803,756
2020,10,Sant Martí,72,Sant Martí de Provençals,10113,1196,622,574
2020,10,Sant Martí,72,Sant Martí de Provençals,10114,1430,742,688
2020,10,Sant Martí,72,Sant Martí de Provençals,10115,1397,736,661
2020,10,Sant Martí,72,Sant Martí de Provençals,10116,1862,1002,860
2020,10,Sant Martí,72,Sant Martí de Provençals,10117,1270,670,600
2020,10,Sant Martí,72,Sant Martí de Provençals,10118,1009,538,471
2020,10,Sant Martí,72,Sant Martí de Provençals,10119,1174,638,536
2020,10,Sant Martí,72,Sant Martí de Provençals,10120,1477,811,666
2020,10,Sant Martí,72,Sant Martí de Provençals,10121,1573,826,747
2020,10,Sant Martí,72,Sant Martí de Provençals,10122,1484,778,706
2020,10,Sant Martí,73,la Verneda i la Pau,10123,1349,699,650
2020,10,Sant Martí,73,la Verneda i la Pau,10124,1103,576,527
2020,10,Sant Martí,73,la Verneda i la Pau,10125,1083,559,524
2020,10,Sant Martí,73,la Verneda i la Pau,10126,1017,528,489
2020,10,Sant Martí,73,la Verneda i la Pau,10127,1011,512,499
2020,10,Sant Martí,73,la Verneda i la Pau,10128,1572,847,725
2020,10,Sant Martí,73,la Verneda i la Pau,10129,1168,597,571
2020,10,Sant Martí,73,la Verneda i la Pau,10130,1200,630,570
2020,10,Sant Martí,73,la Verneda i la Pau,10131,1149,614,535
2020,10,Sant Martí,73,la Verneda i la Pau,10132,1287,696,591
2020,10,Sant Martí,73,la Verneda i la Pau,10133,1703,897,806
2020,10,Sant Martí,73,la Verneda i la Pau,10134,1582,876,706
2020,10,Sant Martí,73,la Verneda i la Pau,10135,1256,660,596
2020,10,Sant Martí,73,la Verneda i la Pau,10136,1374,729,645
2020,10,Sant Martí,73,la Verneda i la Pau,10137,1594,818,776
2020,10,Sant Martí,73,la Verneda i la Pau,10138,1629,863,766
2020,10,Sant Martí,73,la Verneda i la Pau,10139,1679,867,812
2020,10,Sant Martí,73,la Verneda i la Pau,10140,1635,845,790
2020,10,Sant Martí,73,la Verneda i la Pau,10141,1124,588,536
2020,10,Sant Martí,73,la Verneda i la Pau,10142,1634,858,776
2020,10,Sant Martí,73,la Verneda i la Pau,10143,1729,912,817
2021,1,Ciutat Vella,1,el Raval,1001,1311,606,705
2021,1,Ciutat Vella,1,el Raval,1002,1489,704,785
2021,1,Ciutat Vella,1,el Raval,1003,3661,1636,2025
2021,1,Ciutat Vella,1,el Raval,1004,2972,1340,1632
2021,1,Ciutat Vella,1,el Raval,1005,2448,1140,1308
2021,1,Ciutat Vella,1,el Raval,1006,1631,704,927
2021,1,Ciutat Vella,1,el Raval,1007,2015,804,1211
2021,1,Ciutat Vella,1,el Raval,1008,3397,1361,2036
2021,1,Ciutat Vella,1,el Raval,1009,2244,1016,1228
2021,1,Ciutat Vella,1,el Raval,1010,2501,1126,1375
2021,1,Ciutat Vella,1,el Raval,1011,3340,1478,1862
2021,1,Ciutat Vella,1,el Raval,1012,1946,954,992
2021,1,Ciutat Vella,1,el Raval,1013,1471,760,711
2021,1,Ciutat Vella,1,el Raval,1014,2154,954,1200
2021,1,Ciutat Vella,1,el Raval,1015,2355,1151,1204
2021,1,Ciutat Vella,1,el Raval,1016,2159,1068,1091
2021,1,Ciutat Vella,1,el Raval,1017,2594,1298,1296
2021,1,Ciutat Vella,1,el Raval,1018,1568,765,803
2021,1,Ciutat Vella,1,el Raval,1019,3005,1373,1632
2021,1,Ciutat Vella,1,el Raval,1020,2237,1158,1079
2021,1,Ciutat Vella,1,el Raval,1021,2190,1070,1120
2021,1,Ciutat Vella,2,el Barri Gòtic,1022,1570,736,834
2021,1,Ciutat Vella,2,el Barri Gòtic,1023,2098,1056,1042
2021,1,Ciutat Vella,2,el Barri Gòtic,1025,1387,683,704
2021,1,Ciutat Vella,2,el Barri Gòtic,1026,8690,1855,6835
2021,1,Ciutat Vella,2,el Barri Gòtic,1027,1564,794,770
2021,1,Ciutat Vella,2,el Barri Gòtic,1028,1959,1009,950
2021,1,Ciutat Vella,2,el Barri Gòtic,1029,1481,723,758
2021,1,Ciutat Vella,2,el Barri Gòtic,1030,2495,1237,1258
2021,1,Ciutat Vella,2,el Barri Gòtic,1031,1606,750,856
2021,1,Ciutat Vella,3,la Barceloneta,1032,1862,918,944
2021,1,Ciutat Vella,3,la Barceloneta,1033,1131,553,578
2021,1,Ciutat Vella,3,la Barceloneta,1034,962,488,474
2021,1,Ciutat Vella,3,la Barceloneta,1035,1255,621,634
2021,1,Ciutat Vella,3,la Barceloneta,1036,1194,628,566
2021,1,Ciutat Vella,3,la Barceloneta,1037,1381,726,655
2021,1,Ciutat Vella,3,la Barceloneta,1038,1537,726,811
2021,1,Ciutat Vella,3,la Barceloneta,1039,1375,687,688
2021,1,Ciutat Vella,3,la Barceloneta,1040,1089,554,535
2021,1,Ciutat Vella,3,la Barceloneta,1041,1577,801,776
2021,1,Ciutat Vella,3,la Barceloneta,1042,1762,945,817
2021,1,Ciutat Vella,4,"Sant Pere, Santa Caterina i la Ribera",1043,1629,791,838
2021,1,Ciutat Vella,4,"Sant Pere, Santa Caterina i la Ribera",1044,1425,747,678
2021,1,Ciutat Vella,4,"Sant Pere, Santa Caterina i la Ribera",1045,2012,1006,1006
2021,1,Ciutat Vella,4,"Sant Pere, Santa Caterina i la Ribera",1046,1792,862,930
2021,1,Ciutat Vella,4,"Sant Pere, Santa Caterina i la Ribera",1047,1781,932,849
2021,1,Ciutat Vella,4,"Sant Pere, Santa Caterina i la Ribera",1048,2139,1095,1044
2021,1,Ciutat Vella,4,"Sant Pere, Santa Caterina i la Ribera",1049,1520,799,721
2021,1,Ciutat Vella,4,"Sant Pere, Santa Caterina i la Ribera",1050,1544,764,780
2021,1,Ciutat Vella,4,"Sant Pere, Santa Caterina i la Ribera",1051,1863,908,955
2021,1,Ciutat Vella,4,"Sant Pere, Santa Caterina i la Ribera",1052,2858,1265,1593
2021,1,Ciutat Vella,4,"Sant Pere, Santa Caterina i la Ribera",1053,1862,969,893
2021,1,Ciutat Vella,4,"Sant Pere, Santa Caterina i la Ribera",1054,1268,619,649
2021,1,Ciutat Vella,4,"Sant Pere, Santa Caterina i la Ribera",1055,1316,674,642
2021,2,Eixample,5,el Fort Pienc,2001,1279,648,631
2021,2,Eixample,5,el Fort Pienc,2002,3556,1613,1943
2021,2,Eixample,5,el Fort Pienc,2003,1145,644,501
2021,2,Eixample,5,el Fort Pienc,2004,1548,785,763
2021,2,Eixample,5,el Fort Pienc,2005,2073,1123,950
2021,2,Eixample,5,el Fort Pienc,2006,1675,896,779
2021,2,Eixample,5,el Fort Pienc,2007,1249,691,558
2021,2,Eixample,5,el Fort Pienc,2008,1918,1023,895
2021,2,Eixample,5,el Fort Pienc,2009,1822,978,844
2021,2,Eixample,5,el Fort Pienc,2010,1236,654,582
2021,2,Eixample,5,el Fort Pienc,2011,1119,571,548
2021,2,Eixample,5,el Fort Pienc,2012,1563,806,757
2021,2,Eixample,5,el Fort Pienc,2013,1182,602,580
2021,2,Eixample,5,el Fort Pienc,2014,1388,702,686
2021,2,Eixample,5,el Fort Pienc,2015,1566,811,755
2021,2,Eixample,5,el Fort Pienc,2016,1863,1016,847
2021,2,Eixample,5,el Fort Pienc,2017,1942,1042,900
2021,2,Eixample,5,el Fort Pienc,2018,1825,990,835
2021,2,Eixample,5,el Fort Pienc,2019,1992,1055,937
2021,2,Eixample,5,el Fort Pienc,2020,1504,793,711
2021,2,Eixample,6,la Sagrada Família,2021,1507,798,709
2021,2,Eixample,6,la Sagrada Família,2022,1344,684,660
2021,2,Eixample,6,la Sagrada Família,2023,1044,574,470
2021,2,Eixample,6,la Sagrada Família,2024,1160,640,520
2021,2,Eixample,6,la Sagrada Família,2025,1164,606,558
2021,2,Eixample,6,la Sagrada Família,2026,2179,1202,977
2021,2,Eixample,6,la Sagrada Família,2027,2080,1113,967
2021,2,Eixample,6,la Sagrada Família,2028,2093,1142,951
2021,2,Eixample,6,la Sagrada Família,2029,1275,692,583
2021,2,Eixample,6,la Sagrada Família,2030,1350,730,620
2021,2,Eixample,6,la Sagrada Família,2031,1039,567,472
2021,2,Eixample,6,la Sagrada Família,2032,1122,629,493
2021,2,Eixample,6,la Sagrada Família,2033,1222,655,567
2021,2,Eixample,6,la Sagrada Família,2034,1203,675,528
2021,2,Eixample,6,la Sagrada Família,2035,1296,715,581
2021,2,Eixample,6,la Sagrada Família,2036,1189,661,528
2021,2,Eixample,6,la Sagrada Família,2037,1210,627,583
2021,2,Eixample,6,la Sagrada Família,2038,1559,815,744
2021,2,Eixample,6,la Sagrada Família,2039,1721,967,754
2021,2,Eixample,6,la Sagrada Família,2040,1701,887,814
2021,2,Eixample,6,la Sagrada Família,2041,1679,922,757
2021,2,Eixample,6,la Sagrada Família,2042,1569,865,704
2021,2,Eixample,6,la Sagrada Família,2043,1510,784,726
2021,2,Eixample,6,la Sagrada Família,2044,1313,718,595
2021,2,Eixample,6,la Sagrada Família,2045,1159,625,534
2021,2,Eixample,6,la Sagrada Família,2046,1957,1041,916
2021,2,Eixample,6,la Sagrada Família,2047,1962,1037,925
2021,2,Eixample,6,la Sagrada Família,2048,1300,708,592
2021,2,Eixample,6,la Sagrada Família,2049,2101,1124,977
2021,2,Eixample,6,la Sagrada Família,2050,1651,893,758
2021,2,Eixample,6,la Sagrada Família,2051,1943,1032,911
2021,2,Eixample,6,la Sagrada Família,2052,1816,970,846
2021,2,Eixample,6,la Sagrada Família,2053,1867,994,873
2021,2,Eixample,6,la Sagrada Família,2054,1879,1026,853
2021,2,Eixample,7,la Dreta de l'Eixample,2055,1839,978,861
2021,2,Eixample,7,la Dreta de l'Eixample,2056,1476,799,677
2021,2,Eixample,7,la Dreta de l'Eixample,2057,1271,682,589
2021,2,Eixample,7,la Dreta de l'Eixample,2058,1376,726,650
2021,2,Eixample,7,la Dreta de l'Eixample,2059,1673,941,732
2021,2,Eixample,7,la Dreta de l'Eixample,2060,1738,963,775
2021,2,Eixample,7,la Dreta de l'Eixample,2061,1365,758,607
2021,2,Eixample,7,la Dreta de l'Eixample,2062,1537,795,742
2021,2,Eixample,7,la Dreta de l'Eixample,2063,1209,718,491
2021,2,Eixample,7,la Dreta de l'Eixample,2064,1335,720,615
2021,2,Eixample,7,la Dreta de l'Eixample,2065,1886,989,897
2021,2,Eixample,7,la Dreta de l'Eixample,2066,1737,939,798
2021,2,Eixample,7,la Dreta de l'Eixample,2067,1659,887,772
2021,2,Eixample,7,la Dreta de l'Eixample,2068,1633,861,772
2021,2,Eixample,7,la Dreta de l'Eixample,2069,1373,721,652
2021,2,Eixample,7,la Dreta de l'Eixample,2070,1292,702,590
2021,2,Eixample,7,la Dreta de l'Eixample,2071,1708,894,814
2021,2,Eixample,7,la Dreta de l'Eixample,2072,1202,612,590
2021,2,Eixample,7,la Dreta de l'Eixample,2073,1650,881,769
2021,2,Eixample,7,la Dreta de l'Eixample,2074,1242,632,610
2021,2,Eixample,7,la Dreta de l'Eixample,2075,1301,683,618
2021,2,Eixample,7,la Dreta de l'Eixample,2076,1614,854,760
2021,2,Eixample,7,la Dreta de l'Eixample,2077,1730,841,889
2021,2,Eixample,7,la Dreta de l'Eixample,2078,1376,730,646
2021,2,Eixample,7,la Dreta de l'Eixample,2079,1402,712,690
2021,2,Eixample,7,la Dreta de l'Eixample,2080,1591,784,807
2021,2,Eixample,7,la Dreta de l'Eixample,2081,2128,1157,971
2021,2,Eixample,7,la Dreta de l'Eixample,2082,901,480,421
2021,2,Eixample,7,la Dreta de l'Eixample,2083,1844,992,852
2021,2,Eixample,8,l'Antiga Esquerra de l'Eixample,2084,2076,1140,936
2021,2,Eixample,8,l'Antiga Esquerra de l'Eixample,2085,1417,788,629
2021,2,Eixample,8,l'Antiga Esquerra de l'Eixample,2086,1443,779,664
2021,2,Eixample,8,l'Antiga Esquerra de l'Eixample,2087,1477,812,665
2021,2,Eixample,8,l'Antiga Esquerra de l'Eixample,2088,1664,889,775
2021,2,Eixample,8,l'Antiga Esquerra de l'Eixample,2089,1790,944,846
2021,2,Eixample,8,l'Antiga Esquerra de l'Eixample,2090,1728,932,796
2021,2,Eixample,8,l'Antiga Esquerra de l'Eixample,2091,2076,1005,1071
2021,2,Eixample,8,l'Antiga Esquerra de l'Eixample,2092,2356,991,1365
2021,2,Eixample,8,l'Antiga Esquerra de l'Eixample,2093,1679,876,803
2021,2,Eixample,8,l'Antiga Esquerra de l'Eixample,2094,1518,772,746
2021,2,Eixample,8,l'Antiga Esquerra de l'Eixample,2095,1546,781,765
2021,2,Eixample,8,l'Antiga Esquerra de l'Eixample,2096,1436,748,688
2021,2,Eixample,8,l'Antiga Esquerra de l'Eixample,2097,1084,565,519
2021,2,Eixample,8,l'Antiga Esquerra de l'Eixample,2098,1498,798,700
2021,2,Eixample,8,l'Antiga Esquerra de l'Eixample,2099,1602,844,758
2021,2,Eixample,8,l'Antiga Esquerra de l'Eixample,2100,1338,705,633
2021,2,Eixample,8,l'Antiga Esquerra de l'Eixample,2101,2241,1194,1047
2021,2,Eixample,8,l'Antiga Esquerra de l'Eixample,2102,1377,770,607
2021,2,Eixample,8,l'Antiga Esquerra de l'Eixample,2103,1635,867,768
2021,2,Eixample,8,l'Antiga Esquerra de l'Eixample,2104,1182,644,538
2021,2,Eixample,8,l'Antiga Esquerra de l'Eixample,2105,2118,1164,954
2021,2,Eixample,8,l'Antiga Esquerra de l'Eixample,2106,1406,755,651
2021,2,Eixample,8,l'Antiga Esquerra de l'Eixample,2107,1654,906,748
2021,2,Eixample,8,l'Antiga Esquerra de l'Eixample,2108,1644,899,745
2021,2,Eixample,8,l'Antiga Esquerra de l'Eixample,2109,2061,1117,944
2021,2,Eixample,9,la Nova Esquerra de l'Eixample,2110,1905,1024,881
2021,2,Eixample,9,la Nova Esquerra de l'Eixample,2111,1833,999,834
2021,2,Eixample,9,la Nova Esquerra de l'Eixample,2112,1304,695,609
2021,2,Eixample,9,la Nova Esquerra de l'Eixample,2113,2206,1151,1055
2021,2,Eixample,9,la Nova Esquerra de l'Eixample,2114,1679,927,752
2021,2,Eixample,9,la Nova Esquerra de l'Eixample,2115,1350,727,623
2021,2,Eixample,9,la Nova Esquerra de l'Eixample,2116,988,536,452
2021,2,Eixample,9,la Nova Esquerra de l'Eixample,2117,1215,672,543
2021,2,Eixample,9,la Nova Esquerra de l'Eixample,2118,1503,812,691
2021,2,Eixample,9,la Nova Esquerra de l'Eixample,2119,1273,669,604
2021,2,Eixample,9,la Nova Esquerra de l'Eixample,2120,1163,604,559
2021,2,Eixample,9,la Nova Esquerra de l'Eixample,2121,1240,650,590
2021,2,Eixample,9,la Nova Esquerra de l'Eixample,2122,1048,568,480
2021,2,Eixample,9,la Nova Esquerra de l'Eixample,2123,1123,578,545
2021,2,Eixample,9,la Nova Esquerra de l'Eixample,2124,1077,593,484
2021,2,Eixample,9,la Nova Esquerra de l'Eixample,2125,1684,921,763
2021,2,Eixample,9,la Nova Esquerra de l'Eixample,2126,1476,800,676
2021,2,Eixample,9,la Nova Esquerra de l'Eixample,2127,1151,600,551
2021,2,Eixample,9,la Nova Esquerra de l'Eixample,2128,1327,711,616
2021,2,Eixample,9,la Nova Esquerra de l'Eixample,2129,1516,837,679
2021,2,Eixample,9,la Nova Esquerra de l'Eixample,2130,1107,589,518
2021,2,Eixample,9,la Nova Esquerra de l'Eixample,2131,1143,610,533
2021,2,Eixample,9,la Nova Esquerra de l'Eixample,2132,1053,545,508
2021,2,Eixample,9,la Nova Esquerra de l'Eixample,2133,834,464,370
2021,2,Eixample,9,la Nova Esquerra de l'Eixample,2134,1478,771,707
2021,2,Eixample,9,la Nova Esquerra de l'Eixample,2135,2146,1131,1015
2021,2,Eixample,9,la Nova Esquerra de l'Eixample,2136,892,487,405
2021,2,Eixample,9,la Nova Esquerra de l'Eixample,2137,1484,777,707
2021,2,Eixample,9,la Nova Esquerra de l'Eixample,2138,1962,1027,935
2021,2,Eixample,9,la Nova Esquerra de l'Eixample,2139,1678,894,784
2021,2,Eixample,9,la Nova Esquerra de l'Eixample,2140,1887,1021,866
2021,2,Eixample,9,la Nova Esquerra de l'Eixample,2141,1180,635,545
2021,2,Eixample,9,la Nova Esquerra de l'Eixample,2142,2045,1072,973
2021,2,Eixample,9,la Nova Esquerra de l'Eixample,2143,1383,697,686
2021,2,Eixample,9,la Nova Esquerra de l'Eixample,2144,1560,827,733
2021,2,Eixample,9,la Nova Esquerra de l'Eixample,2145,1240,642,598
2021,2,Eixample,9,la Nova Esquerra de l'Eixample,2146,1190,641,549
2021,2,Eixample,9,la Nova Esquerra de l'Eixample,2147,2147,1135,1012
2021,2,Eixample,9,la Nova Esquerra de l'Eixample,2148,1611,876,735
2021,2,Eixample,9,la Nova Esquerra de l'Eixample,2149,1825,928,897
2021,2,Eixample,10,Sant Antoni,2150,1543,812,731
2021,2,Eixample,10,Sant Antoni,2151,1505,805,700
2021,2,Eixample,10,Sant Antoni,2152,1256,685,571
2021,2,Eixample,10,Sant Antoni,2153,1333,708,625
2021,2,Eixample,10,Sant Antoni,2154,1087,557,530
2021,2,Eixample,10,Sant Antoni,2155,1857,988,869
2021,2,Eixample,10,Sant Antoni,2156,1273,662,611
2021,2,Eixample,10,Sant Antoni,2157,1217,658,559
2021,2,Eixample,10,Sant Antoni,2158,1605,831,774
2021,2,Eixample,10,Sant Antoni,2159,1976,1020,956
2021,2,Eixample,10,Sant Antoni,2160,1993,1040,953
2021,2,Eixample,10,Sant Antoni,2161,1198,626,572
2021,2,Eixample,10,Sant Antoni,2162,1407,718,689
2021,2,Eixample,10,Sant Antoni,2163,1845,960,885
2021,2,Eixample,10,Sant Antoni,2164,1467,749,718
2021,2,Eixample,10,Sant Antoni,2165,1716,880,836
2021,2,Eixample,10,Sant Antoni,2166,2119,1100,1019
2021,2,Eixample,10,Sant Antoni,2167,2128,1107,1021
2021,2,Eixample,10,Sant Antoni,2168,2278,1211,1067
2021,2,Eixample,10,Sant Antoni,2169,1535,793,742
2021,2,Eixample,10,Sant Antoni,2170,1555,840,715
2021,2,Eixample,10,Sant Antoni,2171,1673,857,816
2021,2,Eixample,10,Sant Antoni,2172,1601,842,759
2021,2,Eixample,10,Sant Antoni,2173,1533,804,729
2021,3,Sants-Montjuïc,11,el Poble-sec,3001,1695,887,808
2021,3,Sants-Montjuïc,11,el Poble-sec,3002,1908,973,935
2021,3,Sants-Montjuïc,11,el Poble-sec,3003,1702,882,820
2021,3,Sants-Montjuïc,11,el Poble-sec,3004,1635,856,779
2021,3,Sants-Montjuïc,11,el Poble-sec,3005,1205,636,569
2021,3,Sants-Montjuïc,11,el Poble-sec,3006,1412,713,699
2021,3,Sants-Montjuïc,11,el Poble-sec,3007,1703,895,808
2021,3,Sants-Montjuïc,11,el Poble-sec,3008,1180,613,567
2021,3,Sants-Montjuïc,11,el Poble-sec,3009,1233,646,587
2021,3,Sants-Montjuïc,11,el Poble-sec,3010,1931,928,1003
2021,3,Sants-Montjuïc,11,el Poble-sec,3011,1774,879,895
2021,3,Sants-Montjuïc,11,el Poble-sec,3012,2170,1107,1063
2021,3,Sants-Montjuïc,11,el Poble-sec,3013,1814,916,898
2021,3,Sants-Montjuïc,11,el Poble-sec,3014,1819,913,906
2021,3,Sants-Montjuïc,11,el Poble-sec,3015,3032,1533,1499
2021,3,Sants-Montjuïc,11,el Poble-sec,3016,1259,656,603
2021,3,Sants-Montjuïc,11,el Poble-sec,3017,1700,845,855
2021,3,Sants-Montjuïc,11,el Poble-sec,3018,1734,859,875
2021,3,Sants-Montjuïc,11,el Poble-sec,3019,1544,809,735
2021,3,Sants-Montjuïc,11,el Poble-sec,3020,1206,593,613
2021,3,Sants-Montjuïc,11,el Poble-sec,3021,1075,563,512
2021,3,Sants-Montjuïc,11,el Poble-sec,3022,1456,726,730
2021,3,Sants-Montjuïc,11,el Poble-sec,3023,1936,974,962
2021,3,Sants-Montjuïc,11,el Poble-sec,3024,2081,1027,1054
2021,3,Sants-Montjuïc,12,la Marina del Prat Vermell,3025,1356,657,699
2021,3,Sants-Montjuïc,13,la Marina de Port,3026,1015,532,483
2021,3,Sants-Montjuïc,13,la Marina de Port,3027,1763,915,848
2021,3,Sants-Montjuïc,13,la Marina de Port,3028,2664,1353,1311
2021,3,Sants-Montjuïc,13,la Marina de Port,3029,1302,675,627
2021,3,Sants-Montjuïc,13,la Marina de Port,3030,1578,856,722
2021,3,Sants-Montjuïc,13,la Marina de Port,3031,2411,1257,1154
2021,3,Sants-Montjuïc,13,la Marina de Port,3032,1716,886,830
2021,3,Sants-Montjuïc,13,la Marina de Port,3033,1489,737,752
2021,3,Sants-Montjuïc,13,la Marina de Port,3034,1517,795,722
2021,3,Sants-Montjuïc,13,la Marina de Port,3035,2261,1178,1083
2021,3,Sants-Montjuïc,13,la Marina de Port,3036,2403,1252,1151
2021,3,Sants-Montjuïc,13,la Marina de Port,3037,1027,534,493
2021,3,Sants-Montjuïc,13,la Marina de Port,3038,958,502,456
2021,3,Sants-Montjuïc,13,la Marina de Port,3039,2549,1331,1218
2021,3,Sants-Montjuïc,13,la Marina de Port,3211,1539,783,756
2021,3,Sants-Montjuïc,13,la Marina de Port,3212,2469,1304,1165
2021,3,Sants-Montjuïc,13,la Marina de Port,3213,2431,1251,1180
2021,3,Sants-Montjuïc,14,la Font de la Guatlla,3040,1466,788,678
2021,3,Sants-Montjuïc,14,la Font de la Guatlla,3041,1403,735,668
2021,3,Sants-Montjuïc,14,la Font de la Guatlla,3042,1388,704,684
2021,3,Sants-Montjuïc,14,la Font de la Guatlla,3043,1618,875,743
2021,3,Sants-Montjuïc,14,la Font de la Guatlla,3044,1885,978,907
2021,3,Sants-Montjuïc,14,la Font de la Guatlla,3045,1060,547,513
2021,3,Sants-Montjuïc,14,la Font de la Guatlla,3046,1419,750,669
2021,3,Sants-Montjuïc,15,Hostafrancs,3047,1766,919,847
2021,3,Sants-Montjuïc,15,Hostafrancs,3048,1327,704,623
2021,3,Sants-Montjuïc,15,Hostafrancs,3049,1661,882,779
2021,3,Sants-Montjuïc,15,Hostafrancs,3050,1642,829,813
2021,3,Sants-Montjuïc,15,Hostafrancs,3051,1964,988,976
2021,3,Sants-Montjuïc,15,Hostafrancs,3052,1325,706,619
2021,3,Sants-Montjuïc,15,Hostafrancs,3053,2215,1151,1064
2021,3,Sants-Montjuïc,15,Hostafrancs,3054,1638,841,797
2021,3,Sants-Montjuïc,15,Hostafrancs,3055,1623,853,770
2021,3,Sants-Montjuïc,15,Hostafrancs,3056,941,505,436
2021,3,Sants-Montjuïc,16,la Bordeta,3057,1466,770,696
2021,3,Sants-Montjuïc,16,la Bordeta,3058,1743,931,812
2021,3,Sants-Montjuïc,16,la Bordeta,3059,1205,613,592
2021,3,Sants-Montjuïc,16,la Bordeta,3060,1406,712,694
2021,3,Sants-Montjuïc,16,la Bordeta,3061,1140,611,529
2021,3,Sants-Montjuïc,16,la Bordeta,3062,1540,823,717
2021,3,Sants-Montjuïc,16,la Bordeta,3063,1946,985,961
2021,3,Sants-Montjuïc,16,la Bordeta,3064,1205,639,566
2021,3,Sants-Montjuïc,16,la Bordeta,3065,1344,699,645
2021,3,Sants-Montjuïc,16,la Bordeta,3066,2317,1201,1116
2021,3,Sants-Montjuïc,16,la Bordeta,3067,1765,938,827
2021,3,Sants-Montjuïc,16,la Bordeta,3068,1178,627,551
2021,3,Sants-Montjuïc,16,la Bordeta,3069,1196,620,576
2021,3,Sants-Montjuïc,17,Sants - Badal,3070,1354,684,670
2021,3,Sants-Montjuïc,17,Sants - Badal,3071,1349,702,647
2021,3,Sants-Montjuïc,17,Sants - Badal,3072,1447,766,681
2021,3,Sants-Montjuïc,17,Sants - Badal,3073,1579,818,761
2021,3,Sants-Montjuïc,17,Sants - Badal,3074,1822,975,847
2021,3,Sants-Montjuïc,17,Sants - Badal,3075,1752,927,825
2021,3,Sants-Montjuïc,17,Sants - Badal,3076,1102,590,512
2021,3,Sants-Montjuïc,17,Sants - Badal,3077,1338,725,613
2021,3,Sants-Montjuïc,17,Sants - Badal,3078,1752,923,829
2021,3,Sants-Montjuïc,17,Sants - Badal,3079,1827,976,851
2021,3,Sants-Montjuïc,17,Sants - Badal,3080,1541,852,689
2021,3,Sants-Montjuïc,17,Sants - Badal,3081,1967,1036,931
2021,3,Sants-Montjuïc,17,Sants - Badal,3082,1903,1029,874
2021,3,Sants-Montjuïc,17,Sants - Badal,3083,1393,747,646
2021,3,Sants-Montjuïc,17,Sants - Badal,3084,1414,761,653
2021,3,Sants-Montjuïc,17,Sants - Badal,3085,1363,728,635
2021,3,Sants-Montjuïc,18,Sants,3086,1241,641,600
2021,3,Sants-Montjuïc,18,Sants,3087,1444,767,677
2021,3,Sants-Montjuïc,18,Sants,3088,1444,760,684
2021,3,Sants-Montjuïc,18,Sants,3089,1254,673,581
2021,3,Sants-Montjuïc,18,Sants,3090,998,538,460
2021,3,Sants-Montjuïc,18,Sants,3091,1485,761,724
2021,3,Sants-Montjuïc,18,Sants,3092,1216,644,572
2021,3,Sants-Montjuïc,18,Sants,3093,1507,816,691
2021,3,Sants-Montjuïc,18,Sants,3094,1230,662,568
2021,3,Sants-Montjuïc,18,Sants,3095,1634,873,761
2021,3,Sants-Montjuïc,18,Sants,3096,1589,845,744
2021,3,Sants-Montjuïc,18,Sants,3097,1690,881,809
2021,3,Sants-Montjuïc,18,Sants,3098,1445,731,714
2021,3,Sants-Montjuïc,18,Sants,3099,988,541,447
2021,3,Sants-Montjuïc,18,Sants,3100,1328,732,596
2021,3,Sants-Montjuïc,18,Sants,3101,4276,1725,2551
2021,3,Sants-Montjuïc,18,Sants,3102,1305,683,622
2021,3,Sants-Montjuïc,18,Sants,3103,1148,627,521
2021,3,Sants-Montjuïc,18,Sants,3104,1431,749,682
2021,3,Sants-Montjuïc,18,Sants,3105,1191,664,527
2021,3,Sants-Montjuïc,18,Sants,3106,1273,679,594
2021,3,Sants-Montjuïc,18,Sants,3107,1648,840,808
2021,3,Sants-Montjuïc,18,Sants,3108,1664,875,789
2021,3,Sants-Montjuïc,18,Sants,3109,1541,788,753
2021,3,Sants-Montjuïc,18,Sants,3110,1493,796,697
2021,3,Sants-Montjuïc,18,Sants,3111,1295,701,594
2021,3,Sants-Montjuïc,18,Sants,3112,1847,979,868
2021,3,Sants-Montjuïc,18,Sants,3113,1605,854,751
2021,3,Sants-Montjuïc,18,Sants,3114,1469,775,694
2021,4,Les Corts,19,les Corts,4001,1258,665,593
2021,4,Les Corts,19,les Corts,4002,1917,999,918
2021,4,Les Corts,19,les Corts,4003,1025,531,494
2021,4,Les Corts,19,les Corts,4004,988,509,479
2021,4,Les Corts,19,les Corts,4005,1225,667,558
2021,4,Les Corts,19,les Corts,4006,1100,597,503
2021,4,Les Corts,19,les Corts,4007,1062,592,470
2021,4,Les Corts,19,les Corts,4008,1001,539,462
2021,4,Les Corts,19,les Corts,4009,1461,787,674
2021,4,Les Corts,19,les Corts,4010,898,484,414
2021,4,Les Corts,19,les Corts,4011,1740,926,814
2021,4,Les Corts,19,les Corts,4012,1376,741,635
2021,4,Les Corts,19,les Corts,4013,1208,648,560
2021,4,Les Corts,19,les Corts,4014,820,447,373
2021,4,Les Corts,19,les Corts,4015,1879,1032,847
2021,4,Les Corts,19,les Corts,4016,1102,587,515
2021,4,Les Corts,19,les Corts,4017,1195,652,543
2021,4,Les Corts,19,les Corts,4018,1511,830,681
2021,4,Les Corts,19,les Corts,4019,1335,702,633
2021,4,Les Corts,19,les Corts,4020,1488,807,681
2021,4,Les Corts,19,les Corts,4021,1279,691,588
2021,4,Les Corts,19,les Corts,4022,1615,846,769
2021,4,Les Corts,19,les Corts,4023,1045,560,485
2021,4,Les Corts,19,les Corts,4024,1032,554,478
2021,4,Les Corts,19,les Corts,4025,1171,640,531
2021,4,Les Corts,19,les Corts,4026,1203,668,535
2021,4,Les Corts,19,les Corts,4027,1338,713,625
2021,4,Les Corts,19,les Corts,4028,1317,706,611
2021,4,Les Corts,19,les Corts,4029,1116,617,499
2021,4,Les Corts,19,les Corts,4030,1844,1013,831
2021,4,Les Corts,19,les Corts,4031,1896,958,938
2021,4,Les Corts,19,les Corts,4032,1525,843,682
2021,4,Les Corts,19,les Corts,4033,1147,626,521
2021,4,Les Corts,19,les Corts,4034,1468,762,706
2021,4,Les Corts,19,les Corts,4035,1358,747,611
2021,4,Les Corts,20,la Maternitat i Sant Ramon,4036,1737,950,787
2021,4,Les Corts,20,la Maternitat i Sant Ramon,4037,2088,1128,960
2021,4,Les Corts,20,la Maternitat i Sant Ramon,4038,1259,679,580
2021,4,Les Corts,20,la Maternitat i Sant Ramon,4039,1185,631,554
2021,4,Les Corts,20,la Maternitat i Sant Ramon,4040,1604,825,779
2021,4,Les Corts,20,la Maternitat i Sant Ramon,4041,1339,707,632
2021,4,Les Corts,20,la Maternitat i Sant Ramon,4042,1753,939,814
2021,4,Les Corts,20,la Maternitat i Sant Ramon,4043,1613,865,748
2021,4,Les Corts,20,la Maternitat i Sant Ramon,4044,1568,839,729
2021,4,Les Corts,20,la Maternitat i Sant Ramon,4045,1421,761,660
2021,4,Les Corts,20,la Maternitat i Sant Ramon,4046,2413,1255,1158
2021,4,Les Corts,20,la Maternitat i Sant Ramon,4047,1848,990,858
2021,4,Les Corts,20,la Maternitat i Sant Ramon,4048,1489,803,686
2021,4,Les Corts,20,la Maternitat i Sant Ramon,4049,1156,618,538
2021,4,Les Corts,20,la Maternitat i Sant Ramon,4084,1352,732,620
2021,4,Les Corts,21,Pedralbes,4050,2028,1067,961
2021,4,Les Corts,21,Pedralbes,4051,1635,916,719
2021,4,Les Corts,21,Pedralbes,4052,2192,1201,991
2021,4,Les Corts,21,Pedralbes,4053,1690,881,809
2021,4,Les Corts,21,Pedralbes,4054,998,534,464
2021,4,Les Corts,21,Pedralbes,4055,1505,778,727
2021,4,Les Corts,21,Pedralbes,4056,1760,929,831
2021,5,Sarrià-Sant Gervasi,22,"Vallvidrera, el Tibidabo i les Planes",5001,1787,888,899
2021,5,Sarrià-Sant Gervasi,22,"Vallvidrera, el Tibidabo i les Planes",5002,1586,811,775
2021,5,Sarrià-Sant Gervasi,22,"Vallvidrera, el Tibidabo i les Planes",5003,1387,706,681
2021,5,Sarrià-Sant Gervasi,23,Sarrià,5004,1113,644,469
2021,5,Sarrià-Sant Gervasi,23,Sarrià,5005,1231,623,608
2021,5,Sarrià-Sant Gervasi,23,Sarrià,5006,1772,901,871
2021,5,Sarrià-Sant Gervasi,23,Sarrià,5007,1840,901,939
2021,5,Sarrià-Sant Gervasi,23,Sarrià,5008,1686,896,790
2021,5,Sarrià-Sant Gervasi,23,Sarrià,5009,1716,938,778
2021,5,Sarrià-Sant Gervasi,23,Sarrià,5010,1516,799,717
2021,5,Sarrià-Sant Gervasi,23,Sarrià,5011,1412,776,636
2021,5,Sarrià-Sant Gervasi,23,Sarrià,5012,1347,738,609
2021,5,Sarrià-Sant Gervasi,23,Sarrià,5013,1665,875,790
2021,5,Sarrià-Sant Gervasi,23,Sarrià,5014,1592,853,739
2021,5,Sarrià-Sant Gervasi,23,Sarrià,5015,1527,844,683
2021,5,Sarrià-Sant Gervasi,23,Sarrià,5016,1857,1009,848
2021,5,Sarrià-Sant Gervasi,23,Sarrià,5017,1556,839,717
2021,5,Sarrià-Sant Gervasi,23,Sarrià,5018,1255,682,573
2021,5,Sarrià-Sant Gervasi,23,Sarrià,5019,1684,925,759
2021,5,Sarrià-Sant Gervasi,24,les Tres Torres,5020,1155,629,526
2021,5,Sarrià-Sant Gervasi,24,les Tres Torres,5021,1289,685,604
2021,5,Sarrià-Sant Gervasi,24,les Tres Torres,5022,1747,971,776
2021,5,Sarrià-Sant Gervasi,24,les Tres Torres,5023,1468,796,672
2021,5,Sarrià-Sant Gervasi,24,les Tres Torres,5024,1907,1025,882
2021,5,Sarrià-Sant Gervasi,24,les Tres Torres,5025,1309,695,614
2021,5,Sarrià-Sant Gervasi,24,les Tres Torres,5026,1405,737,668
2021,5,Sarrià-Sant Gervasi,24,les Tres Torres,5027,1405,743,662
2021,5,Sarrià-Sant Gervasi,24,les Tres Torres,5028,1641,832,809
2021,5,Sarrià-Sant Gervasi,24,les Tres Torres,5029,1631,849,782
2021,5,Sarrià-Sant Gervasi,24,les Tres Torres,5030,1399,750,649
2021,5,Sarrià-Sant Gervasi,25,Sant Gervasi - la Bonanova,5031,1625,851,774
2021,5,Sarrià-Sant Gervasi,25,Sant Gervasi - la Bonanova,5032,1835,984,851
2021,5,Sarrià-Sant Gervasi,25,Sant Gervasi - la Bonanova,5033,1424,747,677
2021,5,Sarrià-Sant Gervasi,25,Sant Gervasi - la Bonanova,5034,1326,688,638
2021,5,Sarrià-Sant Gervasi,25,Sant Gervasi - la Bonanova,5035,1037,531,506
2021,5,Sarrià-Sant Gervasi,25,Sant Gervasi - la Bonanova,5036,1708,906,802
2021,5,Sarrià-Sant Gervasi,25,Sant Gervasi - la Bonanova,5037,1451,814,637
2021,5,Sarrià-Sant Gervasi,25,Sant Gervasi - la Bonanova,5038,1348,734,614
2021,5,Sarrià-Sant Gervasi,25,Sant Gervasi - la Bonanova,5039,1537,819,718
2021,5,Sarrià-Sant Gervasi,25,Sant Gervasi - la Bonanova,5040,1436,787,649
2021,5,Sarrià-Sant Gervasi,25,Sant Gervasi - la Bonanova,5041,1939,1000,939
2021,5,Sarrià-Sant Gervasi,25,Sant Gervasi - la Bonanova,5042,1293,683,610
2021,5,Sarrià-Sant Gervasi,25,Sant Gervasi - la Bonanova,5043,1464,804,660
2021,5,Sarrià-Sant Gervasi,25,Sant Gervasi - la Bonanova,5044,1326,739,587
2021,5,Sarrià-Sant Gervasi,25,Sant Gervasi - la Bonanova,5045,1615,896,719
2021,5,Sarrià-Sant Gervasi,25,Sant Gervasi - la Bonanova,5046,1138,641,497
2021,5,Sarrià-Sant Gervasi,25,Sant Gervasi - la Bonanova,5047,1234,684,550
2021,5,Sarrià-Sant Gervasi,25,Sant Gervasi - la Bonanova,5048,1248,695,553
2021,5,Sarrià-Sant Gervasi,26,Sant Gervasi - Galvany,5049,1665,919,746
2021,5,Sarrià-Sant Gervasi,26,Sant Gervasi - Galvany,5050,1621,863,758
2021,5,Sarrià-Sant Gervasi,26,Sant Gervasi - Galvany,5051,1611,870,741
2021,5,Sarrià-Sant Gervasi,26,Sant Gervasi - Galvany,5052,1438,803,635
2021,5,Sarrià-Sant Gervasi,26,Sant Gervasi - Galvany,5053,1503,799,704
2021,5,Sarrià-Sant Gervasi,26,Sant Gervasi - Galvany,5054,1047,584,463
2021,5,Sarrià-Sant Gervasi,26,Sant Gervasi - Galvany,5055,1407,764,643
2021,5,Sarrià-Sant Gervasi,26,Sant Gervasi - Galvany,5056,1201,697,504
2021,5,Sarrià-Sant Gervasi,26,Sant Gervasi - Galvany,5057,1662,879,783
2021,5,Sarrià-Sant Gervasi,26,Sant Gervasi - Galvany,5058,1552,845,707
2021,5,Sarrià-Sant Gervasi,26,Sant Gervasi - Galvany,5059,1546,863,683
2021,5,Sarrià-Sant Gervasi,26,Sant Gervasi - Galvany,5060,1157,655,502
2021,5,Sarrià-Sant Gervasi,26,Sant Gervasi - Galvany,5061,1460,828,632
2021,5,Sarrià-Sant Gervasi,26,Sant Gervasi - Galvany,5062,1636,925,711
2021,5,Sarrià-Sant Gervasi,26,Sant Gervasi - Galvany,5063,1551,853,698
2021,5,Sarrià-Sant Gervasi,26,Sant Gervasi - Galvany,5064,1606,900,706
2021,5,Sarrià-Sant Gervasi,26,Sant Gervasi - Galvany,5065,1652,900,752
2021,5,Sarrià-Sant Gervasi,26,Sant Gervasi - Galvany,5066,1343,741,602
2021,5,Sarrià-Sant Gervasi,26,Sant Gervasi - Galvany,5067,1246,683,563
2021,5,Sarrià-Sant Gervasi,26,Sant Gervasi - Galvany,5068,1536,839,697
2021,5,Sarrià-Sant Gervasi,26,Sant Gervasi - Galvany,5069,1745,935,810
2021,5,Sarrià-Sant Gervasi,26,Sant Gervasi - Galvany,5070,1440,799,641
2021,5,Sarrià-Sant Gervasi,26,Sant Gervasi - Galvany,5071,1628,916,712
2021,5,Sarrià-Sant Gervasi,26,Sant Gervasi - Galvany,5072,1723,959,764
2021,5,Sarrià-Sant Gervasi,26,Sant Gervasi - Galvany,5073,1609,882,727
2021,5,Sarrià-Sant Gervasi,26,Sant Gervasi - Galvany,5074,1668,900,768
2021,5,Sarrià-Sant Gervasi,26,Sant Gervasi - Galvany,5075,1851,1045,806
2021,5,Sarrià-Sant Gervasi,26,Sant Gervasi - Galvany,5076,1416,776,640
2021,5,Sarrià-Sant Gervasi,26,Sant Gervasi - Galvany,5077,1448,789,659
2021,5,Sarrià-Sant Gervasi,26,Sant Gervasi - Galvany,5078,2109,1137,972
2021,5,Sarrià-Sant Gervasi,26,Sant Gervasi - Galvany,5079,1269,688,581
2021,5,Sarrià-Sant Gervasi,27,el Putget i Farró,5080,1376,745,631
2021,5,Sarrià-Sant Gervasi,27,el Putget i Farró,5081,1610,875,735
2021,5,Sarrià-Sant Gervasi,27,el Putget i Farró,5082,1637,898,739
2021,5,Sarrià-Sant Gervasi,27,el Putget i Farró,5083,1277,692,585
2021,5,Sarrià-Sant Gervasi,27,el Putget i Farró,5084,1344,746,598
2021,5,Sarrià-Sant Gervasi,27,el Putget i Farró,5085,1332,701,631
2021,5,Sarrià-Sant Gervasi,27,el Putget i Farró,5086,1347,727,620
2021,5,Sarrià-Sant Gervasi,27,el Putget i Farró,5087,1598,873,725
2021,5,Sarrià-Sant Gervasi,27,el Putget i Farró,5088,1757,896,861
2021,5,Sarrià-Sant Gervasi,27,el Putget i Farró,5089,1788,926,862
2021,5,Sarrià-Sant Gervasi,27,el Putget i Farró,5090,1906,1017,889
2021,5,Sarrià-Sant Gervasi,27,el Putget i Farró,5091,1555,867,688
2021,5,Sarrià-Sant Gervasi,27,el Putget i Farró,5092,1622,872,750
2021,5,Sarrià-Sant Gervasi,27,el Putget i Farró,5093,1104,630,474
2021,5,Sarrià-Sant Gervasi,27,el Putget i Farró,5094,2711,1502,1209
2021,5,Sarrià-Sant Gervasi,27,el Putget i Farró,5095,1688,935,753
2021,5,Sarrià-Sant Gervasi,27,el Putget i Farró,5096,1150,637,513
2021,5,Sarrià-Sant Gervasi,27,el Putget i Farró,5097,1621,848,773
2021,5,Sarrià-Sant Gervasi,27,el Putget i Farró,5098,1563,867,696
2021,6,Gràcia,28,Vallcarca i els Penitents,6001,1185,688,497
2021,6,Gràcia,28,Vallcarca i els Penitents,6002,1538,837,701
2021,6,Gràcia,28,Vallcarca i els Penitents,6003,2294,1187,1107
2021,6,Gràcia,28,Vallcarca i els Penitents,6004,1447,734,713
2021,6,Gràcia,28,Vallcarca i els Penitents,6006,1030,538,492
2021,6,Gràcia,28,Vallcarca i els Penitents,6007,1967,1052,915
2021,6,Gràcia,28,Vallcarca i els Penitents,6008,2004,1114,890
2021,6,Gràcia,28,Vallcarca i els Penitents,6009,1289,688,601
2021,6,Gràcia,28,Vallcarca i els Penitents,6010,1077,568,509
2021,6,Gràcia,28,Vallcarca i els Penitents,6011,1315,690,625
2021,6,Gràcia,28,Vallcarca i els Penitents,6012,1179,623,556
2021,6,Gràcia,29,el Coll,6013,1801,959,842
2021,6,Gràcia,29,el Coll,6014,1457,793,664
2021,6,Gràcia,29,el Coll,6015,1441,763,678
2021,6,Gràcia,29,el Coll,6016,1641,871,770
2021,6,Gràcia,29,el Coll,6017,1348,712,636
2021,6,Gràcia,30,la Salut,6018,1348,704,644
2021,6,Gràcia,30,la Salut,6019,1495,795,700
2021,6,Gràcia,30,la Salut,6020,1176,631,545
2021,6,Gràcia,30,la Salut,6021,1380,738,642
2021,6,Gràcia,30,la Salut,6022,1370,677,693
2021,6,Gràcia,30,la Salut,6023,1302,704,598
2021,6,Gràcia,30,la Salut,6024,1736,950,786
2021,6,Gràcia,30,la Salut,6025,1407,777,630
2021,6,Gràcia,30,la Salut,6026,1025,556,469
2021,6,Gràcia,30,la Salut,6027,1216,680,536
2021,6,Gràcia,31,Vila de Gràcia,6028,1328,684,644
2021,6,Gràcia,31,Vila de Gràcia,6029,1285,685,600
2021,6,Gràcia,31,Vila de Gràcia,6030,1353,710,643
2021,6,Gràcia,31,Vila de Gràcia,6031,1106,608,498
2021,6,Gràcia,31,Vila de Gràcia,6032,1169,645,524
2021,6,Gràcia,31,Vila de Gràcia,6033,1288,712,576
2021,6,Gràcia,31,Vila de Gràcia,6034,1217,670,547
2021,6,Gràcia,31,Vila de Gràcia,6035,1074,580,494
2021,6,Gràcia,31,Vila de Gràcia,6036,1486,838,648
2021,6,Gràcia,31,Vila de Gràcia,6037,1144,600,544
2021,6,Gràcia,31,Vila de Gràcia,6038,1486,840,646
2021,6,Gràcia,31,Vila de Gràcia,6039,1585,864,721
2021,6,Gràcia,31,Vila de Gràcia,6040,1666,948,718
2021,6,Gràcia,31,Vila de Gràcia,6041,1739,957,782
2021,6,Gràcia,31,Vila de Gràcia,6042,1693,889,804
2021,6,Gràcia,31,Vila de Gràcia,6043,1270,678,592
2021,6,Gràcia,31,Vila de Gràcia,6044,1568,832,736
2021,6,Gràcia,31,Vila de Gràcia,6045,1308,704,604
2021,6,Gràcia,31,Vila de Gràcia,6046,1147,622,525
2021,6,Gràcia,31,Vila de Gràcia,6047,1222,669,553
2021,6,Gràcia,31,Vila de Gràcia,6048,1413,757,656
2021,6,Gràcia,31,Vila de Gràcia,6049,1166,652,514
2021,6,Gràcia,31,Vila de Gràcia,6050,1335,710,625
2021,6,Gràcia,31,Vila de Gràcia,6051,1240,698,542
2021,6,Gràcia,31,Vila de Gràcia,6052,1507,830,677
2021,6,Gràcia,31,Vila de Gràcia,6053,1493,817,676
2021,6,Gràcia,31,Vila de Gràcia,6054,1625,834,791
2021,6,Gràcia,31,Vila de Gràcia,6055,1434,794,640
2021,6,Gràcia,31,Vila de Gràcia,6056,1568,852,716
2021,6,Gràcia,31,Vila de Gràcia,6057,1533,856,677
2021,6,Gràcia,31,Vila de Gràcia,6058,1722,946,776
2021,6,Gràcia,31,Vila de Gràcia,6059,1505,800,705
2021,6,Gràcia,31,Vila de Gràcia,6060,1776,952,824
2021,6,Gràcia,31,Vila de Gràcia,6061,1300,678,622
2021,6,Gràcia,31,Vila de Gràcia,6062,1212,657,555
2021,6,Gràcia,31,Vila de Gràcia,6063,1493,820,673
2021,6,Gràcia,32,el Camp d'en Grassot i Gràcia Nova,6064,1926,1066,860
2021,6,Gràcia,32,el Camp d'en Grassot i Gràcia Nova,6065,1160,622,538
2021,6,Gràcia,32,el Camp d'en Grassot i Gràcia Nova,6066,983,550,433
2021,6,Gràcia,32,el Camp d'en Grassot i Gràcia Nova,6067,1770,967,803
2021,6,Gràcia,32,el Camp d'en Grassot i Gràcia Nova,6068,1555,877,678
2021,6,Gràcia,32,el Camp d'en Grassot i Gràcia Nova,6069,1085,587,498
2021,6,Gràcia,32,el Camp d'en Grassot i Gràcia Nova,6070,1840,1047,793
2021,6,Gràcia,32,el Camp d'en Grassot i Gràcia Nova,6071,1094,587,507
2021,6,Gràcia,32,el Camp d'en Grassot i Gràcia Nova,6072,1646,889,757
2021,6,Gràcia,32,el Camp d'en Grassot i Gràcia Nova,6073,1377,751,626
2021,6,Gràcia,32,el Camp d'en Grassot i Gràcia Nova,6074,1148,591,557
2021,6,Gràcia,32,el Camp d'en Grassot i Gràcia Nova,6075,1070,563,507
2021,6,Gràcia,32,el Camp d'en Grassot i Gràcia Nova,6076,1302,668,634
2021,6,Gràcia,32,el Camp d'en Grassot i Gràcia Nova,6077,1189,652,537
2021,6,Gràcia,32,el Camp d'en Grassot i Gràcia Nova,6078,1298,684,614
2021,6,Gràcia,32,el Camp d'en Grassot i Gràcia Nova,6079,1129,632,497
2021,6,Gràcia,32,el Camp d'en Grassot i Gràcia Nova,6080,1176,624,552
2021,6,Gràcia,32,el Camp d'en Grassot i Gràcia Nova,6081,1327,732,595
2021,6,Gràcia,32,el Camp d'en Grassot i Gràcia Nova,6082,2705,1388,1317
2021,6,Gràcia,32,el Camp d'en Grassot i Gràcia Nova,6083,1735,901,834
2021,6,Gràcia,32,el Camp d'en Grassot i Gràcia Nova,6084,1486,825,661
2021,6,Gràcia,32,el Camp d'en Grassot i Gràcia Nova,6085,1267,703,564
2021,6,Gràcia,32,el Camp d'en Grassot i Gràcia Nova,6086,984,519,465
2021,6,Gràcia,32,el Camp d'en Grassot i Gràcia Nova,6087,1867,1009,858
2021,6,Gràcia,32,el Camp d'en Grassot i Gràcia Nova,6088,1233,687,546
2021,7,Horta-Guinardó,33,el Baix Guinardó,7001,1577,869,708
2021,7,Horta-Guinardó,33,el Baix Guinardó,7002,1150,639,511
2021,7,Horta-Guinardó,33,el Baix Guinardó,7003,1308,715,593
2021,7,Horta-Guinardó,33,el Baix Guinardó,7004,1534,824,710
2021,7,Horta-Guinardó,33,el Baix Guinardó,7005,1433,756,677
2021,7,Horta-Guinardó,33,el Baix Guinardó,7006,966,515,451
2021,7,Horta-Guinardó,33,el Baix Guinardó,7007,1396,761,635
2021,7,Horta-Guinardó,33,el Baix Guinardó,7008,1429,743,686
2021,7,Horta-Guinardó,33,el Baix Guinardó,7009,1184,661,523
2021,7,Horta-Guinardó,33,el Baix Guinardó,7010,1366,720,646
2021,7,Horta-Guinardó,33,el Baix Guinardó,7011,1143,608,535
2021,7,Horta-Guinardó,33,el Baix Guinardó,7012,1556,846,710
2021,7,Horta-Guinardó,33,el Baix Guinardó,7013,1208,641,567
2021,7,Horta-Guinardó,33,el Baix Guinardó,7014,877,475,402
2021,7,Horta-Guinardó,33,el Baix Guinardó,7015,1427,746,681
2021,7,Horta-Guinardó,33,el Baix Guinardó,7016,1365,694,671
2021,7,Horta-Guinardó,33,el Baix Guinardó,7017,1731,945,786
2021,7,Horta-Guinardó,33,el Baix Guinardó,7018,1692,930,762
2021,7,Horta-Guinardó,33,el Baix Guinardó,7019,1500,789,711
2021,7,Horta-Guinardó,34,Can Baró,7020,1740,935,805
2021,7,Horta-Guinardó,34,Can Baró,7021,1062,545,517
2021,7,Horta-Guinardó,34,Can Baró,7022,1159,616,543
2021,7,Horta-Guinardó,34,Can Baró,7023,1305,655,650
2021,7,Horta-Guinardó,34,Can Baró,7024,1492,799,693
2021,7,Horta-Guinardó,34,Can Baró,7025,1455,772,683
2021,7,Horta-Guinardó,34,Can Baró,7026,1107,597,510
2021,7,Horta-Guinardó,35,el Guinardó,7027,2110,1119,991
2021,7,Horta-Guinardó,35,el Guinardó,7028,1472,754,718
2021,7,Horta-Guinardó,35,el Guinardó,7029,1291,668,623
2021,7,Horta-Guinardó,35,el Guinardó,7030,1397,776,621
2021,7,Horta-Guinardó,35,el Guinardó,7031,1597,830,767
2021,7,Horta-Guinardó,35,el Guinardó,7032,1447,741,706
2021,7,Horta-Guinardó,35,el Guinardó,7033,1444,767,677
2021,7,Horta-Guinardó,35,el Guinardó,7034,1840,966,874
2021,7,Horta-Guinardó,35,el Guinardó,7035,1784,951,833
2021,7,Horta-Guinardó,35,el Guinardó,7036,1397,766,631
2021,7,Horta-Guinardó,35,el Guinardó,7037,1485,799,686
2021,7,Horta-Guinardó,35,el Guinardó,7038,1256,663,593
2021,7,Horta-Guinardó,35,el Guinardó,7039,1633,883,750
2021,7,Horta-Guinardó,35,el Guinardó,7040,1482,815,667
2021,7,Horta-Guinardó,35,el Guinardó,7041,1366,735,631
2021,7,Horta-Guinardó,35,el Guinardó,7042,1512,831,681
2021,7,Horta-Guinardó,35,el Guinardó,7043,1415,760,655
2021,7,Horta-Guinardó,35,el Guinardó,7044,1321,701,620
2021,7,Horta-Guinardó,35,el Guinardó,7045,1613,828,785
2021,7,Horta-Guinardó,35,el Guinardó,7046,1397,748,649
2021,7,Horta-Guinardó,35,el Guinardó,7047,1493,771,722
2021,7,Horta-Guinardó,35,el Guinardó,7048,1334,731,603
2021,7,Horta-Guinardó,35,el Guinardó,7049,1237,650,587
2021,7,Horta-Guinardó,35,el Guinardó,7050,1216,644,572
2021,7,Horta-Guinardó,35,el Guinardó,7051,1786,968,818
2021,7,Horta-Guinardó,36,la Font d'en Fargues,7052,1256,646,610
2021,7,Horta-Guinardó,36,la Font d'en Fargues,7053,1457,779,678
2021,7,Horta-Guinardó,36,la Font d'en Fargues,7054,1592,839,753
2021,7,Horta-Guinardó,36,la Font d'en Fargues,7055,1188,638,550
2021,7,Horta-Guinardó,36,la Font d'en Fargues,7056,1203,609,594
2021,7,Horta-Guinardó,36,la Font d'en Fargues,7057,1444,758,686
2021,7,Horta-Guinardó,36,la Font d'en Fargues,7058,1365,709,656
2021,7,Horta-Guinardó,37,el Carmel,7059,1335,698,637
2021,7,Horta-Guinardó,37,el Carmel,7060,1854,956,898
2021,7,Horta-Guinardó,37,el Carmel,7061,1210,620,590
2021,7,Horta-Guinardó,37,el Carmel,7062,1380,714,666
2021,7,Horta-Guinardó,37,el Carmel,7063,1460,755,705
2021,7,Horta-Guinardó,37,el Carmel,7064,1723,914,809
2021,7,Horta-Guinardó,37,el Carmel,7065,1784,946,838
2021,7,Horta-Guinardó,37,el Carmel,7066,1811,948,863
2021,7,Horta-Guinardó,37,el Carmel,7067,1581,842,739
2021,7,Horta-Guinardó,37,el Carmel,7068,1337,715,622
2021,7,Horta-Guinardó,37,el Carmel,7069,1468,768,700
2021,7,Horta-Guinardó,37,el Carmel,7070,1471,778,693
2021,7,Horta-Guinardó,37,el Carmel,7071,1357,719,638
2021,7,Horta-Guinardó,37,el Carmel,7072,1404,750,654
2021,7,Horta-Guinardó,37,el Carmel,7073,1145,625,520
2021,7,Horta-Guinardó,37,el Carmel,7074,1716,900,816
2021,7,Horta-Guinardó,37,el Carmel,7075,1231,637,594
2021,7,Horta-Guinardó,37,el Carmel,7076,1403,734,669
2021,7,Horta-Guinardó,37,el Carmel,7077,1358,700,658
2021,7,Horta-Guinardó,37,el Carmel,7078,1409,718,691
2021,7,Horta-Guinardó,37,el Carmel,7079,1469,776,693
2021,7,Horta-Guinardó,37,el Carmel,7080,1818,953,865
2021,7,Horta-Guinardó,38,la Teixonera,7081,1988,1021,967
2021,7,Horta-Guinardó,38,la Teixonera,7082,1286,666,620
2021,7,Horta-Guinardó,38,la Teixonera,7083,1383,722,661
2021,7,Horta-Guinardó,38,la Teixonera,7084,1369,686,683
2021,7,Horta-Guinardó,38,la Teixonera,7085,1253,637,616
2021,7,Horta-Guinardó,38,la Teixonera,7086,1458,762,696
2021,7,Horta-Guinardó,38,la Teixonera,7087,1597,868,729
2021,7,Horta-Guinardó,38,la Teixonera,7088,1710,886,824
2021,7,Horta-Guinardó,39,Sant Genís dels Agudells,7089,1348,742,606
2021,7,Horta-Guinardó,39,Sant Genís dels Agudells,7090,1481,763,718
2021,7,Horta-Guinardó,39,Sant Genís dels Agudells,7091,1217,645,572
2021,7,Horta-Guinardó,39,Sant Genís dels Agudells,7092,1571,871,700
2021,7,Horta-Guinardó,39,Sant Genís dels Agudells,7093,1768,875,893
2021,7,Horta-Guinardó,40,Montbau,7094,1256,685,571
2021,7,Horta-Guinardó,40,Montbau,7095,1556,826,730
2021,7,Horta-Guinardó,40,Montbau,7096,1440,804,636
2021,7,Horta-Guinardó,40,Montbau,7097,862,497,365
2021,7,Horta-Guinardó,41,la Vall d'Hebron,7098,2187,1170,1017
2021,7,Horta-Guinardó,41,la Vall d'Hebron,7099,1036,540,496
2021,7,Horta-Guinardó,41,la Vall d'Hebron,7100,1213,658,555
2021,7,Horta-Guinardó,41,la Vall d'Hebron,7101,1496,801,695
2021,7,Horta-Guinardó,42,la Clota,7102,698,335,363
2021,7,Horta-Guinardó,43,Horta,7103,1583,832,751
2021,7,Horta-Guinardó,43,Horta,7104,1555,828,727
2021,7,Horta-Guinardó,43,Horta,7105,1035,552,483
2021,7,Horta-Guinardó,43,Horta,7106,1176,632,544
2021,7,Horta-Guinardó,43,Horta,7107,1181,616,565
2021,7,Horta-Guinardó,43,Horta,7108,1235,658,577
2021,7,Horta-Guinardó,43,Horta,7109,1647,875,772
2021,7,Horta-Guinardó,43,Horta,7110,1030,578,452
2021,7,Horta-Guinardó,43,Horta,7111,893,503,390
2021,7,Horta-Guinardó,43,Horta,7112,1303,679,624
2021,7,Horta-Guinardó,43,Horta,7113,1198,633,565
2021,7,Horta-Guinardó,43,Horta,7114,1189,636,553
2021,7,Horta-Guinardó,43,Horta,7115,1060,568,492
2021,7,Horta-Guinardó,43,Horta,7116,1517,837,680
2021,7,Horta-Guinardó,43,Horta,7117,2773,1316,1457
2021,7,Horta-Guinardó,43,Horta,7118,1242,677,565
2021,7,Horta-Guinardó,43,Horta,7119,1292,692,600
2021,7,Horta-Guinardó,43,Horta,7120,1256,695,561
2021,7,Horta-Guinardó,43,Horta,7121,1157,640,517
2021,7,Horta-Guinardó,43,Horta,7122,1313,723,590
2021,7,Horta-Guinardó,43,Horta,7123,1420,748,672
2021,8,Nou Barris,44,Vilapicina i la Torre Llobeta,8001,1259,678,581
2021,8,Nou Barris,44,Vilapicina i la Torre Llobeta,8002,1251,676,575
2021,8,Nou Barris,44,Vilapicina i la Torre Llobeta,8003,1196,637,559
2021,8,Nou Barris,44,Vilapicina i la Torre Llobeta,8004,1421,785,636
2021,8,Nou Barris,44,Vilapicina i la Torre Llobeta,8005,1154,618,536
2021,8,Nou Barris,44,Vilapicina i la Torre Llobeta,8006,1617,862,755
2021,8,Nou Barris,44,Vilapicina i la Torre Llobeta,8007,1190,659,531
2021,8,Nou Barris,44,Vilapicina i la Torre Llobeta,8008,1622,865,757
2021,8,Nou Barris,44,Vilapicina i la Torre Llobeta,8009,1793,934,859
2021,8,Nou Barris,44,Vilapicina i la Torre Llobeta,8010,1087,592,495
2021,8,Nou Barris,44,Vilapicina i la Torre Llobeta,8011,1177,632,545
2021,8,Nou Barris,44,Vilapicina i la Torre Llobeta,8012,1317,739,578
2021,8,Nou Barris,44,Vilapicina i la Torre Llobeta,8013,1167,643,524
2021,8,Nou Barris,44,Vilapicina i la Torre Llobeta,8014,1298,705,593
2021,8,Nou Barris,44,Vilapicina i la Torre Llobeta,8015,1466,825,641
2021,8,Nou Barris,44,Vilapicina i la Torre Llobeta,8016,1133,625,508
2021,8,Nou Barris,44,Vilapicina i la Torre Llobeta,8017,1383,728,655
2021,8,Nou Barris,44,Vilapicina i la Torre Llobeta,8018,1513,805,708
2021,8,Nou Barris,44,Vilapicina i la Torre Llobeta,8019,1831,991,840
2021,8,Nou Barris,45,Porta,8020,1390,739,651
2021,8,Nou Barris,45,Porta,8021,1465,787,678
2021,8,Nou Barris,45,Porta,8022,1252,671,581
2021,8,Nou Barris,45,Porta,8023,1394,749,645
2021,8,Nou Barris,45,Porta,8024,1362,741,621
2021,8,Nou Barris,45,Porta,8025,1189,666,523
2021,8,Nou Barris,45,Porta,8026,1384,744,640
2021,8,Nou Barris,45,Porta,8027,1408,709,699
2021,8,Nou Barris,45,Porta,8028,1096,602,494
2021,8,Nou Barris,45,Porta,8029,1501,801,700
2021,8,Nou Barris,45,Porta,8030,1502,786,716
2021,8,Nou Barris,45,Porta,8031,1298,695,603
2021,8,Nou Barris,45,Porta,8032,1292,698,594
2021,8,Nou Barris,45,Porta,8033,1487,784,703
2021,8,Nou Barris,45,Porta,8034,1246,712,534
2021,8,Nou Barris,45,Porta,8035,4435,2136,2299
2021,8,Nou Barris,45,Porta,8036,1534,831,703
2021,8,Nou Barris,45,Porta,8037,1561,880,681
2021,8,Nou Barris,46,el Turó de la Peira,8038,1568,851,717
2021,8,Nou Barris,46,el Turó de la Peira,8039,1564,818,746
2021,8,Nou Barris,46,el Turó de la Peira,8040,1908,1005,903
2021,8,Nou Barris,46,el Turó de la Peira,8041,2646,1353,1293
2021,8,Nou Barris,46,el Turó de la Peira,8042,1240,694,546
2021,8,Nou Barris,46,el Turó de la Peira,8043,1137,644,493
2021,8,Nou Barris,46,el Turó de la Peira,8044,1299,688,611
2021,8,Nou Barris,46,el Turó de la Peira,8045,1781,899,882
2021,8,Nou Barris,46,el Turó de la Peira,8046,1418,783,635
2021,8,Nou Barris,46,el Turó de la Peira,8047,1625,874,751
2021,8,Nou Barris,47,Can Peguera,8048,978,521,457
2021,8,Nou Barris,47,Can Peguera,8049,1237,660,577
2021,8,Nou Barris,48,la Guineueta,8050,1385,733,652
2021,8,Nou Barris,48,la Guineueta,8051,1343,695,648
2021,8,Nou Barris,48,la Guineueta,8052,906,503,403
2021,8,Nou Barris,48,la Guineueta,8053,1138,615,523
2021,8,Nou Barris,48,la Guineueta,8054,1671,926,745
2021,8,Nou Barris,48,la Guineueta,8055,1822,960,862
2021,8,Nou Barris,48,la Guineueta,8056,1488,778,710
2021,8,Nou Barris,48,la Guineueta,8057,1331,717,614
2021,8,Nou Barris,48,la Guineueta,8058,1620,870,750
2021,8,Nou Barris,48,la Guineueta,8059,991,520,471
2021,8,Nou Barris,48,la Guineueta,8215,1572,896,676
2021,8,Nou Barris,49,Canyelles,8060,1177,646,531
2021,8,Nou Barris,49,Canyelles,8061,1642,848,794
2021,8,Nou Barris,49,Canyelles,8062,1147,602,545
2021,8,Nou Barris,49,Canyelles,8063,1067,560,507
2021,8,Nou Barris,49,Canyelles,8064,1780,928,852
2021,8,Nou Barris,50,les Roquetes,8065,1796,885,911
2021,8,Nou Barris,50,les Roquetes,8066,1648,843,805
2021,8,Nou Barris,50,les Roquetes,8067,1792,927,865
2021,8,Nou Barris,50,les Roquetes,8068,1973,1028,945
2021,8,Nou Barris,50,les Roquetes,8069,1579,823,756
2021,8,Nou Barris,50,les Roquetes,8070,1486,775,711
2021,8,Nou Barris,50,les Roquetes,8071,1757,902,855
2021,8,Nou Barris,50,les Roquetes,8072,1211,653,558
2021,8,Nou Barris,50,les Roquetes,8073,1758,937,821
2021,8,Nou Barris,50,les Roquetes,8074,1563,803,760
2021,8,Nou Barris,51,Verdun,8075,1929,1047,882
2021,8,Nou Barris,51,Verdun,8076,1620,880,740
2021,8,Nou Barris,51,Verdun,8077,1447,779,668
2021,8,Nou Barris,51,Verdun,8078,1563,831,732
2021,8,Nou Barris,51,Verdun,8079,1447,773,674
2021,8,Nou Barris,51,Verdun,8080,1561,804,757
2021,8,Nou Barris,51,Verdun,8081,1691,881,810
2021,8,Nou Barris,51,Verdun,8082,1607,885,722
2021,8,Nou Barris,52,la Prosperitat,8083,1319,702,617
2021,8,Nou Barris,52,la Prosperitat,8084,1147,629,518
2021,8,Nou Barris,52,la Prosperitat,8085,1468,750,718
2021,8,Nou Barris,52,la Prosperitat,8086,1714,919,795
2021,8,Nou Barris,52,la Prosperitat,8087,1257,671,586
2021,8,Nou Barris,52,la Prosperitat,8088,1281,684,597
2021,8,Nou Barris,52,la Prosperitat,8089,1241,661,580
2021,8,Nou Barris,52,la Prosperitat,8090,1209,643,566
2021,8,Nou Barris,52,la Prosperitat,8091,1203,646,557
2021,8,Nou Barris,52,la Prosperitat,8092,997,524,473
2021,8,Nou Barris,52,la Prosperitat,8093,1276,648,628
2021,8,Nou Barris,52,la Prosperitat,8094,1463,768,695
2021,8,Nou Barris,52,la Prosperitat,8095,1068,557,511
2021,8,Nou Barris,52,la Prosperitat,8096,1544,809,735
2021,8,Nou Barris,52,la Prosperitat,8097,1362,732,630
2021,8,Nou Barris,52,la Prosperitat,8098,1267,667,600
2021,8,Nou Barris,52,la Prosperitat,8099,1465,767,698
2021,8,Nou Barris,52,la Prosperitat,8100,1297,706,591
2021,8,Nou Barris,52,la Prosperitat,8101,1748,925,823
2021,8,Nou Barris,52,la Prosperitat,8102,1542,874,668
2021,8,Nou Barris,53,la Trinitat Nova,8103,1680,848,832
2021,8,Nou Barris,53,la Trinitat Nova,8104,1260,658,602
2021,8,Nou Barris,53,la Trinitat Nova,8105,1484,794,690
2021,8,Nou Barris,53,la Trinitat Nova,8106,1262,645,617
2021,8,Nou Barris,53,la Trinitat Nova,8107,1942,1021,921
2021,8,Nou Barris,54,Torre Baró,8108,1942,977,965
2021,8,Nou Barris,54,Torre Baró,8109,981,485,496
2021,8,Nou Barris,55,Ciutat Meridiana,8110,2058,1039,1019
2021,8,Nou Barris,55,Ciutat Meridiana,8111,1716,897,819
2021,8,Nou Barris,55,Ciutat Meridiana,8112,1750,883,867
2021,8,Nou Barris,55,Ciutat Meridiana,8113,1800,927,873
2021,8,Nou Barris,55,Ciutat Meridiana,8114,2049,1043,1006
2021,8,Nou Barris,55,Ciutat Meridiana,8115,1779,899,880
2021,8,Nou Barris,56,Vallbona,8116,1401,716,685
2021,9,Sant Andreu,57,la Trinitat Vella,9001,2771,1319,1452
2021,9,Sant Andreu,57,la Trinitat Vella,9002,2164,1089,1075
2021,9,Sant Andreu,57,la Trinitat Vella,9003,2197,1053,1144
2021,9,Sant Andreu,57,la Trinitat Vella,9004,1721,868,853
2021,9,Sant Andreu,57,la Trinitat Vella,9005,1660,833,827
2021,9,Sant Andreu,58,Baró de Viver,9006,1277,642,635
2021,9,Sant Andreu,58,Baró de Viver,9007,1376,713,663
2021,9,Sant Andreu,59,el Bon Pastor,9008,1866,925,941
2021,9,Sant Andreu,59,el Bon Pastor,9009,1442,749,693
2021,9,Sant Andreu,59,el Bon Pastor,9010,1804,941,863
2021,9,Sant Andreu,59,el Bon Pastor,9011,1725,878,847
2021,9,Sant Andreu,59,el Bon Pastor,9013,2041,1072,969
2021,9,Sant Andreu,59,el Bon Pastor,9014,3008,1349,1659
2021,9,Sant Andreu,59,el Bon Pastor,9015,1844,956,888
2021,9,Sant Andreu,60,Sant Andreu,9016,1336,714,622
2021,9,Sant Andreu,60,Sant Andreu,9017,1527,793,734
2021,9,Sant Andreu,60,Sant Andreu,9018,1492,777,715
2021,9,Sant Andreu,60,Sant Andreu,9019,2709,1388,1321
2021,9,Sant Andreu,60,Sant Andreu,9020,1153,626,527
2021,9,Sant Andreu,60,Sant Andreu,9021,1378,722,656
2021,9,Sant Andreu,60,Sant Andreu,9022,1278,666,612
2021,9,Sant Andreu,60,Sant Andreu,9023,1240,626,614
2021,9,Sant Andreu,60,Sant Andreu,9024,1177,660,517
2021,9,Sant Andreu,60,Sant Andreu,9025,1206,656,550
2021,9,Sant Andreu,60,Sant Andreu,9026,1524,800,724
2021,9,Sant Andreu,60,Sant Andreu,9027,1301,676,625
2021,9,Sant Andreu,60,Sant Andreu,9028,1599,822,777
2021,9,Sant Andreu,60,Sant Andreu,9029,1116,586,530
2021,9,Sant Andreu,60,Sant Andreu,9030,1451,775,676
2021,9,Sant Andreu,60,Sant Andreu,9031,1192,607,585
2021,9,Sant Andreu,60,Sant Andreu,9032,2211,1175,1036
2021,9,Sant Andreu,60,Sant Andreu,9033,3212,1668,1544
2021,9,Sant Andreu,60,Sant Andreu,9034,1415,757,658
2021,9,Sant Andreu,60,Sant Andreu,9035,1602,844,758
2021,9,Sant Andreu,60,Sant Andreu,9036,1401,741,660
2021,9,Sant Andreu,60,Sant Andreu,9037,1574,790,784
2021,9,Sant Andreu,60,Sant Andreu,9038,1762,950,812
2021,9,Sant Andreu,60,Sant Andreu,9039,1536,814,722
2021,9,Sant Andreu,60,Sant Andreu,9040,1586,844,742
2021,9,Sant Andreu,60,Sant Andreu,9041,1372,744,628
2021,9,Sant Andreu,60,Sant Andreu,9042,1260,691,569
2021,9,Sant Andreu,60,Sant Andreu,9043,1329,717,612
2021,9,Sant Andreu,60,Sant Andreu,9044,1492,765,727
2021,9,Sant Andreu,60,Sant Andreu,9045,1426,767,659
2021,9,Sant Andreu,60,Sant Andreu,9046,1323,687,636
2021,9,Sant Andreu,60,Sant Andreu,9047,1620,850,770
2021,9,Sant Andreu,60,Sant Andreu,9048,1379,741,638
2021,9,Sant Andreu,60,Sant Andreu,9049,1334,724,610
2021,9,Sant Andreu,60,Sant Andreu,9050,1533,805,728
2021,9,Sant Andreu,60,Sant Andreu,9051,1252,652,600
2021,9,Sant Andreu,60,Sant Andreu,9052,1214,643,571
2021,9,Sant Andreu,60,Sant Andreu,9053,1606,867,739
2021,9,Sant Andreu,60,Sant Andreu,9054,1107,597,510
2021,9,Sant Andreu,61,la Sagrera,9055,1740,915,825
2021,9,Sant Andreu,61,la Sagrera,9056,1157,606,551
2021,9,Sant Andreu,61,la Sagrera,9057,1656,865,791
2021,9,Sant Andreu,61,la Sagrera,9058,1522,824,698
2021,9,Sant Andreu,61,la Sagrera,9059,1397,722,675
2021,9,Sant Andreu,61,la Sagrera,9060,1340,729,611
2021,9,Sant Andreu,61,la Sagrera,9061,1643,854,789
2021,9,Sant Andreu,61,la Sagrera,9062,1359,712,647
2021,9,Sant Andreu,61,la Sagrera,9063,1165,607,558
2021,9,Sant Andreu,61,la Sagrera,9064,1163,612,551
2021,9,Sant Andreu,61,la Sagrera,9065,2091,1121,970
2021,9,Sant Andreu,61,la Sagrera,9066,1443,762,681
2021,9,Sant Andreu,61,la Sagrera,9067,1534,837,697
2021,9,Sant Andreu,61,la Sagrera,9068,1553,805,748
2021,9,Sant Andreu,61,la Sagrera,9069,913,503,410
2021,9,Sant Andreu,61,la Sagrera,9070,1732,954,778
2021,9,Sant Andreu,61,la Sagrera,9071,1920,1040,880
2021,9,Sant Andreu,61,la Sagrera,9072,1461,788,673
2021,9,Sant Andreu,61,la Sagrera,9073,1513,792,721
2021,9,Sant Andreu,61,la Sagrera,9156,1266,675,591
2021,9,Sant Andreu,62,el Congrés i els Indians,9074,1678,897,781
2021,9,Sant Andreu,62,el Congrés i els Indians,9075,1566,808,758
2021,9,Sant Andreu,62,el Congrés i els Indians,9076,1469,803,666
2021,9,Sant Andreu,62,el Congrés i els Indians,9077,1635,897,738
2021,9,Sant Andreu,62,el Congrés i els Indians,9078,1443,772,671
2021,9,Sant Andreu,62,el Congrés i els Indians,9079,1644,863,781
2021,9,Sant Andreu,62,el Congrés i els Indians,9080,1346,706,640
2021,9,Sant Andreu,62,el Congrés i els Indians,9081,1738,928,810
2021,9,Sant Andreu,62,el Congrés i els Indians,9082,2030,1072,958
2021,9,Sant Andreu,63,Navas,9083,1594,840,754
2021,9,Sant Andreu,63,Navas,9084,1749,920,829
2021,9,Sant Andreu,63,Navas,9085,1813,974,839
2021,9,Sant Andreu,63,Navas,9086,1452,789,663
2021,9,Sant Andreu,63,Navas,9087,1301,679,622
2021,9,Sant Andreu,63,Navas,9088,1909,1059,850
2021,9,Sant Andreu,63,Navas,9089,1527,834,693
2021,9,Sant Andreu,63,Navas,9090,1607,866,741
2021,9,Sant Andreu,63,Navas,9091,1900,1016,884
2021,9,Sant Andreu,63,Navas,9092,1933,1008,925
2021,9,Sant Andreu,63,Navas,9093,1306,703,603
2021,9,Sant Andreu,63,Navas,9094,2053,1075,978
2021,9,Sant Andreu,63,Navas,9095,2155,1125,1030
2021,10,Sant Martí,64,Camp de l'Arpa del Clot,10001,1626,832,794
2021,10,Sant Martí,64,Camp de l'Arpa del Clot,10002,1775,919,856
2021,10,Sant Martí,64,Camp de l'Arpa del Clot,10003,1574,825,749
2021,10,Sant Martí,64,Camp de l'Arpa del Clot,10004,1580,871,709
2021,10,Sant Martí,64,Camp de l'Arpa del Clot,10005,1675,924,751
2021,10,Sant Martí,64,Camp de l'Arpa del Clot,10006,1862,988,874
2021,10,Sant Martí,64,Camp de l'Arpa del Clot,10007,1323,682,641
2021,10,Sant Martí,64,Camp de l'Arpa del Clot,10008,1759,953,806
2021,10,Sant Martí,64,Camp de l'Arpa del Clot,10009,1617,852,765
2021,10,Sant Martí,64,Camp de l'Arpa del Clot,10010,1745,929,816
2021,10,Sant Martí,64,Camp de l'Arpa del Clot,10011,1188,639,549
2021,10,Sant Martí,64,Camp de l'Arpa del Clot,10012,1823,960,863
2021,10,Sant Martí,64,Camp de l'Arpa del Clot,10013,1406,769,637
2021,10,Sant Martí,64,Camp de l'Arpa del Clot,10014,1528,816,712
2021,10,Sant Martí,64,Camp de l'Arpa del Clot,10015,1934,1000,934
2021,10,Sant Martí,64,Camp de l'Arpa del Clot,10016,1233,632,601
2021,10,Sant Martí,64,Camp de l'Arpa del Clot,10017,1682,916,766
2021,10,Sant Martí,64,Camp de l'Arpa del Clot,10018,1474,781,693
2021,10,Sant Martí,64,Camp de l'Arpa del Clot,10019,1571,839,732
2021,10,Sant Martí,64,Camp de l'Arpa del Clot,10020,1482,778,704
2021,10,Sant Martí,64,Camp de l'Arpa del Clot,10021,1369,708,661
2021,10,Sant Martí,64,Camp de l'Arpa del Clot,10022,1364,736,628
2021,10,Sant Martí,64,Camp de l'Arpa del Clot,10023,1435,784,651
2021,10,Sant Martí,64,Camp de l'Arpa del Clot,10024,1453,742,711
2021,10,Sant Martí,64,Camp de l'Arpa del Clot,10025,1360,746,614
2021,10,Sant Martí,65,el Clot,10026,1527,799,728
2021,10,Sant Martí,65,el Clot,10027,1482,792,690
2021,10,Sant Martí,65,el Clot,10028,1812,928,884
2021,10,Sant Martí,65,el Clot,10029,1420,737,683
2021,10,Sant Martí,65,el Clot,10030,1751,932,819
2021,10,Sant Martí,65,el Clot,10031,1537,785,752
2021,10,Sant Martí,65,el Clot,10032,1383,710,673
2021,10,Sant Martí,65,el Clot,10033,856,475,381
2021,10,Sant Martí,65,el Clot,10034,1721,904,817
2021,10,Sant Martí,65,el Clot,10035,1984,1009,975
2021,10,Sant Martí,65,el Clot,10036,1432,720,712
2021,10,Sant Martí,65,el Clot,10037,1043,545,498
2021,10,Sant Martí,65,el Clot,10038,1601,840,761
2021,10,Sant Martí,65,el Clot,10039,1877,984,893
2021,10,Sant Martí,65,el Clot,10040,1828,933,895
2021,10,Sant Martí,65,el Clot,10041,1676,871,805
2021,10,Sant Martí,65,el Clot,10234,1829,992,837
2021,10,Sant Martí,66,el Parc i la Llacuna del Poblenou,10042,3065,1591,1474
2021,10,Sant Martí,66,el Parc i la Llacuna del Poblenou,10043,2422,1217,1205
2021,10,Sant Martí,66,el Parc i la Llacuna del Poblenou,10044,1547,816,731
2021,10,Sant Martí,66,el Parc i la Llacuna del Poblenou,10045,1321,683,638
2021,10,Sant Martí,66,el Parc i la Llacuna del Poblenou,10046,1222,647,575
2021,10,Sant Martí,66,el Parc i la Llacuna del Poblenou,10047,1766,912,854
2021,10,Sant Martí,66,el Parc i la Llacuna del Poblenou,10048,1677,854,823
2021,10,Sant Martí,66,el Parc i la Llacuna del Poblenou,10049,1321,661,660
2021,10,Sant Martí,66,el Parc i la Llacuna del Poblenou,10050,1573,838,735
2021,10,Sant Martí,67,la Vila Olímpica del Poblenou,10051,1630,839,791
2021,10,Sant Martí,67,la Vila Olímpica del Poblenou,10052,2441,1224,1217
2021,10,Sant Martí,67,la Vila Olímpica del Poblenou,10053,1742,888,854
2021,10,Sant Martí,67,la Vila Olímpica del Poblenou,10054,958,498,460
2021,10,Sant Martí,67,la Vila Olímpica del Poblenou,10055,2624,1331,1293
2021,10,Sant Martí,68,el Poblenou,10056,1926,971,955
2021,10,Sant Martí,68,el Poblenou,10057,1452,734,718
2021,10,Sant Martí,68,el Poblenou,10058,1138,572,566
2021,10,Sant Martí,68,el Poblenou,10059,1780,928,852
2021,10,Sant Martí,68,el Poblenou,10060,1678,837,841
2021,10,Sant Martí,68,el Poblenou,10061,1761,920,841
2021,10,Sant Martí,68,el Poblenou,10062,1533,785,748
2021,10,Sant Martí,68,el Poblenou,10063,1173,601,572
2021,10,Sant Martí,68,el Poblenou,10064,1702,897,805
2021,10,Sant Martí,68,el Poblenou,10065,1577,818,759
2021,10,Sant Martí,68,el Poblenou,10066,2104,1069,1035
2021,10,Sant Martí,68,el Poblenou,10067,1895,986,909
2021,10,Sant Martí,68,el Poblenou,10068,1676,849,827
2021,10,Sant Martí,68,el Poblenou,10069,2771,1441,1330
2021,10,Sant Martí,68,el Poblenou,10070,1663,876,787
2021,10,Sant Martí,68,el Poblenou,10071,1841,946,895
2021,10,Sant Martí,68,el Poblenou,10072,2021,1019,1002
2021,10,Sant Martí,68,el Poblenou,10073,1475,764,711
2021,10,Sant Martí,68,el Poblenou,10074,1667,858,809
2021,10,Sant Martí,68,el Poblenou,10075,1578,804,774
2021,10,Sant Martí,69,Diagonal Mar i el Front Marítim del Poblenou,10076,2252,1147,1105
2021,10,Sant Martí,69,Diagonal Mar i el Front Marítim del Poblenou,10077,1870,932,938
2021,10,Sant Martí,69,Diagonal Mar i el Front Marítim del Poblenou,10078,2442,1240,1202
2021,10,Sant Martí,69,Diagonal Mar i el Front Marítim del Poblenou,10079,1756,912,844
2021,10,Sant Martí,69,Diagonal Mar i el Front Marítim del Poblenou,10080,2270,1138,1132
2021,10,Sant Martí,69,Diagonal Mar i el Front Marítim del Poblenou,10235,1329,705,624
2021,10,Sant Martí,69,Diagonal Mar i el Front Marítim del Poblenou,10236,1617,864,753
2021,10,Sant Martí,70,el Besòs i el Maresme,10081,2144,1063,1081
2021,10,Sant Martí,70,el Besòs i el Maresme,10082,1969,941,1028
2021,10,Sant Martí,70,el Besòs i el Maresme,10083,2297,995,1302
2021,10,Sant Martí,70,el Besòs i el Maresme,10084,1672,831,841
2021,10,Sant Martí,70,el Besòs i el Maresme,10085,2120,1032,1088
2021,10,Sant Martí,70,el Besòs i el Maresme,10086,1989,982,1007
2021,10,Sant Martí,70,el Besòs i el Maresme,10087,1879,946,933
2021,10,Sant Martí,70,el Besòs i el Maresme,10088,1674,847,827
2021,10,Sant Martí,70,el Besòs i el Maresme,10089,4352,1682,2670
2021,10,Sant Martí,70,el Besòs i el Maresme,10090,1514,791,723
2021,10,Sant Martí,70,el Besòs i el Maresme,10091,1997,1013,984
2021,10,Sant Martí,70,el Besòs i el Maresme,10092,1459,778,681
2021,10,Sant Martí,70,el Besòs i el Maresme,10093,1050,539,511
2021,10,Sant Martí,71,Provençals del Poblenou,10094,3059,1517,1542
2021,10,Sant Martí,71,Provençals del Poblenou,10095,1291,656,635
2021,10,Sant Martí,71,Provençals del Poblenou,10096,1633,868,765
2021,10,Sant Martí,71,Provençals del Poblenou,10097,1581,842,739
2021,10,Sant Martí,71,Provençals del Poblenou,10098,1778,938,840
2021,10,Sant Martí,71,Provençals del Poblenou,10099,1153,618,535
2021,10,Sant Martí,71,Provençals del Poblenou,10100,1707,904,803
2021,10,Sant Martí,71,Provençals del Poblenou,10101,1689,827,862
2021,10,Sant Martí,71,Provençals del Poblenou,10102,2603,1372,1231
2021,10,Sant Martí,71,Provençals del Poblenou,10103,2176,1140,1036
2021,10,Sant Martí,71,Provençals del Poblenou,10104,1591,843,748
2021,10,Sant Martí,71,Provençals del Poblenou,10237,924,511,413
2021,10,Sant Martí,72,Sant Martí de Provençals,10105,2195,1182,1013
2021,10,Sant Martí,72,Sant Martí de Provençals,10106,1017,544,473
2021,10,Sant Martí,72,Sant Martí de Provençals,10107,1530,788,742
2021,10,Sant Martí,72,Sant Martí de Provençals,10108,1312,715,597
2021,10,Sant Martí,72,Sant Martí de Provençals,10109,1668,880,788
2021,10,Sant Martí,72,Sant Martí de Provençals,10110,1714,943,771
2021,10,Sant Martí,72,Sant Martí de Provençals,10111,1315,689,626
2021,10,Sant Martí,72,Sant Martí de Provençals,10112,1537,804,733
2021,10,Sant Martí,72,Sant Martí de Provençals,10113,1184,614,570
2021,10,Sant Martí,72,Sant Martí de Provençals,10114,1500,778,722
2021,10,Sant Martí,72,Sant Martí de Provençals,10115,1408,740,668
2021,10,Sant Martí,72,Sant Martí de Provençals,10116,1874,1017,857
2021,10,Sant Martí,72,Sant Martí de Provençals,10117,1274,680,594
2021,10,Sant Martí,72,Sant Martí de Provençals,10118,994,524,470
2021,10,Sant Martí,72,Sant Martí de Provençals,10119,1157,619,538
2021,10,Sant Martí,72,Sant Martí de Provençals,10120,1465,807,658
2021,10,Sant Martí,72,Sant Martí de Provençals,10121,1595,850,745
2021,10,Sant Martí,72,Sant Martí de Provençals,10122,1490,784,706
2021,10,Sant Martí,73,la Verneda i la Pau,10123,1349,695,654
2021,10,Sant Martí,73,la Verneda i la Pau,10124,1110,577,533
2021,10,Sant Martí,73,la Verneda i la Pau,10125,1090,568,522
2021,10,Sant Martí,73,la Verneda i la Pau,10126,1005,529,476
2021,10,Sant Martí,73,la Verneda i la Pau,10127,1017,512,505
2021,10,Sant Martí,73,la Verneda i la Pau,10128,1586,855,731
2021,10,Sant Martí,73,la Verneda i la Pau,10129,1157,599,558
2021,10,Sant Martí,73,la Verneda i la Pau,10130,1202,626,576
2021,10,Sant Martí,73,la Verneda i la Pau,10131,1114,594,520
2021,10,Sant Martí,73,la Verneda i la Pau,10132,1260,680,580
2021,10,Sant Martí,73,la Verneda i la Pau,10133,1709,902,807
2021,10,Sant Martí,73,la Verneda i la Pau,10134,1559,877,682
2021,10,Sant Martí,73,la Verneda i la Pau,10135,1238,649,589
2021,10,Sant Martí,73,la Verneda i la Pau,10136,1370,728,642
2021,10,Sant Martí,73,la Verneda i la Pau,10137,1583,821,762
2021,10,Sant Martí,73,la Verneda i la Pau,10138,1599,852,747
2021,10,Sant Martí,73,la Verneda i la Pau,10139,1713,897,816
2021,10,Sant Martí,73,la Verneda i la Pau,10140,1671,861,810
2021,10,Sant Martí,73,la Verneda i la Pau,10141,1117,585,532
2021,10,Sant Martí,73,la Verneda i la Pau,10142,1622,842,780
2021,10,Sant Martí,73,la Verneda i la Pau,10143,1727,911,816
2022,1,Ciutat Vella,1,el Raval,1001,1302,600,702
2022,1,Ciutat Vella,1,el Raval,1002,1400,682,718
2022,1,Ciutat Vella,1,el Raval,1003,3467,1585,1882
2022,1,Ciutat Vella,1,el Raval,1004,2945,1325,1620
2022,1,Ciutat Vella,1,el Raval,1005,2338,1080,1258
2022,1,Ciutat Vella,1,el Raval,1006,1613,729,884
2022,1,Ciutat Vella,1,el Raval,1007,1899,764,1135
2022,1,Ciutat Vella,1,el Raval,1008,3245,1333,1912
2022,1,Ciutat Vella,1,el Raval,1009,2154,994,1160
2022,1,Ciutat Vella,1,el Raval,1010,2278,1057,1221
2022,1,Ciutat Vella,1,el Raval,1011,3077,1381,1696
2022,1,Ciutat Vella,1,el Raval,1012,1902,933,969
2022,1,Ciutat Vella,1,el Raval,1013,1433,742,691
2022,1,Ciutat Vella,1,el Raval,1014,1984,897,1087
2022,1,Ciutat Vella,1,el Raval,1015,2231,1097,1134
2022,1,Ciutat Vella,1,el Raval,1016,2064,1026,1038
2022,1,Ciutat Vella,1,el Raval,1017,2520,1237,1283
2022,1,Ciutat Vella,1,el Raval,1018,1522,756,766
2022,1,Ciutat Vella,1,el Raval,1019,2845,1319,1526
2022,1,Ciutat Vella,1,el Raval,1020,2216,1168,1048
2022,1,Ciutat Vella,1,el Raval,1021,2085,1056,1029
2022,1,Ciutat Vella,2,el Barri Gòtic,1022,1606,750,856
2022,1,Ciutat Vella,2,el Barri Gòtic,1023,1962,987,975
2022,1,Ciutat Vella,2,el Barri Gòtic,1025,1299,636,663
2022,1,Ciutat Vella,2,el Barri Gòtic,1026,8923,1994,6929
2022,1,Ciutat Vella,2,el Barri Gòtic,1027,1485,761,724
2022,1,Ciutat Vella,2,el Barri Gòtic,1028,1925,978,947
2022,1,Ciutat Vella,2,el Barri Gòtic,1029,1410,718,692
2022,1,Ciutat Vella,2,el Barri Gòtic,1030,2500,1232,1268
2022,1,Ciutat Vella,2,el Barri Gòtic,1031,1638,768,870
2022,1,Ciutat Vella,3,la Barceloneta,1032,1726,860,866
2022,1,Ciutat Vella,3,la Barceloneta,1033,1055,513,542
2022,1,Ciutat Vella,3,la Barceloneta,1034,898,427,471
2022,1,Ciutat Vella,3,la Barceloneta,1035,1179,586,593
2022,1,Ciutat Vella,3,la Barceloneta,1036,1182,626,556
2022,1,Ciutat Vella,3,la Barceloneta,1037,1296,680,616
2022,1,Ciutat Vella,3,la Barceloneta,1038,1445,697,748
2022,1,Ciutat Vella,3,la Barceloneta,1039,1315,647,668
2022,1,Ciutat Vella,3,la Barceloneta,1040,1062,522,540
2022,1,Ciutat Vella,3,la Barceloneta,1041,1434,727,707
2022,1,Ciutat Vella,3,la Barceloneta,1042,1750,937,813
2022,1,Ciutat Vella,4,"Sant Pere, Santa Caterina i la Ribera",1043,1664,820,844
2022,1,Ciutat Vella,4,"Sant Pere, Santa Caterina i la Ribera",1044,1423,736,687
2022,1,Ciutat Vella,4,"Sant Pere, Santa Caterina i la Ribera",1045,1950,972,978
2022,1,Ciutat Vella,4,"Sant Pere, Santa Caterina i la Ribera",1046,1834,881,953
2022,1,Ciutat Vella,4,"Sant Pere, Santa Caterina i la Ribera",1047,1744,896,848
2022,1,Ciutat Vella,4,"Sant Pere, Santa Caterina i la Ribera",1048,2105,1064,1041
2022,1,Ciutat Vella,4,"Sant Pere, Santa Caterina i la Ribera",1049,1476,762,714
2022,1,Ciutat Vella,4,"Sant Pere, Santa Caterina i la Ribera",1050,1569,782,787
2022,1,Ciutat Vella,4,"Sant Pere, Santa Caterina i la Ribera",1051,1769,851,918
2022,1,Ciutat Vella,4,"Sant Pere, Santa Caterina i la Ribera",1052,2511,1236,1275
2022,1,Ciutat Vella,4,"Sant Pere, Santa Caterina i la Ribera",1053,1873,978,895
2022,1,Ciutat Vella,4,"Sant Pere, Santa Caterina i la Ribera",1054,1219,605,614
2022,1,Ciutat Vella,4,"Sant Pere, Santa Caterina i la Ribera",1055,1281,649,632
2022,2,Eixample,5,el Fort Pienc,2001,1339,712,627
2022,2,Eixample,5,el Fort Pienc,2002,3665,1635,2030
2022,2,Eixample,5,el Fort Pienc,2003,1167,655,512
2022,2,Eixample,5,el Fort Pienc,2004,1492,750,742
2022,2,Eixample,5,el Fort Pienc,2005,2045,1106,939
2022,2,Eixample,5,el Fort Pienc,2006,1666,889,777
2022,2,Eixample,5,el Fort Pienc,2007,1254,693,561
2022,2,Eixample,5,el Fort Pienc,2008,1940,1024,916
2022,2,Eixample,5,el Fort Pienc,2009,1790,944,846
2022,2,Eixample,5,el Fort Pienc,2010,1211,640,571
2022,2,Eixample,5,el Fort Pienc,2011,1097,567,530
2022,2,Eixample,5,el Fort Pienc,2012,1568,803,765
2022,2,Eixample,5,el Fort Pienc,2013,1137,593,544
2022,2,Eixample,5,el Fort Pienc,2014,1362,705,657
2022,2,Eixample,5,el Fort Pienc,2015,1574,810,764
2022,2,Eixample,5,el Fort Pienc,2016,1852,1008,844
2022,2,Eixample,5,el Fort Pienc,2017,1980,1064,916
2022,2,Eixample,5,el Fort Pienc,2018,1833,984,849
2022,2,Eixample,5,el Fort Pienc,2019,1990,1052,938
2022,2,Eixample,5,el Fort Pienc,2020,1483,785,698
2022,2,Eixample,6,la Sagrada Família,2021,1470,781,689
2022,2,Eixample,6,la Sagrada Família,2022,1309,676,633
2022,2,Eixample,6,la Sagrada Família,2023,1069,593,476
2022,2,Eixample,6,la Sagrada Família,2024,1108,602,506
2022,2,Eixample,6,la Sagrada Família,2025,1117,585,532
2022,2,Eixample,6,la Sagrada Família,2026,2068,1153,915
2022,2,Eixample,6,la Sagrada Família,2027,2114,1121,993
2022,2,Eixample,6,la Sagrada Família,2028,2032,1099,933
2022,2,Eixample,6,la Sagrada Família,2029,1213,656,557
2022,2,Eixample,6,la Sagrada Família,2030,1370,730,640
2022,2,Eixample,6,la Sagrada Família,2031,1036,573,463
2022,2,Eixample,6,la Sagrada Família,2032,1157,668,489
2022,2,Eixample,6,la Sagrada Família,2033,1157,626,531
2022,2,Eixample,6,la Sagrada Família,2034,1193,672,521
2022,2,Eixample,6,la Sagrada Família,2035,1279,689,590
2022,2,Eixample,6,la Sagrada Família,2036,1198,651,547
2022,2,Eixample,6,la Sagrada Família,2037,1201,626,575
2022,2,Eixample,6,la Sagrada Família,2038,1525,808,717
2022,2,Eixample,6,la Sagrada Família,2039,1756,988,768
2022,2,Eixample,6,la Sagrada Família,2040,1671,871,800
2022,2,Eixample,6,la Sagrada Família,2041,1631,898,733
2022,2,Eixample,6,la Sagrada Família,2042,1603,877,726
2022,2,Eixample,6,la Sagrada Família,2043,1461,766,695
2022,2,Eixample,6,la Sagrada Família,2044,1300,698,602
2022,2,Eixample,6,la Sagrada Família,2045,1166,621,545
2022,2,Eixample,6,la Sagrada Família,2046,1919,1034,885
2022,2,Eixample,6,la Sagrada Família,2047,1967,1048,919
2022,2,Eixample,6,la Sagrada Família,2048,1285,709,576
2022,2,Eixample,6,la Sagrada Família,2049,2035,1107,928
2022,2,Eixample,6,la Sagrada Família,2050,1610,888,722
2022,2,Eixample,6,la Sagrada Família,2051,1857,1002,855
2022,2,Eixample,6,la Sagrada Família,2052,1788,971,817
2022,2,Eixample,6,la Sagrada Família,2053,1856,994,862
2022,2,Eixample,6,la Sagrada Família,2054,1881,1004,877
2022,2,Eixample,7,la Dreta de l'Eixample,2055,1840,979,861
2022,2,Eixample,7,la Dreta de l'Eixample,2056,1499,801,698
2022,2,Eixample,7,la Dreta de l'Eixample,2057,1267,662,605
2022,2,Eixample,7,la Dreta de l'Eixample,2058,1372,720,652
2022,2,Eixample,7,la Dreta de l'Eixample,2059,1669,929,740
2022,2,Eixample,7,la Dreta de l'Eixample,2060,1673,929,744
2022,2,Eixample,7,la Dreta de l'Eixample,2061,1344,746,598
2022,2,Eixample,7,la Dreta de l'Eixample,2062,1535,800,735
2022,2,Eixample,7,la Dreta de l'Eixample,2063,1171,698,473
2022,2,Eixample,7,la Dreta de l'Eixample,2064,1300,705,595
2022,2,Eixample,7,la Dreta de l'Eixample,2065,1813,967,846
2022,2,Eixample,7,la Dreta de l'Eixample,2066,1766,956,810
2022,2,Eixample,7,la Dreta de l'Eixample,2067,1656,862,794
2022,2,Eixample,7,la Dreta de l'Eixample,2068,1624,861,763
2022,2,Eixample,7,la Dreta de l'Eixample,2069,1357,746,611
2022,2,Eixample,7,la Dreta de l'Eixample,2070,1270,683,587
2022,2,Eixample,7,la Dreta de l'Eixample,2071,1674,863,811
2022,2,Eixample,7,la Dreta de l'Eixample,2072,1204,596,608
2022,2,Eixample,7,la Dreta de l'Eixample,2073,1638,874,764
2022,2,Eixample,7,la Dreta de l'Eixample,2074,1282,644,638
2022,2,Eixample,7,la Dreta de l'Eixample,2075,1261,664,597
2022,2,Eixample,7,la Dreta de l'Eixample,2076,1622,858,764
2022,2,Eixample,7,la Dreta de l'Eixample,2077,1758,863,895
2022,2,Eixample,7,la Dreta de l'Eixample,2078,1474,793,681
2022,2,Eixample,7,la Dreta de l'Eixample,2079,1490,755,735
2022,2,Eixample,7,la Dreta de l'Eixample,2080,1596,802,794
2022,2,Eixample,7,la Dreta de l'Eixample,2081,2170,1167,1003
2022,2,Eixample,7,la Dreta de l'Eixample,2082,916,488,428
2022,2,Eixample,7,la Dreta de l'Eixample,2083,1915,1022,893
2022,2,Eixample,8,l'Antiga Esquerra de l'Eixample,2084,2065,1125,940
2022,2,Eixample,8,l'Antiga Esquerra de l'Eixample,2085,1413,786,627
2022,2,Eixample,8,l'Antiga Esquerra de l'Eixample,2086,1404,757,647
2022,2,Eixample,8,l'Antiga Esquerra de l'Eixample,2087,1425,785,640
2022,2,Eixample,8,l'Antiga Esquerra de l'Eixample,2088,1679,883,796
2022,2,Eixample,8,l'Antiga Esquerra de l'Eixample,2089,1753,936,817
2022,2,Eixample,8,l'Antiga Esquerra de l'Eixample,2090,1739,931,808
2022,2,Eixample,8,l'Antiga Esquerra de l'Eixample,2091,2269,1002,1267
2022,2,Eixample,8,l'Antiga Esquerra de l'Eixample,2092,1759,880,879
2022,2,Eixample,8,l'Antiga Esquerra de l'Eixample,2093,1676,852,824
2022,2,Eixample,8,l'Antiga Esquerra de l'Eixample,2094,1503,774,729
2022,2,Eixample,8,l'Antiga Esquerra de l'Eixample,2095,1512,766,746
2022,2,Eixample,8,l'Antiga Esquerra de l'Eixample,2096,1408,735,673
2022,2,Eixample,8,l'Antiga Esquerra de l'Eixample,2097,1119,594,525
2022,2,Eixample,8,l'Antiga Esquerra de l'Eixample,2098,1446,780,666
2022,2,Eixample,8,l'Antiga Esquerra de l'Eixample,2099,1615,843,772
2022,2,Eixample,8,l'Antiga Esquerra de l'Eixample,2100,1342,711,631
2022,2,Eixample,8,l'Antiga Esquerra de l'Eixample,2101,2181,1178,1003
2022,2,Eixample,8,l'Antiga Esquerra de l'Eixample,2102,1385,775,610
2022,2,Eixample,8,l'Antiga Esquerra de l'Eixample,2103,1650,887,763
2022,2,Eixample,8,l'Antiga Esquerra de l'Eixample,2104,1170,635,535
2022,2,Eixample,8,l'Antiga Esquerra de l'Eixample,2105,2083,1135,948
2022,2,Eixample,8,l'Antiga Esquerra de l'Eixample,2106,1442,781,661
2022,2,Eixample,8,l'Antiga Esquerra de l'Eixample,2107,1630,898,732
2022,2,Eixample,8,l'Antiga Esquerra de l'Eixample,2108,1596,868,728
2022,2,Eixample,8,l'Antiga Esquerra de l'Eixample,2109,2101,1153,948
2022,2,Eixample,9,la Nova Esquerra de l'Eixample,2110,1852,997,855
2022,2,Eixample,9,la Nova Esquerra de l'Eixample,2111,1848,991,857
2022,2,Eixample,9,la Nova Esquerra de l'Eixample,2112,1272,688,584
2022,2,Eixample,9,la Nova Esquerra de l'Eixample,2113,2188,1146,1042
2022,2,Eixample,9,la Nova Esquerra de l'Eixample,2114,1671,904,767
2022,2,Eixample,9,la Nova Esquerra de l'Eixample,2115,1337,726,611
2022,2,Eixample,9,la Nova Esquerra de l'Eixample,2116,990,533,457
2022,2,Eixample,9,la Nova Esquerra de l'Eixample,2117,1217,676,541
2022,2,Eixample,9,la Nova Esquerra de l'Eixample,2118,1444,771,673
2022,2,Eixample,9,la Nova Esquerra de l'Eixample,2119,1267,651,616
2022,2,Eixample,9,la Nova Esquerra de l'Eixample,2120,1163,614,549
2022,2,Eixample,9,la Nova Esquerra de l'Eixample,2121,1262,668,594
2022,2,Eixample,9,la Nova Esquerra de l'Eixample,2122,1026,553,473
2022,2,Eixample,9,la Nova Esquerra de l'Eixample,2123,1093,584,509
2022,2,Eixample,9,la Nova Esquerra de l'Eixample,2124,1083,597,486
2022,2,Eixample,9,la Nova Esquerra de l'Eixample,2125,1670,921,749
2022,2,Eixample,9,la Nova Esquerra de l'Eixample,2126,1464,797,667
2022,2,Eixample,9,la Nova Esquerra de l'Eixample,2127,1156,609,547
2022,2,Eixample,9,la Nova Esquerra de l'Eixample,2128,1300,700,600
2022,2,Eixample,9,la Nova Esquerra de l'Eixample,2129,1523,831,692
2022,2,Eixample,9,la Nova Esquerra de l'Eixample,2130,1104,583,521
2022,2,Eixample,9,la Nova Esquerra de l'Eixample,2131,1121,603,518
2022,2,Eixample,9,la Nova Esquerra de l'Eixample,2132,1012,509,503
2022,2,Eixample,9,la Nova Esquerra de l'Eixample,2133,821,450,371
2022,2,Eixample,9,la Nova Esquerra de l'Eixample,2134,1454,757,697
2022,2,Eixample,9,la Nova Esquerra de l'Eixample,2135,2095,1117,978
2022,2,Eixample,9,la Nova Esquerra de l'Eixample,2136,881,475,406
2022,2,Eixample,9,la Nova Esquerra de l'Eixample,2137,1438,757,681
2022,2,Eixample,9,la Nova Esquerra de l'Eixample,2138,1921,1006,915
2022,2,Eixample,9,la Nova Esquerra de l'Eixample,2139,1711,903,808
2022,2,Eixample,9,la Nova Esquerra de l'Eixample,2140,1891,1015,876
2022,2,Eixample,9,la Nova Esquerra de l'Eixample,2141,1179,628,551
2022,2,Eixample,9,la Nova Esquerra de l'Eixample,2142,2000,1029,971
2022,2,Eixample,9,la Nova Esquerra de l'Eixample,2143,1466,733,733
2022,2,Eixample,9,la Nova Esquerra de l'Eixample,2144,1494,787,707
2022,2,Eixample,9,la Nova Esquerra de l'Eixample,2145,1228,616,612
2022,2,Eixample,9,la Nova Esquerra de l'Eixample,2146,1178,638,540
2022,2,Eixample,9,la Nova Esquerra de l'Eixample,2147,2076,1085,991
2022,2,Eixample,9,la Nova Esquerra de l'Eixample,2148,1554,841,713
2022,2,Eixample,9,la Nova Esquerra de l'Eixample,2149,1864,957,907
2022,2,Eixample,10,Sant Antoni,2150,1508,765,743
2022,2,Eixample,10,Sant Antoni,2151,1489,810,679
2022,2,Eixample,10,Sant Antoni,2152,1270,685,585
2022,2,Eixample,10,Sant Antoni,2153,1352,735,617
2022,2,Eixample,10,Sant Antoni,2154,1006,523,483
2022,2,Eixample,10,Sant Antoni,2155,1804,946,858
2022,2,Eixample,10,Sant Antoni,2156,1283,676,607
2022,2,Eixample,10,Sant Antoni,2157,1194,652,542
2022,2,Eixample,10,Sant Antoni,2158,1584,816,768
2022,2,Eixample,10,Sant Antoni,2159,1961,1018,943
2022,2,Eixample,10,Sant Antoni,2160,1968,1015,953
2022,2,Eixample,10,Sant Antoni,2161,1158,594,564
2022,2,Eixample,10,Sant Antoni,2162,1402,729,673
2022,2,Eixample,10,Sant Antoni,2163,1806,939,867
2022,2,Eixample,10,Sant Antoni,2164,1445,736,709
2022,2,Eixample,10,Sant Antoni,2165,1694,881,813
2022,2,Eixample,10,Sant Antoni,2166,2145,1123,1022
2022,2,Eixample,10,Sant Antoni,2167,2111,1081,1030
2022,2,Eixample,10,Sant Antoni,2168,2256,1201,1055
2022,2,Eixample,10,Sant Antoni,2169,1548,792,756
2022,2,Eixample,10,Sant Antoni,2170,1521,817,704
2022,2,Eixample,10,Sant Antoni,2171,1618,842,776
2022,2,Eixample,10,Sant Antoni,2172,1508,804,704
2022,2,Eixample,10,Sant Antoni,2173,1544,808,736
2022,3,Sants-Montjuïc,11,el Poble-sec,3001,1685,894,791
2022,3,Sants-Montjuïc,11,el Poble-sec,3002,1943,995,948
2022,3,Sants-Montjuïc,11,el Poble-sec,3003,1662,855,807
2022,3,Sants-Montjuïc,11,el Poble-sec,3004,1563,822,741
2022,3,Sants-Montjuïc,11,el Poble-sec,3005,1161,596,565
2022,3,Sants-Montjuïc,11,el Poble-sec,3006,1399,701,698
2022,3,Sants-Montjuïc,11,el Poble-sec,3007,1658,864,794
2022,3,Sants-Montjuïc,11,el Poble-sec,3008,1207,628,579
2022,3,Sants-Montjuïc,11,el Poble-sec,3009,1196,617,579
2022,3,Sants-Montjuïc,11,el Poble-sec,3010,1895,913,982
2022,3,Sants-Montjuïc,11,el Poble-sec,3011,1755,858,897
2022,3,Sants-Montjuïc,11,el Poble-sec,3012,2033,1048,985
2022,3,Sants-Montjuïc,11,el Poble-sec,3013,1717,849,868
2022,3,Sants-Montjuïc,11,el Poble-sec,3014,1779,900,879
2022,3,Sants-Montjuïc,11,el Poble-sec,3015,2901,1473,1428
2022,3,Sants-Montjuïc,11,el Poble-sec,3016,1254,644,610
2022,3,Sants-Montjuïc,11,el Poble-sec,3017,1629,804,825
2022,3,Sants-Montjuïc,11,el Poble-sec,3018,1635,801,834
2022,3,Sants-Montjuïc,11,el Poble-sec,3019,1511,789,722
2022,3,Sants-Montjuïc,11,el Poble-sec,3020,1213,593,620
2022,3,Sants-Montjuïc,11,el Poble-sec,3021,1074,569,505
2022,3,Sants-Montjuïc,11,el Poble-sec,3022,1424,713,711
2022,3,Sants-Montjuïc,11,el Poble-sec,3023,1875,952,923
2022,3,Sants-Montjuïc,11,el Poble-sec,3024,1974,982,992
2022,3,Sants-Montjuïc,12,la Marina del Prat Vermell,3025,1517,746,771
2022,3,Sants-Montjuïc,13,la Marina de Port,3026,998,518,480
2022,3,Sants-Montjuïc,13,la Marina de Port,3027,1704,882,822
2022,3,Sants-Montjuïc,13,la Marina de Port,3028,2612,1331,1281
2022,3,Sants-Montjuïc,13,la Marina de Port,3029,1267,650,617
2022,3,Sants-Montjuïc,13,la Marina de Port,3030,1566,839,727
2022,3,Sants-Montjuïc,13,la Marina de Port,3031,2360,1219,1141
2022,3,Sants-Montjuïc,13,la Marina de Port,3032,1700,879,821
2022,3,Sants-Montjuïc,13,la Marina de Port,3033,1477,731,746
2022,3,Sants-Montjuïc,13,la Marina de Port,3034,1496,788,708
2022,3,Sants-Montjuïc,13,la Marina de Port,3035,2225,1160,1065
2022,3,Sants-Montjuïc,13,la Marina de Port,3036,2365,1238,1127
2022,3,Sants-Montjuïc,13,la Marina de Port,3037,985,510,475
2022,3,Sants-Montjuïc,13,la Marina de Port,3038,937,485,452
2022,3,Sants-Montjuïc,13,la Marina de Port,3039,2495,1302,1193
2022,3,Sants-Montjuïc,13,la Marina de Port,3211,1519,786,733
2022,3,Sants-Montjuïc,13,la Marina de Port,3212,2383,1273,1110
2022,3,Sants-Montjuïc,13,la Marina de Port,3213,2339,1188,1151
2022,3,Sants-Montjuïc,14,la Font de la Guatlla,3040,1690,780,910
2022,3,Sants-Montjuïc,14,la Font de la Guatlla,3041,1394,735,659
2022,3,Sants-Montjuïc,14,la Font de la Guatlla,3042,1348,678,670
2022,3,Sants-Montjuïc,14,la Font de la Guatlla,3043,1566,843,723
2022,3,Sants-Montjuïc,14,la Font de la Guatlla,3044,1886,977,909
2022,3,Sants-Montjuïc,14,la Font de la Guatlla,3045,1084,559,525
2022,3,Sants-Montjuïc,14,la Font de la Guatlla,3046,1391,744,647
2022,3,Sants-Montjuïc,15,Hostafrancs,3047,1733,890,843
2022,3,Sants-Montjuïc,15,Hostafrancs,3048,1335,712,623
2022,3,Sants-Montjuïc,15,Hostafrancs,3049,1656,878,778
2022,3,Sants-Montjuïc,15,Hostafrancs,3050,1605,804,801
2022,3,Sants-Montjuïc,15,Hostafrancs,3051,1890,959,931
2022,3,Sants-Montjuïc,15,Hostafrancs,3052,1342,708,634
2022,3,Sants-Montjuïc,15,Hostafrancs,3053,2147,1124,1023
2022,3,Sants-Montjuïc,15,Hostafrancs,3054,1634,850,784
2022,3,Sants-Montjuïc,15,Hostafrancs,3055,1565,821,744
2022,3,Sants-Montjuïc,15,Hostafrancs,3056,952,510,442
2022,3,Sants-Montjuïc,16,la Bordeta,3057,1477,776,701
2022,3,Sants-Montjuïc,16,la Bordeta,3058,1747,953,794
2022,3,Sants-Montjuïc,16,la Bordeta,3059,1168,606,562
2022,3,Sants-Montjuïc,16,la Bordeta,3060,1344,682,662
2022,3,Sants-Montjuïc,16,la Bordeta,3061,1091,596,495
2022,3,Sants-Montjuïc,16,la Bordeta,3062,1546,817,729
2022,3,Sants-Montjuïc,16,la Bordeta,3063,1954,1011,943
2022,3,Sants-Montjuïc,16,la Bordeta,3064,1202,631,571
2022,3,Sants-Montjuïc,16,la Bordeta,3065,1339,703,636
2022,3,Sants-Montjuïc,16,la Bordeta,3066,2324,1206,1118
2022,3,Sants-Montjuïc,16,la Bordeta,3067,1729,925,804
2022,3,Sants-Montjuïc,16,la Bordeta,3068,1144,611,533
2022,3,Sants-Montjuïc,16,la Bordeta,3069,1162,583,579
2022,3,Sants-Montjuïc,17,Sants - Badal,3070,1319,670,649
2022,3,Sants-Montjuïc,17,Sants - Badal,3071,1343,707,636
2022,3,Sants-Montjuïc,17,Sants - Badal,3072,1335,704,631
2022,3,Sants-Montjuïc,17,Sants - Badal,3073,1580,824,756
2022,3,Sants-Montjuïc,17,Sants - Badal,3074,1750,954,796
2022,3,Sants-Montjuïc,17,Sants - Badal,3075,1738,905,833
2022,3,Sants-Montjuïc,17,Sants - Badal,3076,1042,560,482
2022,3,Sants-Montjuïc,17,Sants - Badal,3077,1329,723,606
2022,3,Sants-Montjuïc,17,Sants - Badal,3078,1700,896,804
2022,3,Sants-Montjuïc,17,Sants - Badal,3079,1800,964,836
2022,3,Sants-Montjuïc,17,Sants - Badal,3080,1515,842,673
2022,3,Sants-Montjuïc,17,Sants - Badal,3081,1873,994,879
2022,3,Sants-Montjuïc,17,Sants - Badal,3082,1857,999,858
2022,3,Sants-Montjuïc,17,Sants - Badal,3083,1357,726,631
2022,3,Sants-Montjuïc,17,Sants - Badal,3084,1365,746,619
2022,3,Sants-Montjuïc,17,Sants - Badal,3085,1305,696,609
2022,3,Sants-Montjuïc,18,Sants,3086,1215,630,585
2022,3,Sants-Montjuïc,18,Sants,3087,1480,792,688
2022,3,Sants-Montjuïc,18,Sants,3088,1382,729,653
2022,3,Sants-Montjuïc,18,Sants,3089,1212,659,553
2022,3,Sants-Montjuïc,18,Sants,3090,958,516,442
2022,3,Sants-Montjuïc,18,Sants,3091,1471,762,709
2022,3,Sants-Montjuïc,18,Sants,3092,1217,640,577
2022,3,Sants-Montjuïc,18,Sants,3093,1471,796,675
2022,3,Sants-Montjuïc,18,Sants,3094,1186,639,547
2022,3,Sants-Montjuïc,18,Sants,3095,1609,842,767
2022,3,Sants-Montjuïc,18,Sants,3096,1518,833,685
2022,3,Sants-Montjuïc,18,Sants,3097,1635,861,774
2022,3,Sants-Montjuïc,18,Sants,3098,1435,720,715
2022,3,Sants-Montjuïc,18,Sants,3099,973,545,428
2022,3,Sants-Montjuïc,18,Sants,3100,1281,705,576
2022,3,Sants-Montjuïc,18,Sants,3101,4382,1815,2567
2022,3,Sants-Montjuïc,18,Sants,3102,1340,710,630
2022,3,Sants-Montjuïc,18,Sants,3103,1125,609,516
2022,3,Sants-Montjuïc,18,Sants,3104,1401,752,649
2022,3,Sants-Montjuïc,18,Sants,3105,1180,637,543
2022,3,Sants-Montjuïc,18,Sants,3106,1291,674,617
2022,3,Sants-Montjuïc,18,Sants,3107,1595,813,782
2022,3,Sants-Montjuïc,18,Sants,3108,1597,840,757
2022,3,Sants-Montjuïc,18,Sants,3109,1503,784,719
2022,3,Sants-Montjuïc,18,Sants,3110,1429,767,662
2022,3,Sants-Montjuïc,18,Sants,3111,1272,703,569
2022,3,Sants-Montjuïc,18,Sants,3112,1839,983,856
2022,3,Sants-Montjuïc,18,Sants,3113,1562,837,725
2022,3,Sants-Montjuïc,18,Sants,3114,1470,781,689
2022,4,Les Corts,19,les Corts,4001,1264,658,606
2022,4,Les Corts,19,les Corts,4002,1905,1006,899
2022,4,Les Corts,19,les Corts,4003,1049,546,503
2022,4,Les Corts,19,les Corts,4004,974,508,466
2022,4,Les Corts,19,les Corts,4005,1205,643,562
2022,4,Les Corts,19,les Corts,4006,1125,611,514
2022,4,Les Corts,19,les Corts,4007,1028,575,453
2022,4,Les Corts,19,les Corts,4008,993,533,460
2022,4,Les Corts,19,les Corts,4009,1468,783,685
2022,4,Les Corts,19,les Corts,4010,889,488,401
2022,4,Les Corts,19,les Corts,4011,1701,913,788
2022,4,Les Corts,19,les Corts,4012,1345,709,636
2022,4,Les Corts,19,les Corts,4013,1209,649,560
2022,4,Les Corts,19,les Corts,4014,781,422,359
2022,4,Les Corts,19,les Corts,4015,1872,1026,846
2022,4,Les Corts,19,les Corts,4016,1056,558,498
2022,4,Les Corts,19,les Corts,4017,1190,652,538
2022,4,Les Corts,19,les Corts,4018,1469,803,666
2022,4,Les Corts,19,les Corts,4019,1366,720,646
2022,4,Les Corts,19,les Corts,4020,1476,799,677
2022,4,Les Corts,19,les Corts,4021,1311,715,596
2022,4,Les Corts,19,les Corts,4022,1652,863,789
2022,4,Les Corts,19,les Corts,4023,1064,564,500
2022,4,Les Corts,19,les Corts,4024,1020,546,474
2022,4,Les Corts,19,les Corts,4025,1149,630,519
2022,4,Les Corts,19,les Corts,4026,1215,669,546
2022,4,Les Corts,19,les Corts,4027,1331,713,618
2022,4,Les Corts,19,les Corts,4028,1298,685,613
2022,4,Les Corts,19,les Corts,4029,1120,618,502
2022,4,Les Corts,19,les Corts,4030,1777,963,814
2022,4,Les Corts,19,les Corts,4031,1888,965,923
2022,4,Les Corts,19,les Corts,4032,1541,848,693
2022,4,Les Corts,19,les Corts,4033,1117,608,509
2022,4,Les Corts,19,les Corts,4034,1476,771,705
2022,4,Les Corts,19,les Corts,4035,1336,728,608
2022,4,Les Corts,20,la Maternitat i Sant Ramon,4036,1706,930,776
2022,4,Les Corts,20,la Maternitat i Sant Ramon,4037,2162,1173,989
2022,4,Les Corts,20,la Maternitat i Sant Ramon,4038,1214,664,550
2022,4,Les Corts,20,la Maternitat i Sant Ramon,4039,1134,609,525
2022,4,Les Corts,20,la Maternitat i Sant Ramon,4040,1589,816,773
2022,4,Les Corts,20,la Maternitat i Sant Ramon,4041,1279,680,599
2022,4,Les Corts,20,la Maternitat i Sant Ramon,4042,1772,955,817
2022,4,Les Corts,20,la Maternitat i Sant Ramon,4043,1605,875,730
2022,4,Les Corts,20,la Maternitat i Sant Ramon,4044,1598,841,757
2022,4,Les Corts,20,la Maternitat i Sant Ramon,4045,1386,743,643
2022,4,Les Corts,20,la Maternitat i Sant Ramon,4046,2392,1254,1138
2022,4,Les Corts,20,la Maternitat i Sant Ramon,4047,1863,986,877
2022,4,Les Corts,20,la Maternitat i Sant Ramon,4048,1469,779,690
2022,4,Les Corts,20,la Maternitat i Sant Ramon,4049,1146,629,517
2022,4,Les Corts,20,la Maternitat i Sant Ramon,4084,1369,735,634
2022,4,Les Corts,21,Pedralbes,4050,2024,1068,956
2022,4,Les Corts,21,Pedralbes,4051,1622,900,722
2022,4,Les Corts,21,Pedralbes,4052,2172,1207,965
2022,4,Les Corts,21,Pedralbes,4053,1695,884,811
2022,4,Les Corts,21,Pedralbes,4054,1010,541,469
2022,4,Les Corts,21,Pedralbes,4055,1477,769,708
2022,4,Les Corts,21,Pedralbes,4056,1730,913,817
2022,5,Sarrià-Sant Gervasi,22,"Vallvidrera, el Tibidabo i les Planes",5001,1818,896,922
2022,5,Sarrià-Sant Gervasi,22,"Vallvidrera, el Tibidabo i les Planes",5002,1618,839,779
2022,5,Sarrià-Sant Gervasi,22,"Vallvidrera, el Tibidabo i les Planes",5003,1369,696,673
2022,5,Sarrià-Sant Gervasi,23,Sarrià,5004,1101,632,469
2022,5,Sarrià-Sant Gervasi,23,Sarrià,5005,1223,618,605
2022,5,Sarrià-Sant Gervasi,23,Sarrià,5006,1827,934,893
2022,5,Sarrià-Sant Gervasi,23,Sarrià,5007,1887,923,964
2022,5,Sarrià-Sant Gervasi,23,Sarrià,5008,1675,898,777
2022,5,Sarrià-Sant Gervasi,23,Sarrià,5009,1669,917,752
2022,5,Sarrià-Sant Gervasi,23,Sarrià,5010,1505,808,697
2022,5,Sarrià-Sant Gervasi,23,Sarrià,5011,1394,756,638
2022,5,Sarrià-Sant Gervasi,23,Sarrià,5012,1337,725,612
2022,5,Sarrià-Sant Gervasi,23,Sarrià,5013,1642,866,776
2022,5,Sarrià-Sant Gervasi,23,Sarrià,5014,1568,839,729
2022,5,Sarrià-Sant Gervasi,23,Sarrià,5015,1523,821,702
2022,5,Sarrià-Sant Gervasi,23,Sarrià,5016,1864,1036,828
2022,5,Sarrià-Sant Gervasi,23,Sarrià,5017,1510,815,695
2022,5,Sarrià-Sant Gervasi,23,Sarrià,5018,1253,675,578
2022,5,Sarrià-Sant Gervasi,23,Sarrià,5019,1654,906,748
2022,5,Sarrià-Sant Gervasi,24,les Tres Torres,5020,1074,593,481
2022,5,Sarrià-Sant Gervasi,24,les Tres Torres,5021,1221,647,574
2022,5,Sarrià-Sant Gervasi,24,les Tres Torres,5022,1683,932,751
2022,5,Sarrià-Sant Gervasi,24,les Tres Torres,5023,1445,799,646
2022,5,Sarrià-Sant Gervasi,24,les Tres Torres,5024,1914,1035,879
2022,5,Sarrià-Sant Gervasi,24,les Tres Torres,5025,1280,675,605
2022,5,Sarrià-Sant Gervasi,24,les Tres Torres,5026,1429,754,675
2022,5,Sarrià-Sant Gervasi,24,les Tres Torres,5027,1368,721,647
2022,5,Sarrià-Sant Gervasi,24,les Tres Torres,5028,1675,834,841
2022,5,Sarrià-Sant Gervasi,24,les Tres Torres,5029,1636,854,782
2022,5,Sarrià-Sant Gervasi,24,les Tres Torres,5030,1383,744,639
2022,5,Sarrià-Sant Gervasi,25,Sant Gervasi - la Bonanova,5031,1600,856,744
2022,5,Sarrià-Sant Gervasi,25,Sant Gervasi - la Bonanova,5032,1821,973,848
2022,5,Sarrià-Sant Gervasi,25,Sant Gervasi - la Bonanova,5033,1449,779,670
2022,5,Sarrià-Sant Gervasi,25,Sant Gervasi - la Bonanova,5034,1243,653,590
2022,5,Sarrià-Sant Gervasi,25,Sant Gervasi - la Bonanova,5035,1037,536,501
2022,5,Sarrià-Sant Gervasi,25,Sant Gervasi - la Bonanova,5036,1736,921,815
2022,5,Sarrià-Sant Gervasi,25,Sant Gervasi - la Bonanova,5037,1407,790,617
2022,5,Sarrià-Sant Gervasi,25,Sant Gervasi - la Bonanova,5038,1335,741,594
2022,5,Sarrià-Sant Gervasi,25,Sant Gervasi - la Bonanova,5039,1537,812,725
2022,5,Sarrià-Sant Gervasi,25,Sant Gervasi - la Bonanova,5040,1449,797,652
2022,5,Sarrià-Sant Gervasi,25,Sant Gervasi - la Bonanova,5041,1958,1028,930
2022,5,Sarrià-Sant Gervasi,25,Sant Gervasi - la Bonanova,5042,1262,673,589
2022,5,Sarrià-Sant Gervasi,25,Sant Gervasi - la Bonanova,5043,1432,786,646
2022,5,Sarrià-Sant Gervasi,25,Sant Gervasi - la Bonanova,5044,1299,715,584
2022,5,Sarrià-Sant Gervasi,25,Sant Gervasi - la Bonanova,5045,1577,865,712
2022,5,Sarrià-Sant Gervasi,25,Sant Gervasi - la Bonanova,5046,1109,642,467
2022,5,Sarrià-Sant Gervasi,25,Sant Gervasi - la Bonanova,5047,1216,685,531
2022,5,Sarrià-Sant Gervasi,25,Sant Gervasi - la Bonanova,5048,1225,695,530
2022,5,Sarrià-Sant Gervasi,26,Sant Gervasi - Galvany,5049,1645,913,732
2022,5,Sarrià-Sant Gervasi,26,Sant Gervasi - Galvany,5050,1625,875,750
2022,5,Sarrià-Sant Gervasi,26,Sant Gervasi - Galvany,5051,1618,863,755
2022,5,Sarrià-Sant Gervasi,26,Sant Gervasi - Galvany,5052,1441,801,640
2022,5,Sarrià-Sant Gervasi,26,Sant Gervasi - Galvany,5053,1486,790,696
2022,5,Sarrià-Sant Gervasi,26,Sant Gervasi - Galvany,5054,1048,582,466
2022,5,Sarrià-Sant Gervasi,26,Sant Gervasi - Galvany,5055,1404,756,648
2022,5,Sarrià-Sant Gervasi,26,Sant Gervasi - Galvany,5056,1223,714,509
2022,5,Sarrià-Sant Gervasi,26,Sant Gervasi - Galvany,5057,1631,868,763
2022,5,Sarrià-Sant Gervasi,26,Sant Gervasi - Galvany,5058,1584,853,731
2022,5,Sarrià-Sant Gervasi,26,Sant Gervasi - Galvany,5059,1577,883,694
2022,5,Sarrià-Sant Gervasi,26,Sant Gervasi - Galvany,5060,1165,654,511
2022,5,Sarrià-Sant Gervasi,26,Sant Gervasi - Galvany,5061,1464,826,638
2022,5,Sarrià-Sant Gervasi,26,Sant Gervasi - Galvany,5062,1624,919,705
2022,5,Sarrià-Sant Gervasi,26,Sant Gervasi - Galvany,5063,1528,831,697
2022,5,Sarrià-Sant Gervasi,26,Sant Gervasi - Galvany,5064,1529,857,672
2022,5,Sarrià-Sant Gervasi,26,Sant Gervasi - Galvany,5065,1659,901,758
2022,5,Sarrià-Sant Gervasi,26,Sant Gervasi - Galvany,5066,1311,722,589
2022,5,Sarrià-Sant Gervasi,26,Sant Gervasi - Galvany,5067,1300,704,596
2022,5,Sarrià-Sant Gervasi,26,Sant Gervasi - Galvany,5068,1541,819,722
2022,5,Sarrià-Sant Gervasi,26,Sant Gervasi - Galvany,5069,1713,896,817
2022,5,Sarrià-Sant Gervasi,26,Sant Gervasi - Galvany,5070,1450,796,654
2022,5,Sarrià-Sant Gervasi,26,Sant Gervasi - Galvany,5071,1639,909,730
2022,5,Sarrià-Sant Gervasi,26,Sant Gervasi - Galvany,5072,1674,926,748
2022,5,Sarrià-Sant Gervasi,26,Sant Gervasi - Galvany,5073,1585,859,726
2022,5,Sarrià-Sant Gervasi,26,Sant Gervasi - Galvany,5074,1642,910,732
2022,5,Sarrià-Sant Gervasi,26,Sant Gervasi - Galvany,5075,1854,1044,810
2022,5,Sarrià-Sant Gervasi,26,Sant Gervasi - Galvany,5076,1396,761,635
2022,5,Sarrià-Sant Gervasi,26,Sant Gervasi - Galvany,5077,1484,818,666
2022,5,Sarrià-Sant Gervasi,26,Sant Gervasi - Galvany,5078,2121,1141,980
2022,5,Sarrià-Sant Gervasi,26,Sant Gervasi - Galvany,5079,1220,670,550
2022,5,Sarrià-Sant Gervasi,27,el Putget i Farró,5080,1336,724,612
2022,5,Sarrià-Sant Gervasi,27,el Putget i Farró,5081,1582,872,710
2022,5,Sarrià-Sant Gervasi,27,el Putget i Farró,5082,1625,885,740
2022,5,Sarrià-Sant Gervasi,27,el Putget i Farró,5083,1310,720,590
2022,5,Sarrià-Sant Gervasi,27,el Putget i Farró,5084,1364,741,623
2022,5,Sarrià-Sant Gervasi,27,el Putget i Farró,5085,1309,700,609
2022,5,Sarrià-Sant Gervasi,27,el Putget i Farró,5086,1324,705,619
2022,5,Sarrià-Sant Gervasi,27,el Putget i Farró,5087,1592,880,712
2022,5,Sarrià-Sant Gervasi,27,el Putget i Farró,5088,1766,901,865
2022,5,Sarrià-Sant Gervasi,27,el Putget i Farró,5089,1812,962,850
2022,5,Sarrià-Sant Gervasi,27,el Putget i Farró,5090,1855,999,856
2022,5,Sarrià-Sant Gervasi,27,el Putget i Farró,5091,1575,866,709
2022,5,Sarrià-Sant Gervasi,27,el Putget i Farró,5092,1570,858,712
2022,5,Sarrià-Sant Gervasi,27,el Putget i Farró,5093,1097,621,476
2022,5,Sarrià-Sant Gervasi,27,el Putget i Farró,5094,2727,1505,1222
2022,5,Sarrià-Sant Gervasi,27,el Putget i Farró,5095,1680,919,761
2022,5,Sarrià-Sant Gervasi,27,el Putget i Farró,5096,1114,620,494
2022,5,Sarrià-Sant Gervasi,27,el Putget i Farró,5097,1620,840,780
2022,5,Sarrià-Sant Gervasi,27,el Putget i Farró,5098,1525,828,697
2022,6,Gràcia,28,Vallcarca i els Penitents,6001,1180,672,508
2022,6,Gràcia,28,Vallcarca i els Penitents,6002,1497,826,671
2022,6,Gràcia,28,Vallcarca i els Penitents,6003,2288,1190,1098
2022,6,Gràcia,28,Vallcarca i els Penitents,6004,1370,701,669
2022,6,Gràcia,28,Vallcarca i els Penitents,6006,1018,528,490
2022,6,Gràcia,28,Vallcarca i els Penitents,6007,1993,1055,938
2022,6,Gràcia,28,Vallcarca i els Penitents,6008,1960,1069,891
2022,6,Gràcia,28,Vallcarca i els Penitents,6009,1264,668,596
2022,6,Gràcia,28,Vallcarca i els Penitents,6010,1024,534,490
2022,6,Gràcia,28,Vallcarca i els Penitents,6011,1313,692,621
2022,6,Gràcia,28,Vallcarca i els Penitents,6012,1175,620,555
2022,6,Gràcia,29,el Coll,6013,1782,947,835
2022,6,Gràcia,29,el Coll,6014,1415,778,637
2022,6,Gràcia,29,el Coll,6015,1438,764,674
2022,6,Gràcia,29,el Coll,6016,1567,843,724
2022,6,Gràcia,29,el Coll,6017,1409,741,668
2022,6,Gràcia,30,la Salut,6018,1302,678,624
2022,6,Gràcia,30,la Salut,6019,1496,787,709
2022,6,Gràcia,30,la Salut,6020,1181,637,544
2022,6,Gràcia,30,la Salut,6021,1357,722,635
2022,6,Gràcia,30,la Salut,6022,1364,683,681
2022,6,Gràcia,30,la Salut,6023,1282,696,586
2022,6,Gràcia,30,la Salut,6024,1682,915,767
2022,6,Gràcia,30,la Salut,6025,1418,786,632
2022,6,Gràcia,30,la Salut,6026,1046,580,466
2022,6,Gràcia,30,la Salut,6027,1209,664,545
2022,6,Gràcia,31,Vila de Gràcia,6028,1317,690,627
2022,6,Gràcia,31,Vila de Gràcia,6029,1308,704,604
2022,6,Gràcia,31,Vila de Gràcia,6030,1318,698,620
2022,6,Gràcia,31,Vila de Gràcia,6031,1103,611,492
2022,6,Gràcia,31,Vila de Gràcia,6032,1156,636,520
2022,6,Gràcia,31,Vila de Gràcia,6033,1270,696,574
2022,6,Gràcia,31,Vila de Gràcia,6034,1178,640,538
2022,6,Gràcia,31,Vila de Gràcia,6035,1081,576,505
2022,6,Gràcia,31,Vila de Gràcia,6036,1418,790,628
2022,6,Gràcia,31,Vila de Gràcia,6037,1104,574,530
2022,6,Gràcia,31,Vila de Gràcia,6038,1490,855,635
2022,6,Gràcia,31,Vila de Gràcia,6039,1566,865,701
2022,6,Gràcia,31,Vila de Gràcia,6040,1664,953,711
2022,6,Gràcia,31,Vila de Gràcia,6041,1743,945,798
2022,6,Gràcia,31,Vila de Gràcia,6042,1681,896,785
2022,6,Gràcia,31,Vila de Gràcia,6043,1285,676,609
2022,6,Gràcia,31,Vila de Gràcia,6044,1590,832,758
2022,6,Gràcia,31,Vila de Gràcia,6045,1274,679,595
2022,6,Gràcia,31,Vila de Gràcia,6046,1133,613,520
2022,6,Gràcia,31,Vila de Gràcia,6047,1208,670,538
2022,6,Gràcia,31,Vila de Gràcia,6048,1390,744,646
2022,6,Gràcia,31,Vila de Gràcia,6049,1102,620,482
2022,6,Gràcia,31,Vila de Gràcia,6050,1295,680,615
2022,6,Gràcia,31,Vila de Gràcia,6051,1201,665,536
2022,6,Gràcia,31,Vila de Gràcia,6052,1482,810,672
2022,6,Gràcia,31,Vila de Gràcia,6053,1497,818,679
2022,6,Gràcia,31,Vila de Gràcia,6054,1591,821,770
2022,6,Gràcia,31,Vila de Gràcia,6055,1388,764,624
2022,6,Gràcia,31,Vila de Gràcia,6056,1576,858,718
2022,6,Gràcia,31,Vila de Gràcia,6057,1536,850,686
2022,6,Gràcia,31,Vila de Gràcia,6058,1677,929,748
2022,6,Gràcia,31,Vila de Gràcia,6059,1491,787,704
2022,6,Gràcia,31,Vila de Gràcia,6060,1719,917,802
2022,6,Gràcia,31,Vila de Gràcia,6061,1280,674,606
2022,6,Gràcia,31,Vila de Gràcia,6062,1258,686,572
2022,6,Gràcia,31,Vila de Gràcia,6063,1482,814,668
2022,6,Gràcia,32,el Camp d'en Grassot i Gràcia Nova,6064,1906,1038,868
2022,6,Gràcia,32,el Camp d'en Grassot i Gràcia Nova,6065,1127,600,527
2022,6,Gràcia,32,el Camp d'en Grassot i Gràcia Nova,6066,979,545,434
2022,6,Gràcia,32,el Camp d'en Grassot i Gràcia Nova,6067,1748,941,807
2022,6,Gràcia,32,el Camp d'en Grassot i Gràcia Nova,6068,1572,892,680
2022,6,Gràcia,32,el Camp d'en Grassot i Gràcia Nova,6069,1043,561,482
2022,6,Gràcia,32,el Camp d'en Grassot i Gràcia Nova,6070,1867,1046,821
2022,6,Gràcia,32,el Camp d'en Grassot i Gràcia Nova,6071,1064,568,496
2022,6,Gràcia,32,el Camp d'en Grassot i Gràcia Nova,6072,1622,863,759
2022,6,Gràcia,32,el Camp d'en Grassot i Gràcia Nova,6073,1327,720,607
2022,6,Gràcia,32,el Camp d'en Grassot i Gràcia Nova,6074,1105,581,524
2022,6,Gràcia,32,el Camp d'en Grassot i Gràcia Nova,6075,1053,559,494
2022,6,Gràcia,32,el Camp d'en Grassot i Gràcia Nova,6076,1316,695,621
2022,6,Gràcia,32,el Camp d'en Grassot i Gràcia Nova,6077,1170,638,532
2022,6,Gràcia,32,el Camp d'en Grassot i Gràcia Nova,6078,1276,692,584
2022,6,Gràcia,32,el Camp d'en Grassot i Gràcia Nova,6079,1111,613,498
2022,6,Gràcia,32,el Camp d'en Grassot i Gràcia Nova,6080,1148,618,530
2022,6,Gràcia,32,el Camp d'en Grassot i Gràcia Nova,6081,1299,710,589
2022,6,Gràcia,32,el Camp d'en Grassot i Gràcia Nova,6082,2859,1435,1424
2022,6,Gràcia,32,el Camp d'en Grassot i Gràcia Nova,6083,1652,859,793
2022,6,Gràcia,32,el Camp d'en Grassot i Gràcia Nova,6084,1460,817,643
2022,6,Gràcia,32,el Camp d'en Grassot i Gràcia Nova,6085,1275,698,577
2022,6,Gràcia,32,el Camp d'en Grassot i Gràcia Nova,6086,967,524,443
2022,6,Gràcia,32,el Camp d'en Grassot i Gràcia Nova,6087,1836,999,837
2022,6,Gràcia,32,el Camp d'en Grassot i Gràcia Nova,6088,1251,695,556
2022,7,Horta-Guinardó,33,el Baix Guinardó,7001,1551,857,694
2022,7,Horta-Guinardó,33,el Baix Guinardó,7002,1123,630,493
2022,7,Horta-Guinardó,33,el Baix Guinardó,7003,1307,697,610
2022,7,Horta-Guinardó,33,el Baix Guinardó,7004,1535,837,698
2022,7,Horta-Guinardó,33,el Baix Guinardó,7005,1461,773,688
2022,7,Horta-Guinardó,33,el Baix Guinardó,7006,955,503,452
2022,7,Horta-Guinardó,33,el Baix Guinardó,7007,1368,750,618
2022,7,Horta-Guinardó,33,el Baix Guinardó,7008,1394,735,659
2022,7,Horta-Guinardó,33,el Baix Guinardó,7009,1232,695,537
2022,7,Horta-Guinardó,33,el Baix Guinardó,7010,1309,684,625
2022,7,Horta-Guinardó,33,el Baix Guinardó,7011,1138,612,526
2022,7,Horta-Guinardó,33,el Baix Guinardó,7012,1535,840,695
2022,7,Horta-Guinardó,33,el Baix Guinardó,7013,1198,641,557
2022,7,Horta-Guinardó,33,el Baix Guinardó,7014,868,462,406
2022,7,Horta-Guinardó,33,el Baix Guinardó,7015,1382,731,651
2022,7,Horta-Guinardó,33,el Baix Guinardó,7016,1367,701,666
2022,7,Horta-Guinardó,33,el Baix Guinardó,7017,1706,939,767
2022,7,Horta-Guinardó,33,el Baix Guinardó,7018,1664,897,767
2022,7,Horta-Guinardó,33,el Baix Guinardó,7019,1498,778,720
2022,7,Horta-Guinardó,34,Can Baró,7020,1695,902,793
2022,7,Horta-Guinardó,34,Can Baró,7021,1066,554,512
2022,7,Horta-Guinardó,34,Can Baró,7022,1166,617,549
2022,7,Horta-Guinardó,34,Can Baró,7023,1303,655,648
2022,7,Horta-Guinardó,34,Can Baró,7024,1478,788,690
2022,7,Horta-Guinardó,34,Can Baró,7025,1444,763,681
2022,7,Horta-Guinardó,34,Can Baró,7026,1119,601,518
2022,7,Horta-Guinardó,35,el Guinardó,7027,2116,1127,989
2022,7,Horta-Guinardó,35,el Guinardó,7028,1475,760,715
2022,7,Horta-Guinardó,35,el Guinardó,7029,1313,683,630
2022,7,Horta-Guinardó,35,el Guinardó,7030,1365,749,616
2022,7,Horta-Guinardó,35,el Guinardó,7031,1558,806,752
2022,7,Horta-Guinardó,35,el Guinardó,7032,1436,741,695
2022,7,Horta-Guinardó,35,el Guinardó,7033,1423,760,663
2022,7,Horta-Guinardó,35,el Guinardó,7034,1799,962,837
2022,7,Horta-Guinardó,35,el Guinardó,7035,1734,927,807
2022,7,Horta-Guinardó,35,el Guinardó,7036,1405,763,642
2022,7,Horta-Guinardó,35,el Guinardó,7037,1479,788,691
2022,7,Horta-Guinardó,35,el Guinardó,7038,1270,672,598
2022,7,Horta-Guinardó,35,el Guinardó,7039,1605,857,748
2022,7,Horta-Guinardó,35,el Guinardó,7040,1487,817,670
2022,7,Horta-Guinardó,35,el Guinardó,7041,1375,761,614
2022,7,Horta-Guinardó,35,el Guinardó,7042,1513,839,674
2022,7,Horta-Guinardó,35,el Guinardó,7043,1409,756,653
2022,7,Horta-Guinardó,35,el Guinardó,7044,1282,685,597
2022,7,Horta-Guinardó,35,el Guinardó,7045,1568,806,762
2022,7,Horta-Guinardó,35,el Guinardó,7046,1394,764,630
2022,7,Horta-Guinardó,35,el Guinardó,7047,1435,750,685
2022,7,Horta-Guinardó,35,el Guinardó,7048,1341,727,614
2022,7,Horta-Guinardó,35,el Guinardó,7049,1200,625,575
2022,7,Horta-Guinardó,35,el Guinardó,7050,1190,633,557
2022,7,Horta-Guinardó,35,el Guinardó,7051,1822,989,833
2022,7,Horta-Guinardó,36,la Font d'en Fargues,7052,1254,648,606
2022,7,Horta-Guinardó,36,la Font d'en Fargues,7053,1480,777,703
2022,7,Horta-Guinardó,36,la Font d'en Fargues,7054,1632,853,779
2022,7,Horta-Guinardó,36,la Font d'en Fargues,7055,1206,648,558
2022,7,Horta-Guinardó,36,la Font d'en Fargues,7056,1181,607,574
2022,7,Horta-Guinardó,36,la Font d'en Fargues,7057,1426,749,677
2022,7,Horta-Guinardó,36,la Font d'en Fargues,7058,1348,694,654
2022,7,Horta-Guinardó,37,el Carmel,7059,1300,668,632
2022,7,Horta-Guinardó,37,el Carmel,7060,1872,950,922
2022,7,Horta-Guinardó,37,el Carmel,7061,1204,615,589
2022,7,Horta-Guinardó,37,el Carmel,7062,1367,708,659
2022,7,Horta-Guinardó,37,el Carmel,7063,1459,761,698
2022,7,Horta-Guinardó,37,el Carmel,7064,1698,896,802
2022,7,Horta-Guinardó,37,el Carmel,7065,1708,933,775
2022,7,Horta-Guinardó,37,el Carmel,7066,1743,906,837
2022,7,Horta-Guinardó,37,el Carmel,7067,1560,818,742
2022,7,Horta-Guinardó,37,el Carmel,7068,1314,709,605
2022,7,Horta-Guinardó,37,el Carmel,7069,1440,758,682
2022,7,Horta-Guinardó,37,el Carmel,7070,1437,771,666
2022,7,Horta-Guinardó,37,el Carmel,7071,1339,712,627
2022,7,Horta-Guinardó,37,el Carmel,7072,1372,730,642
2022,7,Horta-Guinardó,37,el Carmel,7073,1137,606,531
2022,7,Horta-Guinardó,37,el Carmel,7074,1659,860,799
2022,7,Horta-Guinardó,37,el Carmel,7075,1194,619,575
2022,7,Horta-Guinardó,37,el Carmel,7076,1404,734,670
2022,7,Horta-Guinardó,37,el Carmel,7077,1314,674,640
2022,7,Horta-Guinardó,37,el Carmel,7078,1381,710,671
2022,7,Horta-Guinardó,37,el Carmel,7079,1437,768,669
2022,7,Horta-Guinardó,37,el Carmel,7080,1780,943,837
2022,7,Horta-Guinardó,38,la Teixonera,7081,1915,995,920
2022,7,Horta-Guinardó,38,la Teixonera,7082,1233,643,590
2022,7,Horta-Guinardó,38,la Teixonera,7083,1343,708,635
2022,7,Horta-Guinardó,38,la Teixonera,7084,1361,677,684
2022,7,Horta-Guinardó,38,la Teixonera,7085,1275,659,616
2022,7,Horta-Guinardó,38,la Teixonera,7086,1487,775,712
2022,7,Horta-Guinardó,38,la Teixonera,7087,1600,875,725
2022,7,Horta-Guinardó,38,la Teixonera,7088,1704,892,812
2022,7,Horta-Guinardó,39,Sant Genís dels Agudells,7089,1373,760,613
2022,7,Horta-Guinardó,39,Sant Genís dels Agudells,7090,1465,746,719
2022,7,Horta-Guinardó,39,Sant Genís dels Agudells,7091,1241,668,573
2022,7,Horta-Guinardó,39,Sant Genís dels Agudells,7092,1479,826,653
2022,7,Horta-Guinardó,39,Sant Genís dels Agudells,7093,1704,861,843
2022,7,Horta-Guinardó,40,Montbau,7094,1224,665,559
2022,7,Horta-Guinardó,40,Montbau,7095,1500,790,710
2022,7,Horta-Guinardó,40,Montbau,7096,1421,782,639
2022,7,Horta-Guinardó,40,Montbau,7097,869,503,366
2022,7,Horta-Guinardó,41,la Vall d'Hebron,7098,2141,1138,1003
2022,7,Horta-Guinardó,41,la Vall d'Hebron,7099,1033,532,501
2022,7,Horta-Guinardó,41,la Vall d'Hebron,7100,1190,643,547
2022,7,Horta-Guinardó,41,la Vall d'Hebron,7101,1505,819,686
2022,7,Horta-Guinardó,42,la Clota,7102,669,322,347
2022,7,Horta-Guinardó,43,Horta,7103,1509,796,713
2022,7,Horta-Guinardó,43,Horta,7104,1565,828,737
2022,7,Horta-Guinardó,43,Horta,7105,1031,551,480
2022,7,Horta-Guinardó,43,Horta,7106,1167,639,528
2022,7,Horta-Guinardó,43,Horta,7107,1170,615,555
2022,7,Horta-Guinardó,43,Horta,7108,1240,663,577
2022,7,Horta-Guinardó,43,Horta,7109,1672,890,782
2022,7,Horta-Guinardó,43,Horta,7110,1027,580,447
2022,7,Horta-Guinardó,43,Horta,7111,883,501,382
2022,7,Horta-Guinardó,43,Horta,7112,1292,684,608
2022,7,Horta-Guinardó,43,Horta,7113,1167,611,556
2022,7,Horta-Guinardó,43,Horta,7114,1183,634,549
2022,7,Horta-Guinardó,43,Horta,7115,1069,580,489
2022,7,Horta-Guinardó,43,Horta,7116,1485,813,672
2022,7,Horta-Guinardó,43,Horta,7117,2786,1316,1470
2022,7,Horta-Guinardó,43,Horta,7118,1231,669,562
2022,7,Horta-Guinardó,43,Horta,7119,1300,694,606
2022,7,Horta-Guinardó,43,Horta,7120,1233,678,555
2022,7,Horta-Guinardó,43,Horta,7121,1151,625,526
2022,7,Horta-Guinardó,43,Horta,7122,1293,703,590
2022,7,Horta-Guinardó,43,Horta,7123,1421,749,672
2022,8,Nou Barris,44,Vilapicina i la Torre Llobeta,8001,1271,682,589
2022,8,Nou Barris,44,Vilapicina i la Torre Llobeta,8002,1251,665,586
2022,8,Nou Barris,44,Vilapicina i la Torre Llobeta,8003,1192,640,552
2022,8,Nou Barris,44,Vilapicina i la Torre Llobeta,8004,1455,799,656
2022,8,Nou Barris,44,Vilapicina i la Torre Llobeta,8005,1137,598,539
2022,8,Nou Barris,44,Vilapicina i la Torre Llobeta,8006,1648,883,765
2022,8,Nou Barris,44,Vilapicina i la Torre Llobeta,8007,1145,620,525
2022,8,Nou Barris,44,Vilapicina i la Torre Llobeta,8008,1632,872,760
2022,8,Nou Barris,44,Vilapicina i la Torre Llobeta,8009,1785,929,856
2022,8,Nou Barris,44,Vilapicina i la Torre Llobeta,8010,1085,574,511
2022,8,Nou Barris,44,Vilapicina i la Torre Llobeta,8011,1166,628,538
2022,8,Nou Barris,44,Vilapicina i la Torre Llobeta,8012,1299,721,578
2022,8,Nou Barris,44,Vilapicina i la Torre Llobeta,8013,1169,638,531
2022,8,Nou Barris,44,Vilapicina i la Torre Llobeta,8014,1253,673,580
2022,8,Nou Barris,44,Vilapicina i la Torre Llobeta,8015,1372,763,609
2022,8,Nou Barris,44,Vilapicina i la Torre Llobeta,8016,1136,633,503
2022,8,Nou Barris,44,Vilapicina i la Torre Llobeta,8017,1354,710,644
2022,8,Nou Barris,44,Vilapicina i la Torre Llobeta,8018,1490,800,690
2022,8,Nou Barris,44,Vilapicina i la Torre Llobeta,8019,1827,977,850
2022,8,Nou Barris,45,Porta,8020,1347,709,638
2022,8,Nou Barris,45,Porta,8021,1443,790,653
2022,8,Nou Barris,45,Porta,8022,1200,634,566
2022,8,Nou Barris,45,Porta,8023,1384,734,650
2022,8,Nou Barris,45,Porta,8024,1343,742,601
2022,8,Nou Barris,45,Porta,8025,1219,687,532
2022,8,Nou Barris,45,Porta,8026,1341,726,615
2022,8,Nou Barris,45,Porta,8027,1405,713,692
2022,8,Nou Barris,45,Porta,8028,1066,583,483
2022,8,Nou Barris,45,Porta,8029,1484,797,687
2022,8,Nou Barris,45,Porta,8030,1442,756,686
2022,8,Nou Barris,45,Porta,8031,1260,677,583
2022,8,Nou Barris,45,Porta,8032,1264,684,580
2022,8,Nou Barris,45,Porta,8033,1481,781,700
2022,8,Nou Barris,45,Porta,8034,1234,706,528
2022,8,Nou Barris,45,Porta,8035,4462,2082,2380
2022,8,Nou Barris,45,Porta,8036,1507,832,675
2022,8,Nou Barris,45,Porta,8037,1515,838,677
2022,8,Nou Barris,46,el Turó de la Peira,8038,1615,875,740
2022,8,Nou Barris,46,el Turó de la Peira,8039,1532,804,728
2022,8,Nou Barris,46,el Turó de la Peira,8040,1886,1010,876
2022,8,Nou Barris,46,el Turó de la Peira,8041,2496,1278,1218
2022,8,Nou Barris,46,el Turó de la Peira,8042,1226,690,536
2022,8,Nou Barris,46,el Turó de la Peira,8043,1126,637,489
2022,8,Nou Barris,46,el Turó de la Peira,8044,1330,707,623
2022,8,Nou Barris,46,el Turó de la Peira,8045,1736,901,835
2022,8,Nou Barris,46,el Turó de la Peira,8046,1448,797,651
2022,8,Nou Barris,46,el Turó de la Peira,8047,1630,885,745
2022,8,Nou Barris,47,Can Peguera,8048,971,510,461
2022,8,Nou Barris,47,Can Peguera,8049,1216,648,568
2022,8,Nou Barris,48,la Guineueta,8050,1380,732,648
2022,8,Nou Barris,48,la Guineueta,8051,1339,696,643
2022,8,Nou Barris,48,la Guineueta,8052,887,491,396
2022,8,Nou Barris,48,la Guineueta,8053,1118,606,512
2022,8,Nou Barris,48,la Guineueta,8054,1592,872,720
2022,8,Nou Barris,48,la Guineueta,8055,1797,953,844
2022,8,Nou Barris,48,la Guineueta,8056,1481,777,704
2022,8,Nou Barris,48,la Guineueta,8057,1305,707,598
2022,8,Nou Barris,48,la Guineueta,8058,1612,862,750
2022,8,Nou Barris,48,la Guineueta,8059,992,520,472
2022,8,Nou Barris,48,la Guineueta,8215,1553,888,665
2022,8,Nou Barris,49,Canyelles,8060,1175,637,538
2022,8,Nou Barris,49,Canyelles,8061,1635,847,788
2022,8,Nou Barris,49,Canyelles,8062,1122,595,527
2022,8,Nou Barris,49,Canyelles,8063,1055,554,501
2022,8,Nou Barris,49,Canyelles,8064,1800,946,854
2022,8,Nou Barris,50,les Roquetes,8065,1763,870,893
2022,8,Nou Barris,50,les Roquetes,8066,1564,803,761
2022,8,Nou Barris,50,les Roquetes,8067,1808,936,872
2022,8,Nou Barris,50,les Roquetes,8068,1865,977,888
2022,8,Nou Barris,50,les Roquetes,8069,1540,802,738
2022,8,Nou Barris,50,les Roquetes,8070,1477,773,704
2022,8,Nou Barris,50,les Roquetes,8071,1715,887,828
2022,8,Nou Barris,50,les Roquetes,8072,1186,638,548
2022,8,Nou Barris,50,les Roquetes,8073,1725,905,820
2022,8,Nou Barris,50,les Roquetes,8074,1513,779,734
2022,8,Nou Barris,51,Verdun,8075,1876,1021,855
2022,8,Nou Barris,51,Verdun,8076,1585,877,708
2022,8,Nou Barris,51,Verdun,8077,1407,751,656
2022,8,Nou Barris,51,Verdun,8078,1536,818,718
2022,8,Nou Barris,51,Verdun,8079,1420,758,662
2022,8,Nou Barris,51,Verdun,8080,1518,789,729
2022,8,Nou Barris,51,Verdun,8081,1626,843,783
2022,8,Nou Barris,51,Verdun,8082,1590,881,709
2022,8,Nou Barris,52,la Prosperitat,8083,1282,679,603
2022,8,Nou Barris,52,la Prosperitat,8084,1087,602,485
2022,8,Nou Barris,52,la Prosperitat,8085,1504,776,728
2022,8,Nou Barris,52,la Prosperitat,8086,1642,890,752
2022,8,Nou Barris,52,la Prosperitat,8087,1204,646,558
2022,8,Nou Barris,52,la Prosperitat,8088,1249,665,584
2022,8,Nou Barris,52,la Prosperitat,8089,1217,655,562
2022,8,Nou Barris,52,la Prosperitat,8090,1204,625,579
2022,8,Nou Barris,52,la Prosperitat,8091,1168,618,550
2022,8,Nou Barris,52,la Prosperitat,8092,993,521,472
2022,8,Nou Barris,52,la Prosperitat,8093,1250,641,609
2022,8,Nou Barris,52,la Prosperitat,8094,1414,742,672
2022,8,Nou Barris,52,la Prosperitat,8095,1087,561,526
2022,8,Nou Barris,52,la Prosperitat,8096,1523,800,723
2022,8,Nou Barris,52,la Prosperitat,8097,1317,714,603
2022,8,Nou Barris,52,la Prosperitat,8098,1267,673,594
2022,8,Nou Barris,52,la Prosperitat,8099,1422,736,686
2022,8,Nou Barris,52,la Prosperitat,8100,1269,700,569
2022,8,Nou Barris,52,la Prosperitat,8101,1680,898,782
2022,8,Nou Barris,52,la Prosperitat,8102,1567,872,695
2022,8,Nou Barris,53,la Trinitat Nova,8103,1653,831,822
2022,8,Nou Barris,53,la Trinitat Nova,8104,1234,646,588
2022,8,Nou Barris,53,la Trinitat Nova,8105,1426,756,670
2022,8,Nou Barris,53,la Trinitat Nova,8106,1236,647,589
2022,8,Nou Barris,53,la Trinitat Nova,8107,1872,989,883
2022,8,Nou Barris,54,Torre Baró,8108,1929,972,957
2022,8,Nou Barris,54,Torre Baró,8109,979,489,490
2022,8,Nou Barris,55,Ciutat Meridiana,8110,1990,1002,988
2022,8,Nou Barris,55,Ciutat Meridiana,8111,1659,858,801
2022,8,Nou Barris,55,Ciutat Meridiana,8112,1699,854,845
2022,8,Nou Barris,55,Ciutat Meridiana,8113,1790,928,862
2022,8,Nou Barris,55,Ciutat Meridiana,8114,1963,998,965
2022,8,Nou Barris,55,Ciutat Meridiana,8115,1707,859,848
2022,8,Nou Barris,56,Vallbona,8116,1420,723,697
2022,9,Sant Andreu,57,la Trinitat Vella,9001,2739,1300,1439
2022,9,Sant Andreu,57,la Trinitat Vella,9002,2158,1061,1097
2022,9,Sant Andreu,57,la Trinitat Vella,9003,2176,1062,1114
2022,9,Sant Andreu,57,la Trinitat Vella,9004,1663,829,834
2022,9,Sant Andreu,57,la Trinitat Vella,9005,1622,824,798
2022,9,Sant Andreu,58,Baró de Viver,9006,1275,651,624
2022,9,Sant Andreu,58,Baró de Viver,9007,1328,689,639
2022,9,Sant Andreu,59,el Bon Pastor,9008,1869,931,938
2022,9,Sant Andreu,59,el Bon Pastor,9009,1384,733,651
2022,9,Sant Andreu,59,el Bon Pastor,9010,1794,926,868
2022,9,Sant Andreu,59,el Bon Pastor,9011,1637,839,798
2022,9,Sant Andreu,59,el Bon Pastor,9013,2031,1055,976
2022,9,Sant Andreu,59,el Bon Pastor,9014,2988,1343,1645
2022,9,Sant Andreu,59,el Bon Pastor,9015,1850,955,895
2022,9,Sant Andreu,60,Sant Andreu,9016,1282,673,609
2022,9,Sant Andreu,60,Sant Andreu,9017,1512,794,718
2022,9,Sant Andreu,60,Sant Andreu,9018,1462,758,704
2022,9,Sant Andreu,60,Sant Andreu,9019,2665,1369,1296
2022,9,Sant Andreu,60,Sant Andreu,9020,1115,606,509
2022,9,Sant Andreu,60,Sant Andreu,9021,1407,754,653
2022,9,Sant Andreu,60,Sant Andreu,9022,1268,664,604
2022,9,Sant Andreu,60,Sant Andreu,9023,1212,605,607
2022,9,Sant Andreu,60,Sant Andreu,9024,1195,664,531
2022,9,Sant Andreu,60,Sant Andreu,9025,1233,661,572
2022,9,Sant Andreu,60,Sant Andreu,9026,1477,790,687
2022,9,Sant Andreu,60,Sant Andreu,9027,1284,670,614
2022,9,Sant Andreu,60,Sant Andreu,9028,1561,801,760
2022,9,Sant Andreu,60,Sant Andreu,9029,1085,569,516
2022,9,Sant Andreu,60,Sant Andreu,9030,1451,774,677
2022,9,Sant Andreu,60,Sant Andreu,9031,1174,598,576
2022,9,Sant Andreu,60,Sant Andreu,9032,2154,1133,1021
2022,9,Sant Andreu,60,Sant Andreu,9033,3201,1655,1546
2022,9,Sant Andreu,60,Sant Andreu,9034,1406,742,664
2022,9,Sant Andreu,60,Sant Andreu,9035,1557,820,737
2022,9,Sant Andreu,60,Sant Andreu,9036,1373,733,640
2022,9,Sant Andreu,60,Sant Andreu,9037,1621,807,814
2022,9,Sant Andreu,60,Sant Andreu,9038,1736,942,794
2022,9,Sant Andreu,60,Sant Andreu,9039,1512,803,709
2022,9,Sant Andreu,60,Sant Andreu,9040,1603,856,747
2022,9,Sant Andreu,60,Sant Andreu,9041,1376,747,629
2022,9,Sant Andreu,60,Sant Andreu,9042,1247,694,553
2022,9,Sant Andreu,60,Sant Andreu,9043,1336,705,631
2022,9,Sant Andreu,60,Sant Andreu,9044,1519,777,742
2022,9,Sant Andreu,60,Sant Andreu,9045,1400,761,639
2022,9,Sant Andreu,60,Sant Andreu,9046,1330,696,634
2022,9,Sant Andreu,60,Sant Andreu,9047,1553,822,731
2022,9,Sant Andreu,60,Sant Andreu,9048,1342,722,620
2022,9,Sant Andreu,60,Sant Andreu,9049,1289,696,593
2022,9,Sant Andreu,60,Sant Andreu,9050,1493,780,713
2022,9,Sant Andreu,60,Sant Andreu,9051,1279,652,627
2022,9,Sant Andreu,60,Sant Andreu,9052,1198,630,568
2022,9,Sant Andreu,60,Sant Andreu,9053,1625,864,761
2022,9,Sant Andreu,60,Sant Andreu,9054,1072,570,502
2022,9,Sant Andreu,61,la Sagrera,9055,1738,927,811
2022,9,Sant Andreu,61,la Sagrera,9056,1095,575,520
2022,9,Sant Andreu,61,la Sagrera,9057,1685,879,806
2022,9,Sant Andreu,61,la Sagrera,9058,1525,801,724
2022,9,Sant Andreu,61,la Sagrera,9059,1426,740,686
2022,9,Sant Andreu,61,la Sagrera,9060,1339,721,618
2022,9,Sant Andreu,61,la Sagrera,9061,1593,838,755
2022,9,Sant Andreu,61,la Sagrera,9062,1486,773,713
2022,9,Sant Andreu,61,la Sagrera,9063,1143,599,544
2022,9,Sant Andreu,61,la Sagrera,9064,1147,604,543
2022,9,Sant Andreu,61,la Sagrera,9065,2086,1130,956
2022,9,Sant Andreu,61,la Sagrera,9066,1411,740,671
2022,9,Sant Andreu,61,la Sagrera,9067,1506,817,689
2022,9,Sant Andreu,61,la Sagrera,9068,1528,782,746
2022,9,Sant Andreu,61,la Sagrera,9069,933,512,421
2022,9,Sant Andreu,61,la Sagrera,9070,1745,932,813
2022,9,Sant Andreu,61,la Sagrera,9071,1899,1025,874
2022,9,Sant Andreu,61,la Sagrera,9072,1426,777,649
2022,9,Sant Andreu,61,la Sagrera,9073,1473,784,689
2022,9,Sant Andreu,61,la Sagrera,9156,1257,672,585
2022,9,Sant Andreu,62,el Congrés i els Indians,9074,1664,872,792
2022,9,Sant Andreu,62,el Congrés i els Indians,9075,1533,789,744
2022,9,Sant Andreu,62,el Congrés i els Indians,9076,1444,777,667
2022,9,Sant Andreu,62,el Congrés i els Indians,9077,1607,872,735
2022,9,Sant Andreu,62,el Congrés i els Indians,9078,1437,768,669
2022,9,Sant Andreu,62,el Congrés i els Indians,9079,1609,851,758
2022,9,Sant Andreu,62,el Congrés i els Indians,9080,1328,692,636
2022,9,Sant Andreu,62,el Congrés i els Indians,9081,1725,926,799
2022,9,Sant Andreu,62,el Congrés i els Indians,9082,1972,1040,932
2022,9,Sant Andreu,63,Navas,9083,1638,879,759
2022,9,Sant Andreu,63,Navas,9084,1676,890,786
2022,9,Sant Andreu,63,Navas,9085,1797,944,853
2022,9,Sant Andreu,63,Navas,9086,1488,804,684
2022,9,Sant Andreu,63,Navas,9087,1311,686,625
2022,9,Sant Andreu,63,Navas,9088,1915,1062,853
2022,9,Sant Andreu,63,Navas,9089,1477,817,660
2022,9,Sant Andreu,63,Navas,9090,1523,813,710
2022,9,Sant Andreu,63,Navas,9091,1861,1005,856
2022,9,Sant Andreu,63,Navas,9092,1879,971,908
2022,9,Sant Andreu,63,Navas,9093,1279,676,603
2022,9,Sant Andreu,63,Navas,9094,1958,1029,929
2022,9,Sant Andreu,63,Navas,9095,2145,1126,1019
2022,10,Sant Martí,64,Camp de l'Arpa del Clot,10001,1595,818,777
2022,10,Sant Martí,64,Camp de l'Arpa del Clot,10002,1773,910,863
2022,10,Sant Martí,64,Camp de l'Arpa del Clot,10003,1571,825,746
2022,10,Sant Martí,64,Camp de l'Arpa del Clot,10004,1541,851,690
2022,10,Sant Martí,64,Camp de l'Arpa del Clot,10005,1649,912,737
2022,10,Sant Martí,64,Camp de l'Arpa del Clot,10006,1824,984,840
2022,10,Sant Martí,64,Camp de l'Arpa del Clot,10007,1294,664,630
2022,10,Sant Martí,64,Camp de l'Arpa del Clot,10008,1714,919,795
2022,10,Sant Martí,64,Camp de l'Arpa del Clot,10009,1607,847,760
2022,10,Sant Martí,64,Camp de l'Arpa del Clot,10010,1712,917,795
2022,10,Sant Martí,64,Camp de l'Arpa del Clot,10011,1183,637,546
2022,10,Sant Martí,64,Camp de l'Arpa del Clot,10012,1780,935,845
2022,10,Sant Martí,64,Camp de l'Arpa del Clot,10013,1361,739,622
2022,10,Sant Martí,64,Camp de l'Arpa del Clot,10014,1469,789,680
2022,10,Sant Martí,64,Camp de l'Arpa del Clot,10015,1930,1009,921
2022,10,Sant Martí,64,Camp de l'Arpa del Clot,10016,1217,617,600
2022,10,Sant Martí,64,Camp de l'Arpa del Clot,10017,1661,911,750
2022,10,Sant Martí,64,Camp de l'Arpa del Clot,10018,1457,768,689
2022,10,Sant Martí,64,Camp de l'Arpa del Clot,10019,1518,814,704
2022,10,Sant Martí,64,Camp de l'Arpa del Clot,10020,1457,773,684
2022,10,Sant Martí,64,Camp de l'Arpa del Clot,10021,1301,675,626
2022,10,Sant Martí,64,Camp de l'Arpa del Clot,10022,1353,715,638
2022,10,Sant Martí,64,Camp de l'Arpa del Clot,10023,1442,787,655
2022,10,Sant Martí,64,Camp de l'Arpa del Clot,10024,1487,768,719
2022,10,Sant Martí,64,Camp de l'Arpa del Clot,10025,1311,731,580
2022,10,Sant Martí,65,el Clot,10026,1550,809,741
2022,10,Sant Martí,65,el Clot,10027,1517,814,703
2022,10,Sant Martí,65,el Clot,10028,1737,903,834
2022,10,Sant Martí,65,el Clot,10029,1410,719,691
2022,10,Sant Martí,65,el Clot,10030,1738,933,805
2022,10,Sant Martí,65,el Clot,10031,1509,778,731
2022,10,Sant Martí,65,el Clot,10032,1353,707,646
2022,10,Sant Martí,65,el Clot,10033,859,468,391
2022,10,Sant Martí,65,el Clot,10034,1687,885,802
2022,10,Sant Martí,65,el Clot,10035,1946,993,953
2022,10,Sant Martí,65,el Clot,10036,1420,712,708
2022,10,Sant Martí,65,el Clot,10037,1046,549,497
2022,10,Sant Martí,65,el Clot,10038,1600,832,768
2022,10,Sant Martí,65,el Clot,10039,1833,966,867
2022,10,Sant Martí,65,el Clot,10040,1781,919,862
2022,10,Sant Martí,65,el Clot,10041,1612,841,771
2022,10,Sant Martí,65,el Clot,10234,1782,978,804
2022,10,Sant Martí,66,el Parc i la Llacuna del Poblenou,10042,3204,1669,1535
2022,10,Sant Martí,66,el Parc i la Llacuna del Poblenou,10043,2427,1241,1186
2022,10,Sant Martí,66,el Parc i la Llacuna del Poblenou,10044,1559,823,736
2022,10,Sant Martí,66,el Parc i la Llacuna del Poblenou,10045,1300,676,624
2022,10,Sant Martí,66,el Parc i la Llacuna del Poblenou,10046,1244,670,574
2022,10,Sant Martí,66,el Parc i la Llacuna del Poblenou,10047,1721,889,832
2022,10,Sant Martí,66,el Parc i la Llacuna del Poblenou,10048,1653,824,829
2022,10,Sant Martí,66,el Parc i la Llacuna del Poblenou,10049,1297,637,660
2022,10,Sant Martí,66,el Parc i la Llacuna del Poblenou,10050,1556,816,740
2022,10,Sant Martí,67,la Vila Olímpica del Poblenou,10051,1625,820,805
2022,10,Sant Martí,67,la Vila Olímpica del Poblenou,10052,2429,1215,1214
2022,10,Sant Martí,67,la Vila Olímpica del Poblenou,10053,1719,871,848
2022,10,Sant Martí,67,la Vila Olímpica del Poblenou,10054,965,510,455
2022,10,Sant Martí,67,la Vila Olímpica del Poblenou,10055,2638,1322,1316
2022,10,Sant Martí,68,el Poblenou,10056,1824,905,919
2022,10,Sant Martí,68,el Poblenou,10057,1419,718,701
2022,10,Sant Martí,68,el Poblenou,10058,1143,577,566
2022,10,Sant Martí,68,el Poblenou,10059,1793,930,863
2022,10,Sant Martí,68,el Poblenou,10060,1676,838,838
2022,10,Sant Martí,68,el Poblenou,10061,1738,912,826
2022,10,Sant Martí,68,el Poblenou,10062,1503,778,725
2022,10,Sant Martí,68,el Poblenou,10063,1188,599,589
2022,10,Sant Martí,68,el Poblenou,10064,1658,877,781
2022,10,Sant Martí,68,el Poblenou,10065,1548,795,753
2022,10,Sant Martí,68,el Poblenou,10066,2091,1072,1019
2022,10,Sant Martí,68,el Poblenou,10067,1944,1016,928
2022,10,Sant Martí,68,el Poblenou,10068,1639,841,798
2022,10,Sant Martí,68,el Poblenou,10069,2796,1463,1333
2022,10,Sant Martí,68,el Poblenou,10070,1650,880,770
2022,10,Sant Martí,68,el Poblenou,10071,1802,924,878
2022,10,Sant Martí,68,el Poblenou,10072,2056,1028,1028
2022,10,Sant Martí,68,el Poblenou,10073,1440,741,699
2022,10,Sant Martí,68,el Poblenou,10074,1663,848,815
2022,10,Sant Martí,68,el Poblenou,10075,1532,784,748
2022,10,Sant Martí,69,Diagonal Mar i el Front Marítim del Poblenou,10076,2259,1162,1097
2022,10,Sant Martí,69,Diagonal Mar i el Front Marítim del Poblenou,10077,1821,897,924
2022,10,Sant Martí,69,Diagonal Mar i el Front Marítim del Poblenou,10078,2415,1226,1189
2022,10,Sant Martí,69,Diagonal Mar i el Front Marítim del Poblenou,10079,1742,894,848
2022,10,Sant Martí,69,Diagonal Mar i el Front Marítim del Poblenou,10080,2275,1159,1116
2022,10,Sant Martí,69,Diagonal Mar i el Front Marítim del Poblenou,10235,1282,680,602
2022,10,Sant Martí,69,Diagonal Mar i el Front Marítim del Poblenou,10236,1597,847,750
2022,10,Sant Martí,70,el Besòs i el Maresme,10081,2166,1071,1095
2022,10,Sant Martí,70,el Besòs i el Maresme,10082,1944,943,1001
2022,10,Sant Martí,70,el Besòs i el Maresme,10083,2212,994,1218
2022,10,Sant Martí,70,el Besòs i el Maresme,10084,1663,811,852
2022,10,Sant Martí,70,el Besòs i el Maresme,10085,2094,1012,1082
2022,10,Sant Martí,70,el Besòs i el Maresme,10086,1949,969,980
2022,10,Sant Martí,70,el Besòs i el Maresme,10087,1818,914,904
2022,10,Sant Martí,70,el Besòs i el Maresme,10088,1659,839,820
2022,10,Sant Martí,70,el Besòs i el Maresme,10089,4834,1814,3020
2022,10,Sant Martí,70,el Besòs i el Maresme,10090,1477,758,719
2022,10,Sant Martí,70,el Besòs i el Maresme,10091,1970,992,978
2022,10,Sant Martí,70,el Besòs i el Maresme,10092,1470,784,686
2022,10,Sant Martí,70,el Besòs i el Maresme,10093,1093,559,534
2022,10,Sant Martí,71,Provençals del Poblenou,10094,3060,1520,1540
2022,10,Sant Martí,71,Provençals del Poblenou,10095,1326,671,655
2022,10,Sant Martí,71,Provençals del Poblenou,10096,1669,899,770
2022,10,Sant Martí,71,Provençals del Poblenou,10097,1554,828,726
2022,10,Sant Martí,71,Provençals del Poblenou,10098,1752,919,833
2022,10,Sant Martí,71,Provençals del Poblenou,10099,1118,592,526
2022,10,Sant Martí,71,Provençals del Poblenou,10100,1670,896,774
2022,10,Sant Martí,71,Provençals del Poblenou,10101,1709,849,860
2022,10,Sant Martí,71,Provençals del Poblenou,10102,2612,1369,1243
2022,10,Sant Martí,71,Provençals del Poblenou,10103,2146,1129,1017
2022,10,Sant Martí,71,Provençals del Poblenou,10104,1564,823,741
2022,10,Sant Martí,71,Provençals del Poblenou,10237,912,515,397
2022,10,Sant Martí,72,Sant Martí de Provençals,10105,2164,1166,998
2022,10,Sant Martí,72,Sant Martí de Provençals,10106,1006,544,462
2022,10,Sant Martí,72,Sant Martí de Provençals,10107,1479,772,707
2022,10,Sant Martí,72,Sant Martí de Provençals,10108,1281,683,598
2022,10,Sant Martí,72,Sant Martí de Provençals,10109,1649,872,777
2022,10,Sant Martí,72,Sant Martí de Provençals,10110,1660,918,742
2022,10,Sant Martí,72,Sant Martí de Provençals,10111,1306,683,623
2022,10,Sant Martí,72,Sant Martí de Provençals,10112,1501,779,722
2022,10,Sant Martí,72,Sant Martí de Provençals,10113,1186,611,575
2022,10,Sant Martí,72,Sant Martí de Provençals,10114,1513,778,735
2022,10,Sant Martí,72,Sant Martí de Provençals,10115,1436,757,679
2022,10,Sant Martí,72,Sant Martí de Provençals,10116,1779,968,811
2022,10,Sant Martí,72,Sant Martí de Provençals,10117,1244,658,586
2022,10,Sant Martí,72,Sant Martí de Provençals,10118,987,517,470
2022,10,Sant Martí,72,Sant Martí de Provençals,10119,1136,607,529
2022,10,Sant Martí,72,Sant Martí de Provençals,10120,1433,788,645
2022,10,Sant Martí,72,Sant Martí de Provençals,10121,1610,845,765
2022,10,Sant Martí,72,Sant Martí de Provençals,10122,1482,782,700
2022,10,Sant Martí,73,la Verneda i la Pau,10123,1344,688,656
2022,10,Sant Martí,73,la Verneda i la Pau,10124,1092,571,521
2022,10,Sant Martí,73,la Verneda i la Pau,10125,1099,575,524
2022,10,Sant Martí,73,la Verneda i la Pau,10126,1005,526,479
2022,10,Sant Martí,73,la Verneda i la Pau,10127,1036,528,508
2022,10,Sant Martí,73,la Verneda i la Pau,10128,1550,834,716
2022,10,Sant Martí,73,la Verneda i la Pau,10129,1134,593,541
2022,10,Sant Martí,73,la Verneda i la Pau,10130,1214,629,585
2022,10,Sant Martí,73,la Verneda i la Pau,10131,1095,584,511
2022,10,Sant Martí,73,la Verneda i la Pau,10132,1264,663,601
2022,10,Sant Martí,73,la Verneda i la Pau,10133,1704,898,806
2022,10,Sant Martí,73,la Verneda i la Pau,10134,1570,865,705
2022,10,Sant Martí,73,la Verneda i la Pau,10135,1233,642,591
2022,10,Sant Martí,73,la Verneda i la Pau,10136,1384,737,647
2022,10,Sant Martí,73,la Verneda i la Pau,10137,1567,827,740
2022,10,Sant Martí,73,la Verneda i la Pau,10138,1595,835,760
2022,10,Sant Martí,73,la Verneda i la Pau,10139,1682,879,803
2022,10,Sant Martí,73,la Verneda i la Pau,10140,1633,840,793
2022,10,Sant Martí,73,la Verneda i la Pau,10141,1126,589,537
2022,10,Sant Martí,73,la Verneda i la Pau,10142,1622,830,792
2022,10,Sant Martí,73,la Verneda i la Pau,10143,1805,955,850
2023,1,Ciutat Vella,1,el Raval,1001,1246,606,640
2023,1,Ciutat Vella,1,el Raval,1002,1238,588,650
2023,1,Ciutat Vella,1,el Raval,1003,3406,1555,1851
2023,1,Ciutat Vella,1,el Raval,1004,2881,1334,1547
2023,1,Ciutat Vella,1,el Raval,1005,2294,1084,1210
2023,1,Ciutat Vella,1,el Raval,1006,1579,733,846
2023,1,Ciutat Vella,1,el Raval,1007,1911,795,1116
2023,1,Ciutat Vella,1,el Raval,1008,3092,1326,1766
2023,1,Ciutat Vella,1,el Raval,1009,2134,990,1144
2023,1,Ciutat Vella,1,el Raval,1010,2297,1047,1250
2023,1,Ciutat Vella,1,el Raval,1011,3053,1411,1642
2023,1,Ciutat Vella,1,el Raval,1012,1875,937,938
2023,1,Ciutat Vella,1,el Raval,1013,1453,723,730
2023,1,Ciutat Vella,1,el Raval,1014,1834,846,988
2023,1,Ciutat Vella,1,el Raval,1015,2279,1147,1132
2023,1,Ciutat Vella,1,el Raval,1016,2033,1036,997
2023,1,Ciutat Vella,1,el Raval,1017,2498,1234,1264
2023,1,Ciutat Vella,1,el Raval,1018,1524,753,771
2023,1,Ciutat Vella,1,el Raval,1019,2669,1247,1422
2023,1,Ciutat Vella,1,el Raval,1020,2233,1159,1074
2023,1,Ciutat Vella,1,el Raval,1021,2142,1078,1064
2023,1,Ciutat Vella,2,el Barri Gòtic,1022,1772,747,1025
2023,1,Ciutat Vella,2,el Barri Gòtic,1023,1966,1000,966
2023,1,Ciutat Vella,2,el Barri Gòtic,1025,1314,642,672
2023,1,Ciutat Vella,2,el Barri Gòtic,1026,10671,2552,8119
2023,1,Ciutat Vella,2,el Barri Gòtic,1027,1441,751,690
2023,1,Ciutat Vella,2,el Barri Gòtic,1028,1903,969,934
2023,1,Ciutat Vella,2,el Barri Gòtic,1029,1385,711,674
2023,1,Ciutat Vella,2,el Barri Gòtic,1030,2449,1172,1277
2023,1,Ciutat Vella,2,el Barri Gòtic,1031,1559,732,827
2023,1,Ciutat Vella,3,la Barceloneta,1032,1722,851,871
2023,1,Ciutat Vella,3,la Barceloneta,1033,1050,486,564
2023,1,Ciutat Vella,3,la Barceloneta,1034,935,456,479
2023,1,Ciutat Vella,3,la Barceloneta,1035,1155,587,568
2023,1,Ciutat Vella,3,la Barceloneta,1036,1156,614,542
2023,1,Ciutat Vella,3,la Barceloneta,1037,1276,671,605
2023,1,Ciutat Vella,3,la Barceloneta,1038,1408,700,708
2023,1,Ciutat Vella,3,la Barceloneta,1039,1315,664,651
2023,1,Ciutat Vella,3,la Barceloneta,1040,1081,548,533
2023,1,Ciutat Vella,3,la Barceloneta,1041,1435,744,691
2023,1,Ciutat Vella,3,la Barceloneta,1042,1741,911,830
2023,1,Ciutat Vella,4,"Sant Pere, Santa Caterina i la Ribera",1043,1611,785,826
2023,1,Ciutat Vella,4,"Sant Pere, Santa Caterina i la Ribera",1044,1452,757,695
2023,1,Ciutat Vella,4,"Sant Pere, Santa Caterina i la Ribera",1045,1914,950,964
2023,1,Ciutat Vella,4,"Sant Pere, Santa Caterina i la Ribera",1046,1797,879,918
2023,1,Ciutat Vella,4,"Sant Pere, Santa Caterina i la Ribera",1047,1719,886,833
2023,1,Ciutat Vella,4,"Sant Pere, Santa Caterina i la Ribera",1048,2066,1038,1028
2023,1,Ciutat Vella,4,"Sant Pere, Santa Caterina i la Ribera",1049,1480,776,704
2023,1,Ciutat Vella,4,"Sant Pere, Santa Caterina i la Ribera",1050,1581,784,797
2023,1,Ciutat Vella,4,"Sant Pere, Santa Caterina i la Ribera",1051,1675,829,846
2023,1,Ciutat Vella,4,"Sant Pere, Santa Caterina i la Ribera",1052,2367,1223,1144
2023,1,Ciutat Vella,4,"Sant Pere, Santa Caterina i la Ribera",1053,1834,970,864
2023,1,Ciutat Vella,4,"Sant Pere, Santa Caterina i la Ribera",1054,1264,630,634
2023,1,Ciutat Vella,4,"Sant Pere, Santa Caterina i la Ribera",1055,1281,666,615
2023,2,Eixample,5,el Fort Pienc,2001,1341,717,624
2023,2,Eixample,5,el Fort Pienc,2002,4738,2206,2532
2023,2,Eixample,5,el Fort Pienc,2003,1145,637,508
2023,2,Eixample,5,el Fort Pienc,2004,1526,778,748
2023,2,Eixample,5,el Fort Pienc,2005,1990,1067,923
2023,2,Eixample,5,el Fort Pienc,2006,1621,871,750
2023,2,Eixample,5,el Fort Pienc,2007,1211,652,559
2023,2,Eixample,5,el Fort Pienc,2008,1903,992,911
2023,2,Eixample,5,el Fort Pienc,2009,1780,937,843
2023,2,Eixample,5,el Fort Pienc,2010,1214,635,579
2023,2,Eixample,5,el Fort Pienc,2011,1115,572,543
2023,2,Eixample,5,el Fort Pienc,2012,1586,816,770
2023,2,Eixample,5,el Fort Pienc,2013,1151,580,571
2023,2,Eixample,5,el Fort Pienc,2014,1364,704,660
2023,2,Eixample,5,el Fort Pienc,2015,1564,815,749
2023,2,Eixample,5,el Fort Pienc,2016,1843,981,862
2023,2,Eixample,5,el Fort Pienc,2017,1941,1046,895
2023,2,Eixample,5,el Fort Pienc,2018,1819,989,830
2023,2,Eixample,5,el Fort Pienc,2019,1983,1055,928
2023,2,Eixample,5,el Fort Pienc,2020,1568,830,738
2023,2,Eixample,6,la Sagrada Família,2021,1526,807,719
2023,2,Eixample,6,la Sagrada Família,2022,1294,664,630
2023,2,Eixample,6,la Sagrada Família,2023,1046,582,464
2023,2,Eixample,6,la Sagrada Família,2024,1147,626,521
2023,2,Eixample,6,la Sagrada Família,2025,1128,600,528
2023,2,Eixample,6,la Sagrada Família,2026,2054,1124,930
2023,2,Eixample,6,la Sagrada Família,2027,2072,1100,972
2023,2,Eixample,6,la Sagrada Família,2028,2036,1111,925
2023,2,Eixample,6,la Sagrada Família,2029,1217,660,557
2023,2,Eixample,6,la Sagrada Família,2030,1367,726,641
2023,2,Eixample,6,la Sagrada Família,2031,1029,565,464
2023,2,Eixample,6,la Sagrada Família,2032,1196,684,512
2023,2,Eixample,6,la Sagrada Família,2033,1156,623,533
2023,2,Eixample,6,la Sagrada Família,2034,1198,678,520
2023,2,Eixample,6,la Sagrada Família,2035,1270,703,567
2023,2,Eixample,6,la Sagrada Família,2036,1202,658,544
2023,2,Eixample,6,la Sagrada Família,2037,1138,596,542
2023,2,Eixample,6,la Sagrada Família,2038,1522,807,715
2023,2,Eixample,6,la Sagrada Família,2039,1769,997,772
2023,2,Eixample,6,la Sagrada Família,2040,1763,927,836
2023,2,Eixample,6,la Sagrada Família,2041,1663,934,729
2023,2,Eixample,6,la Sagrada Família,2042,1662,902,760
2023,2,Eixample,6,la Sagrada Família,2043,1489,781,708
2023,2,Eixample,6,la Sagrada Família,2044,1287,706,581
2023,2,Eixample,6,la Sagrada Família,2045,1152,622,530
2023,2,Eixample,6,la Sagrada Família,2046,1966,1061,905
2023,2,Eixample,6,la Sagrada Família,2047,1955,1065,890
2023,2,Eixample,6,la Sagrada Família,2048,1284,703,581
2023,2,Eixample,6,la Sagrada Família,2049,2023,1100,923
2023,2,Eixample,6,la Sagrada Família,2050,1637,903,734
2023,2,Eixample,6,la Sagrada Família,2051,1874,1008,866
2023,2,Eixample,6,la Sagrada Família,2052,1789,969,820
2023,2,Eixample,6,la Sagrada Família,2053,1898,1004,894
2023,2,Eixample,6,la Sagrada Família,2054,1903,1019,884
2023,2,Eixample,7,la Dreta de l'Eixample,2055,1828,993,835
2023,2,Eixample,7,la Dreta de l'Eixample,2056,1528,843,685
2023,2,Eixample,7,la Dreta de l'Eixample,2057,1260,663,597
2023,2,Eixample,7,la Dreta de l'Eixample,2058,1411,745,666
2023,2,Eixample,7,la Dreta de l'Eixample,2059,1720,933,787
2023,2,Eixample,7,la Dreta de l'Eixample,2060,1624,908,716
2023,2,Eixample,7,la Dreta de l'Eixample,2061,1354,751,603
2023,2,Eixample,7,la Dreta de l'Eixample,2062,1543,804,739
2023,2,Eixample,7,la Dreta de l'Eixample,2063,1160,692,468
2023,2,Eixample,7,la Dreta de l'Eixample,2064,1303,698,605
2023,2,Eixample,7,la Dreta de l'Eixample,2065,1839,987,852
2023,2,Eixample,7,la Dreta de l'Eixample,2066,1738,949,789
2023,2,Eixample,7,la Dreta de l'Eixample,2067,1664,902,762
2023,2,Eixample,7,la Dreta de l'Eixample,2068,1647,880,767
2023,2,Eixample,7,la Dreta de l'Eixample,2069,1356,745,611
2023,2,Eixample,7,la Dreta de l'Eixample,2070,1252,687,565
2023,2,Eixample,7,la Dreta de l'Eixample,2071,1633,841,792
2023,2,Eixample,7,la Dreta de l'Eixample,2072,1229,623,606
2023,2,Eixample,7,la Dreta de l'Eixample,2073,1665,868,797
2023,2,Eixample,7,la Dreta de l'Eixample,2074,1270,621,649
2023,2,Eixample,7,la Dreta de l'Eixample,2075,1223,623,600
2023,2,Eixample,7,la Dreta de l'Eixample,2076,1645,854,791
2023,2,Eixample,7,la Dreta de l'Eixample,2077,1776,884,892
2023,2,Eixample,7,la Dreta de l'Eixample,2078,1419,758,661
2023,2,Eixample,7,la Dreta de l'Eixample,2079,1432,720,712
2023,2,Eixample,7,la Dreta de l'Eixample,2080,1606,830,776
2023,2,Eixample,7,la Dreta de l'Eixample,2081,2137,1153,984
2023,2,Eixample,7,la Dreta de l'Eixample,2082,923,504,419
2023,2,Eixample,7,la Dreta de l'Eixample,2083,1920,1036,884
2023,2,Eixample,8,l'Antiga Esquerra de l'Eixample,2084,2051,1140,911
2023,2,Eixample,8,l'Antiga Esquerra de l'Eixample,2085,1444,817,627
2023,2,Eixample,8,l'Antiga Esquerra de l'Eixample,2086,1393,778,615
2023,2,Eixample,8,l'Antiga Esquerra de l'Eixample,2087,1396,783,613
2023,2,Eixample,8,l'Antiga Esquerra de l'Eixample,2088,1693,895,798
2023,2,Eixample,8,l'Antiga Esquerra de l'Eixample,2089,1808,949,859
2023,2,Eixample,8,l'Antiga Esquerra de l'Eixample,2090,1694,895,799
2023,2,Eixample,8,l'Antiga Esquerra de l'Eixample,2091,2630,1076,1554
2023,2,Eixample,8,l'Antiga Esquerra de l'Eixample,2092,1723,871,852
2023,2,Eixample,8,l'Antiga Esquerra de l'Eixample,2093,1691,875,816
2023,2,Eixample,8,l'Antiga Esquerra de l'Eixample,2094,1500,790,710
2023,2,Eixample,8,l'Antiga Esquerra de l'Eixample,2095,1546,786,760
2023,2,Eixample,8,l'Antiga Esquerra de l'Eixample,2096,1444,760,684
2023,2,Eixample,8,l'Antiga Esquerra de l'Eixample,2097,1111,589,522
2023,2,Eixample,8,l'Antiga Esquerra de l'Eixample,2098,1438,751,687
2023,2,Eixample,8,l'Antiga Esquerra de l'Eixample,2099,1595,833,762
2023,2,Eixample,8,l'Antiga Esquerra de l'Eixample,2100,1307,696,611
2023,2,Eixample,8,l'Antiga Esquerra de l'Eixample,2101,2214,1200,1014
2023,2,Eixample,8,l'Antiga Esquerra de l'Eixample,2102,1359,755,604
2023,2,Eixample,8,l'Antiga Esquerra de l'Eixample,2103,1667,899,768
2023,2,Eixample,8,l'Antiga Esquerra de l'Eixample,2104,1175,644,531
2023,2,Eixample,8,l'Antiga Esquerra de l'Eixample,2105,2081,1146,935
2023,2,Eixample,8,l'Antiga Esquerra de l'Eixample,2106,1434,785,649
2023,2,Eixample,8,l'Antiga Esquerra de l'Eixample,2107,1646,888,758
2023,2,Eixample,8,l'Antiga Esquerra de l'Eixample,2108,1587,871,716
2023,2,Eixample,8,l'Antiga Esquerra de l'Eixample,2109,2124,1169,955
2023,2,Eixample,9,la Nova Esquerra de l'Eixample,2110,1841,992,849
2023,2,Eixample,9,la Nova Esquerra de l'Eixample,2111,1878,1013,865
2023,2,Eixample,9,la Nova Esquerra de l'Eixample,2112,1306,707,599
2023,2,Eixample,9,la Nova Esquerra de l'Eixample,2113,2210,1155,1055
2023,2,Eixample,9,la Nova Esquerra de l'Eixample,2114,1707,922,785
2023,2,Eixample,9,la Nova Esquerra de l'Eixample,2115,1371,746,625
2023,2,Eixample,9,la Nova Esquerra de l'Eixample,2116,973,524,449
2023,2,Eixample,9,la Nova Esquerra de l'Eixample,2117,1233,679,554
2023,2,Eixample,9,la Nova Esquerra de l'Eixample,2118,1427,774,653
2023,2,Eixample,9,la Nova Esquerra de l'Eixample,2119,1276,660,616
2023,2,Eixample,9,la Nova Esquerra de l'Eixample,2120,1157,600,557
2023,2,Eixample,9,la Nova Esquerra de l'Eixample,2121,1254,665,589
2023,2,Eixample,9,la Nova Esquerra de l'Eixample,2122,1039,571,468
2023,2,Eixample,9,la Nova Esquerra de l'Eixample,2123,1102,580,522
2023,2,Eixample,9,la Nova Esquerra de l'Eixample,2124,1129,617,512
2023,2,Eixample,9,la Nova Esquerra de l'Eixample,2125,1652,911,741
2023,2,Eixample,9,la Nova Esquerra de l'Eixample,2126,1408,765,643
2023,2,Eixample,9,la Nova Esquerra de l'Eixample,2127,1200,648,552
2023,2,Eixample,9,la Nova Esquerra de l'Eixample,2128,1312,708,604
2023,2,Eixample,9,la Nova Esquerra de l'Eixample,2129,1545,835,710
2023,2,Eixample,9,la Nova Esquerra de l'Eixample,2130,1101,585,516
2023,2,Eixample,9,la Nova Esquerra de l'Eixample,2131,1124,608,516
2023,2,Eixample,9,la Nova Esquerra de l'Eixample,2132,1003,508,495
2023,2,Eixample,9,la Nova Esquerra de l'Eixample,2133,841,469,372
2023,2,Eixample,9,la Nova Esquerra de l'Eixample,2134,1469,763,706
2023,2,Eixample,9,la Nova Esquerra de l'Eixample,2135,2086,1116,970
2023,2,Eixample,9,la Nova Esquerra de l'Eixample,2136,890,480,410
2023,2,Eixample,9,la Nova Esquerra de l'Eixample,2137,1468,783,685
2023,2,Eixample,9,la Nova Esquerra de l'Eixample,2138,1925,1023,902
2023,2,Eixample,9,la Nova Esquerra de l'Eixample,2139,1660,874,786
2023,2,Eixample,9,la Nova Esquerra de l'Eixample,2140,1908,1014,894
2023,2,Eixample,9,la Nova Esquerra de l'Eixample,2141,1198,648,550
2023,2,Eixample,9,la Nova Esquerra de l'Eixample,2142,1980,1015,965
2023,2,Eixample,9,la Nova Esquerra de l'Eixample,2143,1505,751,754
2023,2,Eixample,9,la Nova Esquerra de l'Eixample,2144,1478,775,703
2023,2,Eixample,9,la Nova Esquerra de l'Eixample,2145,1214,609,605
2023,2,Eixample,9,la Nova Esquerra de l'Eixample,2146,1197,650,547
2023,2,Eixample,9,la Nova Esquerra de l'Eixample,2147,2133,1119,1014
2023,2,Eixample,9,la Nova Esquerra de l'Eixample,2148,1538,823,715
2023,2,Eixample,9,la Nova Esquerra de l'Eixample,2149,1846,950,896
2023,2,Eixample,10,Sant Antoni,2150,1567,804,763
2023,2,Eixample,10,Sant Antoni,2151,1487,789,698
2023,2,Eixample,10,Sant Antoni,2152,1258,671,587
2023,2,Eixample,10,Sant Antoni,2153,1365,738,627
2023,2,Eixample,10,Sant Antoni,2154,1037,562,475
2023,2,Eixample,10,Sant Antoni,2155,1841,990,851
2023,2,Eixample,10,Sant Antoni,2156,1280,671,609
2023,2,Eixample,10,Sant Antoni,2157,1244,660,584
2023,2,Eixample,10,Sant Antoni,2158,1647,857,790
2023,2,Eixample,10,Sant Antoni,2159,1945,1027,918
2023,2,Eixample,10,Sant Antoni,2160,1954,1000,954
2023,2,Eixample,10,Sant Antoni,2161,1159,592,567
2023,2,Eixample,10,Sant Antoni,2162,1402,733,669
2023,2,Eixample,10,Sant Antoni,2163,1758,918,840
2023,2,Eixample,10,Sant Antoni,2164,1525,769,756
2023,2,Eixample,10,Sant Antoni,2165,1675,863,812
2023,2,Eixample,10,Sant Antoni,2166,2110,1110,1000
2023,2,Eixample,10,Sant Antoni,2167,2146,1106,1040
2023,2,Eixample,10,Sant Antoni,2168,2223,1194,1029
2023,2,Eixample,10,Sant Antoni,2169,1492,768,724
2023,2,Eixample,10,Sant Antoni,2170,1553,819,734
2023,2,Eixample,10,Sant Antoni,2171,1606,826,780
2023,2,Eixample,10,Sant Antoni,2172,1493,792,701
2023,2,Eixample,10,Sant Antoni,2173,1502,785,717
2023,3,Sants-Montjuïc,11,el Poble-sec,3001,1705,901,804
2023,3,Sants-Montjuïc,11,el Poble-sec,3002,1902,964,938
2023,3,Sants-Montjuïc,11,el Poble-sec,3003,1659,848,811
2023,3,Sants-Montjuïc,11,el Poble-sec,3004,1513,806,707
2023,3,Sants-Montjuïc,11,el Poble-sec,3005,1199,608,591
2023,3,Sants-Montjuïc,11,el Poble-sec,3006,1375,679,696
2023,3,Sants-Montjuïc,11,el Poble-sec,3007,1642,853,789
2023,3,Sants-Montjuïc,11,el Poble-sec,3008,1168,603,565
2023,3,Sants-Montjuïc,11,el Poble-sec,3009,1167,607,560
2023,3,Sants-Montjuïc,11,el Poble-sec,3010,1886,914,972
2023,3,Sants-Montjuïc,11,el Poble-sec,3011,1762,872,890
2023,3,Sants-Montjuïc,11,el Poble-sec,3012,2026,1049,977
2023,3,Sants-Montjuïc,11,el Poble-sec,3013,1734,850,884
2023,3,Sants-Montjuïc,11,el Poble-sec,3014,1758,865,893
2023,3,Sants-Montjuïc,11,el Poble-sec,3015,2901,1485,1416
2023,3,Sants-Montjuïc,11,el Poble-sec,3016,1221,634,587
2023,3,Sants-Montjuïc,11,el Poble-sec,3017,1587,792,795
2023,3,Sants-Montjuïc,11,el Poble-sec,3018,1669,811,858
2023,3,Sants-Montjuïc,11,el Poble-sec,3019,1476,765,711
2023,3,Sants-Montjuïc,11,el Poble-sec,3020,1206,585,621
2023,3,Sants-Montjuïc,11,el Poble-sec,3021,1057,546,511
2023,3,Sants-Montjuïc,11,el Poble-sec,3022,1380,698,682
2023,3,Sants-Montjuïc,11,el Poble-sec,3023,1807,927,880
2023,3,Sants-Montjuïc,11,el Poble-sec,3024,1978,987,991
2023,3,Sants-Montjuïc,12,la Marina del Prat Vermell,3025,1678,831,847
2023,3,Sants-Montjuïc,13,la Marina de Port,3026,997,519,478
2023,3,Sants-Montjuïc,13,la Marina de Port,3027,1745,909,836
2023,3,Sants-Montjuïc,13,la Marina de Port,3028,2594,1340,1254
2023,3,Sants-Montjuïc,13,la Marina de Port,3029,1260,654,606
2023,3,Sants-Montjuïc,13,la Marina de Port,3030,1560,842,718
2023,3,Sants-Montjuïc,13,la Marina de Port,3031,2322,1189,1133
2023,3,Sants-Montjuïc,13,la Marina de Port,3032,1719,894,825
2023,3,Sants-Montjuïc,13,la Marina de Port,3033,1458,743,715
2023,3,Sants-Montjuïc,13,la Marina de Port,3034,1495,782,713
2023,3,Sants-Montjuïc,13,la Marina de Port,3035,2284,1185,1099
2023,3,Sants-Montjuïc,13,la Marina de Port,3036,2377,1260,1117
2023,3,Sants-Montjuïc,13,la Marina de Port,3037,980,507,473
2023,3,Sants-Montjuïc,13,la Marina de Port,3038,949,490,459
2023,3,Sants-Montjuïc,13,la Marina de Port,3039,2456,1269,1187
2023,3,Sants-Montjuïc,13,la Marina de Port,3211,1517,789,728
2023,3,Sants-Montjuïc,13,la Marina de Port,3212,2414,1284,1130
2023,3,Sants-Montjuïc,13,la Marina de Port,3213,2310,1189,1121
2023,3,Sants-Montjuïc,14,la Font de la Guatlla,3040,1809,784,1025
2023,3,Sants-Montjuïc,14,la Font de la Guatlla,3041,1424,737,687
2023,3,Sants-Montjuïc,14,la Font de la Guatlla,3042,1348,671,677
2023,3,Sants-Montjuïc,14,la Font de la Guatlla,3043,1525,814,711
2023,3,Sants-Montjuïc,14,la Font de la Guatlla,3044,1855,958,897
2023,3,Sants-Montjuïc,14,la Font de la Guatlla,3045,1096,549,547
2023,3,Sants-Montjuïc,14,la Font de la Guatlla,3046,1442,773,669
2023,3,Sants-Montjuïc,15,Hostafrancs,3047,1770,918,852
2023,3,Sants-Montjuïc,15,Hostafrancs,3048,1334,714,620
2023,3,Sants-Montjuïc,15,Hostafrancs,3049,1673,892,781
2023,3,Sants-Montjuïc,15,Hostafrancs,3050,1630,824,806
2023,3,Sants-Montjuïc,15,Hostafrancs,3051,1836,931,905
2023,3,Sants-Montjuïc,15,Hostafrancs,3052,1393,750,643
2023,3,Sants-Montjuïc,15,Hostafrancs,3053,2190,1159,1031
2023,3,Sants-Montjuïc,15,Hostafrancs,3054,1636,844,792
2023,3,Sants-Montjuïc,15,Hostafrancs,3055,1574,825,749
2023,3,Sants-Montjuïc,15,Hostafrancs,3056,933,496,437
2023,3,Sants-Montjuïc,16,la Bordeta,3057,1482,772,710
2023,3,Sants-Montjuïc,16,la Bordeta,3058,1794,958,836
2023,3,Sants-Montjuïc,16,la Bordeta,3059,1148,599,549
2023,3,Sants-Montjuïc,16,la Bordeta,3060,1356,691,665
2023,3,Sants-Montjuïc,16,la Bordeta,3061,1118,598,520
2023,3,Sants-Montjuïc,16,la Bordeta,3062,1599,861,738
2023,3,Sants-Montjuïc,16,la Bordeta,3063,2000,1029,971
2023,3,Sants-Montjuïc,16,la Bordeta,3064,1481,783,698
2023,3,Sants-Montjuïc,16,la Bordeta,3065,1318,690,628
2023,3,Sants-Montjuïc,16,la Bordeta,3066,2320,1204,1116
2023,3,Sants-Montjuïc,16,la Bordeta,3067,1729,935,794
2023,3,Sants-Montjuïc,16,la Bordeta,3068,1169,629,540
2023,3,Sants-Montjuïc,16,la Bordeta,3069,1214,618,596
2023,3,Sants-Montjuïc,17,Sants - Badal,3070,1273,665,608
2023,3,Sants-Montjuïc,17,Sants - Badal,3071,1347,718,629
2023,3,Sants-Montjuïc,17,Sants - Badal,3072,1352,717,635
2023,3,Sants-Montjuïc,17,Sants - Badal,3073,1564,816,748
2023,3,Sants-Montjuïc,17,Sants - Badal,3074,1787,965,822
2023,3,Sants-Montjuïc,17,Sants - Badal,3075,1763,918,845
2023,3,Sants-Montjuïc,17,Sants - Badal,3076,1055,562,493
2023,3,Sants-Montjuïc,17,Sants - Badal,3077,1367,749,618
2023,3,Sants-Montjuïc,17,Sants - Badal,3078,1745,916,829
2023,3,Sants-Montjuïc,17,Sants - Badal,3079,1791,959,832
2023,3,Sants-Montjuïc,17,Sants - Badal,3080,1514,815,699
2023,3,Sants-Montjuïc,17,Sants - Badal,3081,1906,1029,877
2023,3,Sants-Montjuïc,17,Sants - Badal,3082,1860,1004,856
2023,3,Sants-Montjuïc,17,Sants - Badal,3083,1365,721,644
2023,3,Sants-Montjuïc,17,Sants - Badal,3084,1386,761,625
2023,3,Sants-Montjuïc,17,Sants - Badal,3085,1291,697,594
2023,3,Sants-Montjuïc,18,Sants,3086,1237,645,592
2023,3,Sants-Montjuïc,18,Sants,3087,1461,780,681
2023,3,Sants-Montjuïc,18,Sants,3088,1361,726,635
2023,3,Sants-Montjuïc,18,Sants,3089,1226,669,557
2023,3,Sants-Montjuïc,18,Sants,3090,974,525,449
2023,3,Sants-Montjuïc,18,Sants,3091,1474,761,713
2023,3,Sants-Montjuïc,18,Sants,3092,1214,637,577
2023,3,Sants-Montjuïc,18,Sants,3093,1472,803,669
2023,3,Sants-Montjuïc,18,Sants,3094,1203,644,559
2023,3,Sants-Montjuïc,18,Sants,3095,1564,811,753
2023,3,Sants-Montjuïc,18,Sants,3096,1583,855,728
2023,3,Sants-Montjuïc,18,Sants,3097,1584,861,723
2023,3,Sants-Montjuïc,18,Sants,3098,1430,719,711
2023,3,Sants-Montjuïc,18,Sants,3099,981,545,436
2023,3,Sants-Montjuïc,18,Sants,3100,1260,700,560
2023,3,Sants-Montjuïc,18,Sants,3101,5661,2425,3236
2023,3,Sants-Montjuïc,18,Sants,3102,1339,699,640
2023,3,Sants-Montjuïc,18,Sants,3103,1124,618,506
2023,3,Sants-Montjuïc,18,Sants,3104,1451,767,684
2023,3,Sants-Montjuïc,18,Sants,3105,1195,637,558
2023,3,Sants-Montjuïc,18,Sants,3106,1277,675,602
2023,3,Sants-Montjuïc,18,Sants,3107,1686,846,840
2023,3,Sants-Montjuïc,18,Sants,3108,1579,835,744
2023,3,Sants-Montjuïc,18,Sants,3109,1516,790,726
2023,3,Sants-Montjuïc,18,Sants,3110,1458,788,670
2023,3,Sants-Montjuïc,18,Sants,3111,1295,709,586
2023,3,Sants-Montjuïc,18,Sants,3112,1873,1013,860
2023,3,Sants-Montjuïc,18,Sants,3113,1549,816,733
2023,3,Sants-Montjuïc,18,Sants,3114,1481,800,681
2023,4,Les Corts,19,les Corts,4001,1258,643,615
2023,4,Les Corts,19,les Corts,4002,1899,989,910
2023,4,Les Corts,19,les Corts,4003,1045,537,508
2023,4,Les Corts,19,les Corts,4004,1025,523,502
2023,4,Les Corts,19,les Corts,4005,1209,641,568
2023,4,Les Corts,19,les Corts,4006,1129,611,518
2023,4,Les Corts,19,les Corts,4007,1014,570,444
2023,4,Les Corts,19,les Corts,4008,993,539,454
2023,4,Les Corts,19,les Corts,4009,1460,786,674
2023,4,Les Corts,19,les Corts,4010,897,492,405
2023,4,Les Corts,19,les Corts,4011,1721,930,791
2023,4,Les Corts,19,les Corts,4012,1313,700,613
2023,4,Les Corts,19,les Corts,4013,1206,649,557
2023,4,Les Corts,19,les Corts,4014,782,426,356
2023,4,Les Corts,19,les Corts,4015,1860,1018,842
2023,4,Les Corts,19,les Corts,4016,1076,572,504
2023,4,Les Corts,19,les Corts,4017,1160,634,526
2023,4,Les Corts,19,les Corts,4018,1502,835,667
2023,4,Les Corts,19,les Corts,4019,1385,733,652
2023,4,Les Corts,19,les Corts,4020,1477,796,681
2023,4,Les Corts,19,les Corts,4021,1318,716,602
2023,4,Les Corts,19,les Corts,4022,1648,845,803
2023,4,Les Corts,19,les Corts,4023,1098,575,523
2023,4,Les Corts,19,les Corts,4024,1026,552,474
2023,4,Les Corts,19,les Corts,4025,1154,628,526
2023,4,Les Corts,19,les Corts,4026,1224,659,565
2023,4,Les Corts,19,les Corts,4027,1306,702,604
2023,4,Les Corts,19,les Corts,4028,1295,675,620
2023,4,Les Corts,19,les Corts,4029,1121,617,504
2023,4,Les Corts,19,les Corts,4030,1751,948,803
2023,4,Les Corts,19,les Corts,4031,2104,1075,1029
2023,4,Les Corts,19,les Corts,4032,1573,857,716
2023,4,Les Corts,19,les Corts,4033,1141,625,516
2023,4,Les Corts,19,les Corts,4034,1426,752,674
2023,4,Les Corts,19,les Corts,4035,1369,746,623
2023,4,Les Corts,20,la Maternitat i Sant Ramon,4036,1730,959,771
2023,4,Les Corts,20,la Maternitat i Sant Ramon,4037,2161,1186,975
2023,4,Les Corts,20,la Maternitat i Sant Ramon,4038,1256,686,570
2023,4,Les Corts,20,la Maternitat i Sant Ramon,4039,1171,636,535
2023,4,Les Corts,20,la Maternitat i Sant Ramon,4040,1627,828,799
2023,4,Les Corts,20,la Maternitat i Sant Ramon,4041,1317,693,624
2023,4,Les Corts,20,la Maternitat i Sant Ramon,4042,1819,979,840
2023,4,Les Corts,20,la Maternitat i Sant Ramon,4043,1606,868,738
2023,4,Les Corts,20,la Maternitat i Sant Ramon,4044,1623,839,784
2023,4,Les Corts,20,la Maternitat i Sant Ramon,4045,1401,744,657
2023,4,Les Corts,20,la Maternitat i Sant Ramon,4046,2365,1223,1142
2023,4,Les Corts,20,la Maternitat i Sant Ramon,4047,1916,1015,901
2023,4,Les Corts,20,la Maternitat i Sant Ramon,4048,1509,803,706
2023,4,Les Corts,20,la Maternitat i Sant Ramon,4049,1189,651,538
2023,4,Les Corts,20,la Maternitat i Sant Ramon,4084,1369,736,633
2023,4,Les Corts,21,Pedralbes,4050,2061,1084,977
2023,4,Les Corts,21,Pedralbes,4051,1678,927,751
2023,4,Les Corts,21,Pedralbes,4052,2176,1222,954
2023,4,Les Corts,21,Pedralbes,4053,1730,913,817
2023,4,Les Corts,21,Pedralbes,4054,1050,556,494
2023,4,Les Corts,21,Pedralbes,4055,1566,817,749
2023,4,Les Corts,21,Pedralbes,4056,1869,966,903
2023,5,Sarrià-Sant Gervasi,22,"Vallvidrera, el Tibidabo i les Planes",5001,1837,902,935
2023,5,Sarrià-Sant Gervasi,22,"Vallvidrera, el Tibidabo i les Planes",5002,1617,841,776
2023,5,Sarrià-Sant Gervasi,22,"Vallvidrera, el Tibidabo i les Planes",5003,1377,704,673
2023,5,Sarrià-Sant Gervasi,23,Sarrià,5004,1098,629,469
2023,5,Sarrià-Sant Gervasi,23,Sarrià,5005,1255,640,615
2023,5,Sarrià-Sant Gervasi,23,Sarrià,5006,1814,925,889
2023,5,Sarrià-Sant Gervasi,23,Sarrià,5007,1949,974,975
2023,5,Sarrià-Sant Gervasi,23,Sarrià,5008,1663,902,761
2023,5,Sarrià-Sant Gervasi,23,Sarrià,5009,1674,922,752
2023,5,Sarrià-Sant Gervasi,23,Sarrià,5010,1531,829,702
2023,5,Sarrià-Sant Gervasi,23,Sarrià,5011,1397,754,643
2023,5,Sarrià-Sant Gervasi,23,Sarrià,5012,1391,755,636
2023,5,Sarrià-Sant Gervasi,23,Sarrià,5013,1652,873,779
2023,5,Sarrià-Sant Gervasi,23,Sarrià,5014,1590,838,752
2023,5,Sarrià-Sant Gervasi,23,Sarrià,5015,1515,811,704
2023,5,Sarrià-Sant Gervasi,23,Sarrià,5016,1902,1053,849
2023,5,Sarrià-Sant Gervasi,23,Sarrià,5017,1502,807,695
2023,5,Sarrià-Sant Gervasi,23,Sarrià,5018,1276,693,583
2023,5,Sarrià-Sant Gervasi,23,Sarrià,5019,1649,919,730
2023,5,Sarrià-Sant Gervasi,24,les Tres Torres,5020,1098,604,494
2023,5,Sarrià-Sant Gervasi,24,les Tres Torres,5021,1259,673,586
2023,5,Sarrià-Sant Gervasi,24,les Tres Torres,5022,1712,956,756
2023,5,Sarrià-Sant Gervasi,24,les Tres Torres,5023,1498,837,661
2023,5,Sarrià-Sant Gervasi,24,les Tres Torres,5024,1903,1026,877
2023,5,Sarrià-Sant Gervasi,24,les Tres Torres,5025,1297,690,607
2023,5,Sarrià-Sant Gervasi,24,les Tres Torres,5026,1430,752,678
2023,5,Sarrià-Sant Gervasi,24,les Tres Torres,5027,1373,725,648
2023,5,Sarrià-Sant Gervasi,24,les Tres Torres,5028,1664,822,842
2023,5,Sarrià-Sant Gervasi,24,les Tres Torres,5029,1660,865,795
2023,5,Sarrià-Sant Gervasi,24,les Tres Torres,5030,1382,741,641
2023,5,Sarrià-Sant Gervasi,25,Sant Gervasi - la Bonanova,5031,1557,834,723
2023,5,Sarrià-Sant Gervasi,25,Sant Gervasi - la Bonanova,5032,1837,972,865
2023,5,Sarrià-Sant Gervasi,25,Sant Gervasi - la Bonanova,5033,1449,771,678
2023,5,Sarrià-Sant Gervasi,25,Sant Gervasi - la Bonanova,5034,1172,643,529
2023,5,Sarrià-Sant Gervasi,25,Sant Gervasi - la Bonanova,5035,1048,544,504
2023,5,Sarrià-Sant Gervasi,25,Sant Gervasi - la Bonanova,5036,1775,951,824
2023,5,Sarrià-Sant Gervasi,25,Sant Gervasi - la Bonanova,5037,1483,834,649
2023,5,Sarrià-Sant Gervasi,25,Sant Gervasi - la Bonanova,5038,1391,771,620
2023,5,Sarrià-Sant Gervasi,25,Sant Gervasi - la Bonanova,5039,1540,816,724
2023,5,Sarrià-Sant Gervasi,25,Sant Gervasi - la Bonanova,5040,1473,813,660
2023,5,Sarrià-Sant Gervasi,25,Sant Gervasi - la Bonanova,5041,2138,1154,984
2023,5,Sarrià-Sant Gervasi,25,Sant Gervasi - la Bonanova,5042,1304,676,628
2023,5,Sarrià-Sant Gervasi,25,Sant Gervasi - la Bonanova,5043,1492,827,665
2023,5,Sarrià-Sant Gervasi,25,Sant Gervasi - la Bonanova,5044,1302,716,586
2023,5,Sarrià-Sant Gervasi,25,Sant Gervasi - la Bonanova,5045,1599,856,743
2023,5,Sarrià-Sant Gervasi,25,Sant Gervasi - la Bonanova,5046,1146,658,488
2023,5,Sarrià-Sant Gervasi,25,Sant Gervasi - la Bonanova,5047,1187,670,517
2023,5,Sarrià-Sant Gervasi,25,Sant Gervasi - la Bonanova,5048,1242,708,534
2023,5,Sarrià-Sant Gervasi,26,Sant Gervasi - Galvany,5049,1675,906,769
2023,5,Sarrià-Sant Gervasi,26,Sant Gervasi - Galvany,5050,1638,875,763
2023,5,Sarrià-Sant Gervasi,26,Sant Gervasi - Galvany,5051,1652,878,774
2023,5,Sarrià-Sant Gervasi,26,Sant Gervasi - Galvany,5052,1442,793,649
2023,5,Sarrià-Sant Gervasi,26,Sant Gervasi - Galvany,5053,1497,794,703
2023,5,Sarrià-Sant Gervasi,26,Sant Gervasi - Galvany,5054,1032,559,473
2023,5,Sarrià-Sant Gervasi,26,Sant Gervasi - Galvany,5055,1404,751,653
2023,5,Sarrià-Sant Gervasi,26,Sant Gervasi - Galvany,5056,1217,723,494
2023,5,Sarrià-Sant Gervasi,26,Sant Gervasi - Galvany,5057,1654,886,768
2023,5,Sarrià-Sant Gervasi,26,Sant Gervasi - Galvany,5058,1571,851,720
2023,5,Sarrià-Sant Gervasi,26,Sant Gervasi - Galvany,5059,1516,863,653
2023,5,Sarrià-Sant Gervasi,26,Sant Gervasi - Galvany,5060,1156,647,509
2023,5,Sarrià-Sant Gervasi,26,Sant Gervasi - Galvany,5061,1441,806,635
2023,5,Sarrià-Sant Gervasi,26,Sant Gervasi - Galvany,5062,1625,896,729
2023,5,Sarrià-Sant Gervasi,26,Sant Gervasi - Galvany,5063,1573,863,710
2023,5,Sarrià-Sant Gervasi,26,Sant Gervasi - Galvany,5064,1632,927,705
2023,5,Sarrià-Sant Gervasi,26,Sant Gervasi - Galvany,5065,1713,934,779
2023,5,Sarrià-Sant Gervasi,26,Sant Gervasi - Galvany,5066,1322,723,599
2023,5,Sarrià-Sant Gervasi,26,Sant Gervasi - Galvany,5067,1348,726,622
2023,5,Sarrià-Sant Gervasi,26,Sant Gervasi - Galvany,5068,1574,830,744
2023,5,Sarrià-Sant Gervasi,26,Sant Gervasi - Galvany,5069,1737,902,835
2023,5,Sarrià-Sant Gervasi,26,Sant Gervasi - Galvany,5070,1466,816,650
2023,5,Sarrià-Sant Gervasi,26,Sant Gervasi - Galvany,5071,1724,950,774
2023,5,Sarrià-Sant Gervasi,26,Sant Gervasi - Galvany,5072,1707,933,774
2023,5,Sarrià-Sant Gervasi,26,Sant Gervasi - Galvany,5073,1590,868,722
2023,5,Sarrià-Sant Gervasi,26,Sant Gervasi - Galvany,5074,1652,911,741
2023,5,Sarrià-Sant Gervasi,26,Sant Gervasi - Galvany,5075,1841,1030,811
2023,5,Sarrià-Sant Gervasi,26,Sant Gervasi - Galvany,5076,1420,767,653
2023,5,Sarrià-Sant Gervasi,26,Sant Gervasi - Galvany,5077,1519,831,688
2023,5,Sarrià-Sant Gervasi,26,Sant Gervasi - Galvany,5078,2093,1127,966
2023,5,Sarrià-Sant Gervasi,26,Sant Gervasi - Galvany,5079,1243,678,565
2023,5,Sarrià-Sant Gervasi,27,el Putget i Farró,5080,1368,741,627
2023,5,Sarrià-Sant Gervasi,27,el Putget i Farró,5081,1592,872,720
2023,5,Sarrià-Sant Gervasi,27,el Putget i Farró,5082,1627,884,743
2023,5,Sarrià-Sant Gervasi,27,el Putget i Farró,5083,1283,702,581
2023,5,Sarrià-Sant Gervasi,27,el Putget i Farró,5084,1362,748,614
2023,5,Sarrià-Sant Gervasi,27,el Putget i Farró,5085,1327,712,615
2023,5,Sarrià-Sant Gervasi,27,el Putget i Farró,5086,1333,716,617
2023,5,Sarrià-Sant Gervasi,27,el Putget i Farró,5087,1625,898,727
2023,5,Sarrià-Sant Gervasi,27,el Putget i Farró,5088,1798,920,878
2023,5,Sarrià-Sant Gervasi,27,el Putget i Farró,5089,1840,967,873
2023,5,Sarrià-Sant Gervasi,27,el Putget i Farró,5090,1848,989,859
2023,5,Sarrià-Sant Gervasi,27,el Putget i Farró,5091,1540,859,681
2023,5,Sarrià-Sant Gervasi,27,el Putget i Farró,5092,1642,892,750
2023,5,Sarrià-Sant Gervasi,27,el Putget i Farró,5093,1134,641,493
2023,5,Sarrià-Sant Gervasi,27,el Putget i Farró,5094,2764,1529,1235
2023,5,Sarrià-Sant Gervasi,27,el Putget i Farró,5095,1695,940,755
2023,5,Sarrià-Sant Gervasi,27,el Putget i Farró,5096,1108,607,501
2023,5,Sarrià-Sant Gervasi,27,el Putget i Farró,5097,1636,852,784
2023,5,Sarrià-Sant Gervasi,27,el Putget i Farró,5098,1508,826,682
2023,6,Gràcia,28,Vallcarca i els Penitents,6001,1231,698,533
2023,6,Gràcia,28,Vallcarca i els Penitents,6002,1479,799,680
2023,6,Gràcia,28,Vallcarca i els Penitents,6003,2383,1250,1133
2023,6,Gràcia,28,Vallcarca i els Penitents,6004,1394,725,669
2023,6,Gràcia,28,Vallcarca i els Penitents,6006,1024,525,499
2023,6,Gràcia,28,Vallcarca i els Penitents,6007,2005,1063,942
2023,6,Gràcia,28,Vallcarca i els Penitents,6008,2001,1088,913
2023,6,Gràcia,28,Vallcarca i els Penitents,6009,1308,695,613
2023,6,Gràcia,28,Vallcarca i els Penitents,6010,1007,526,481
2023,6,Gràcia,28,Vallcarca i els Penitents,6011,1302,688,614
2023,6,Gràcia,28,Vallcarca i els Penitents,6012,1196,648,548
2023,6,Gràcia,29,el Coll,6013,1809,956,853
2023,6,Gràcia,29,el Coll,6014,1429,794,635
2023,6,Gràcia,29,el Coll,6015,1457,775,682
2023,6,Gràcia,29,el Coll,6016,1612,887,725
2023,6,Gràcia,29,el Coll,6017,1433,752,681
2023,6,Gràcia,30,la Salut,6018,1342,702,640
2023,6,Gràcia,30,la Salut,6019,1552,811,741
2023,6,Gràcia,30,la Salut,6020,1198,658,540
2023,6,Gràcia,30,la Salut,6021,1367,733,634
2023,6,Gràcia,30,la Salut,6022,1372,711,661
2023,6,Gràcia,30,la Salut,6023,1270,674,596
2023,6,Gràcia,30,la Salut,6024,1700,919,781
2023,6,Gràcia,30,la Salut,6025,1419,779,640
2023,6,Gràcia,30,la Salut,6026,1089,605,484
2023,6,Gràcia,30,la Salut,6027,1182,656,526
2023,6,Gràcia,31,Vila de Gràcia,6028,1344,703,641
2023,6,Gràcia,31,Vila de Gràcia,6029,1340,721,619
2023,6,Gràcia,31,Vila de Gràcia,6030,1364,725,639
2023,6,Gràcia,31,Vila de Gràcia,6031,1072,585,487
2023,6,Gràcia,31,Vila de Gràcia,6032,1145,637,508
2023,6,Gràcia,31,Vila de Gràcia,6033,1280,706,574
2023,6,Gràcia,31,Vila de Gràcia,6034,1145,629,516
2023,6,Gràcia,31,Vila de Gràcia,6035,1089,574,515
2023,6,Gràcia,31,Vila de Gràcia,6036,1412,793,619
2023,6,Gràcia,31,Vila de Gràcia,6037,1081,564,517
2023,6,Gràcia,31,Vila de Gràcia,6038,1517,876,641
2023,6,Gràcia,31,Vila de Gràcia,6039,1605,890,715
2023,6,Gràcia,31,Vila de Gràcia,6040,1672,946,726
2023,6,Gràcia,31,Vila de Gràcia,6041,1742,961,781
2023,6,Gràcia,31,Vila de Gràcia,6042,1707,915,792
2023,6,Gràcia,31,Vila de Gràcia,6043,1268,680,588
2023,6,Gràcia,31,Vila de Gràcia,6044,1638,858,780
2023,6,Gràcia,31,Vila de Gràcia,6045,1258,667,591
2023,6,Gràcia,31,Vila de Gràcia,6046,1084,584,500
2023,6,Gràcia,31,Vila de Gràcia,6047,1246,702,544
2023,6,Gràcia,31,Vila de Gràcia,6048,1404,739,665
2023,6,Gràcia,31,Vila de Gràcia,6049,1093,625,468
2023,6,Gràcia,31,Vila de Gràcia,6050,1315,691,624
2023,6,Gràcia,31,Vila de Gràcia,6051,1184,673,511
2023,6,Gràcia,31,Vila de Gràcia,6052,1450,789,661
2023,6,Gràcia,31,Vila de Gràcia,6053,1557,847,710
2023,6,Gràcia,31,Vila de Gràcia,6054,1583,816,767
2023,6,Gràcia,31,Vila de Gràcia,6055,1370,748,622
2023,6,Gràcia,31,Vila de Gràcia,6056,1607,865,742
2023,6,Gràcia,31,Vila de Gràcia,6057,1515,843,672
2023,6,Gràcia,31,Vila de Gràcia,6058,1706,945,761
2023,6,Gràcia,31,Vila de Gràcia,6059,1485,795,690
2023,6,Gràcia,31,Vila de Gràcia,6060,1725,923,802
2023,6,Gràcia,31,Vila de Gràcia,6061,1346,701,645
2023,6,Gràcia,31,Vila de Gràcia,6062,1248,685,563
2023,6,Gràcia,31,Vila de Gràcia,6063,1451,795,656
2023,6,Gràcia,32,el Camp d'en Grassot i Gràcia Nova,6064,1934,1038,896
2023,6,Gràcia,32,el Camp d'en Grassot i Gràcia Nova,6065,1114,608,506
2023,6,Gràcia,32,el Camp d'en Grassot i Gràcia Nova,6066,974,547,427
2023,6,Gràcia,32,el Camp d'en Grassot i Gràcia Nova,6067,1800,971,829
2023,6,Gràcia,32,el Camp d'en Grassot i Gràcia Nova,6068,1553,864,689
2023,6,Gràcia,32,el Camp d'en Grassot i Gràcia Nova,6069,1047,572,475
2023,6,Gràcia,32,el Camp d'en Grassot i Gràcia Nova,6070,1878,1055,823
2023,6,Gràcia,32,el Camp d'en Grassot i Gràcia Nova,6071,1076,580,496
2023,6,Gràcia,32,el Camp d'en Grassot i Gràcia Nova,6072,1613,873,740
2023,6,Gràcia,32,el Camp d'en Grassot i Gràcia Nova,6073,1280,696,584
2023,6,Gràcia,32,el Camp d'en Grassot i Gràcia Nova,6074,1104,590,514
2023,6,Gràcia,32,el Camp d'en Grassot i Gràcia Nova,6075,1055,556,499
2023,6,Gràcia,32,el Camp d'en Grassot i Gràcia Nova,6076,1269,666,603
2023,6,Gràcia,32,el Camp d'en Grassot i Gràcia Nova,6077,1160,637,523
2023,6,Gràcia,32,el Camp d'en Grassot i Gràcia Nova,6078,1303,701,602
2023,6,Gràcia,32,el Camp d'en Grassot i Gràcia Nova,6079,1133,624,509
2023,6,Gràcia,32,el Camp d'en Grassot i Gràcia Nova,6080,1171,624,547
2023,6,Gràcia,32,el Camp d'en Grassot i Gràcia Nova,6081,1310,711,599
2023,6,Gràcia,32,el Camp d'en Grassot i Gràcia Nova,6082,3136,1589,1547
2023,6,Gràcia,32,el Camp d'en Grassot i Gràcia Nova,6083,1643,866,777
2023,6,Gràcia,32,el Camp d'en Grassot i Gràcia Nova,6084,1443,794,649
2023,6,Gràcia,32,el Camp d'en Grassot i Gràcia Nova,6085,1311,719,592
2023,6,Gràcia,32,el Camp d'en Grassot i Gràcia Nova,6086,969,530,439
2023,6,Gràcia,32,el Camp d'en Grassot i Gràcia Nova,6087,1804,977,827
2023,6,Gràcia,32,el Camp d'en Grassot i Gràcia Nova,6088,1239,700,539
2023,7,Horta-Guinardó,33,el Baix Guinardó,7001,1551,859,692
2023,7,Horta-Guinardó,33,el Baix Guinardó,7002,1096,620,476
2023,7,Horta-Guinardó,33,el Baix Guinardó,7003,1347,732,615
2023,7,Horta-Guinardó,33,el Baix Guinardó,7004,1542,837,705
2023,7,Horta-Guinardó,33,el Baix Guinardó,7005,1445,766,679
2023,7,Horta-Guinardó,33,el Baix Guinardó,7006,940,499,441
2023,7,Horta-Guinardó,33,el Baix Guinardó,7007,1399,781,618
2023,7,Horta-Guinardó,33,el Baix Guinardó,7008,1391,744,647
2023,7,Horta-Guinardó,33,el Baix Guinardó,7009,1226,705,521
2023,7,Horta-Guinardó,33,el Baix Guinardó,7010,1265,671,594
2023,7,Horta-Guinardó,33,el Baix Guinardó,7011,1165,628,537
2023,7,Horta-Guinardó,33,el Baix Guinardó,7012,1534,833,701
2023,7,Horta-Guinardó,33,el Baix Guinardó,7013,1222,639,583
2023,7,Horta-Guinardó,33,el Baix Guinardó,7014,857,459,398
2023,7,Horta-Guinardó,33,el Baix Guinardó,7015,1384,738,646
2023,7,Horta-Guinardó,33,el Baix Guinardó,7016,1349,699,650
2023,7,Horta-Guinardó,33,el Baix Guinardó,7017,1773,985,788
2023,7,Horta-Guinardó,33,el Baix Guinardó,7018,1684,907,777
2023,7,Horta-Guinardó,33,el Baix Guinardó,7019,1549,804,745
2023,7,Horta-Guinardó,34,Can Baró,7020,1738,915,823
2023,7,Horta-Guinardó,34,Can Baró,7021,1088,567,521
2023,7,Horta-Guinardó,34,Can Baró,7022,1147,615,532
2023,7,Horta-Guinardó,34,Can Baró,7023,1279,642,637
2023,7,Horta-Guinardó,34,Can Baró,7024,1523,807,716
2023,7,Horta-Guinardó,34,Can Baró,7025,1529,802,727
2023,7,Horta-Guinardó,34,Can Baró,7026,1117,603,514
2023,7,Horta-Guinardó,35,el Guinardó,7027,2134,1131,1003
2023,7,Horta-Guinardó,35,el Guinardó,7028,1495,763,732
2023,7,Horta-Guinardó,35,el Guinardó,7029,1336,702,634
2023,7,Horta-Guinardó,35,el Guinardó,7030,1449,782,667
2023,7,Horta-Guinardó,35,el Guinardó,7031,1595,832,763
2023,7,Horta-Guinardó,35,el Guinardó,7032,1455,748,707
2023,7,Horta-Guinardó,35,el Guinardó,7033,1499,794,705
2023,7,Horta-Guinardó,35,el Guinardó,7034,1801,980,821
2023,7,Horta-Guinardó,35,el Guinardó,7035,1730,926,804
2023,7,Horta-Guinardó,35,el Guinardó,7036,1447,778,669
2023,7,Horta-Guinardó,35,el Guinardó,7037,1523,810,713
2023,7,Horta-Guinardó,35,el Guinardó,7038,1279,669,610
2023,7,Horta-Guinardó,35,el Guinardó,7039,1597,866,731
2023,7,Horta-Guinardó,35,el Guinardó,7040,1482,799,683
2023,7,Horta-Guinardó,35,el Guinardó,7041,1397,783,614
2023,7,Horta-Guinardó,35,el Guinardó,7042,1590,871,719
2023,7,Horta-Guinardó,35,el Guinardó,7043,1468,785,683
2023,7,Horta-Guinardó,35,el Guinardó,7044,1307,704,603
2023,7,Horta-Guinardó,35,el Guinardó,7045,1616,837,779
2023,7,Horta-Guinardó,35,el Guinardó,7046,1349,727,622
2023,7,Horta-Guinardó,35,el Guinardó,7047,1503,784,719
2023,7,Horta-Guinardó,35,el Guinardó,7048,1307,708,599
2023,7,Horta-Guinardó,35,el Guinardó,7049,1197,636,561
2023,7,Horta-Guinardó,35,el Guinardó,7050,1208,637,571
2023,7,Horta-Guinardó,35,el Guinardó,7051,1811,978,833
2023,7,Horta-Guinardó,36,la Font d'en Fargues,7052,1303,682,621
2023,7,Horta-Guinardó,36,la Font d'en Fargues,7053,1458,756,702
2023,7,Horta-Guinardó,36,la Font d'en Fargues,7054,1666,870,796
2023,7,Horta-Guinardó,36,la Font d'en Fargues,7055,1217,663,554
2023,7,Horta-Guinardó,36,la Font d'en Fargues,7056,1217,622,595
2023,7,Horta-Guinardó,36,la Font d'en Fargues,7057,1498,798,700
2023,7,Horta-Guinardó,36,la Font d'en Fargues,7058,1350,706,644
2023,7,Horta-Guinardó,37,el Carmel,7059,1334,671,663
2023,7,Horta-Guinardó,37,el Carmel,7060,1890,960,930
2023,7,Horta-Guinardó,37,el Carmel,7061,1170,593,577
2023,7,Horta-Guinardó,37,el Carmel,7062,1336,690,646
2023,7,Horta-Guinardó,37,el Carmel,7063,1473,770,703
2023,7,Horta-Guinardó,37,el Carmel,7064,1709,914,795
2023,7,Horta-Guinardó,37,el Carmel,7065,1735,946,789
2023,7,Horta-Guinardó,37,el Carmel,7066,1795,929,866
2023,7,Horta-Guinardó,37,el Carmel,7067,1595,837,758
2023,7,Horta-Guinardó,37,el Carmel,7068,1327,698,629
2023,7,Horta-Guinardó,37,el Carmel,7069,1446,762,684
2023,7,Horta-Guinardó,37,el Carmel,7070,1409,763,646
2023,7,Horta-Guinardó,37,el Carmel,7071,1351,733,618
2023,7,Horta-Guinardó,37,el Carmel,7072,1440,761,679
2023,7,Horta-Guinardó,37,el Carmel,7073,1157,612,545
2023,7,Horta-Guinardó,37,el Carmel,7074,1684,871,813
2023,7,Horta-Guinardó,37,el Carmel,7075,1218,637,581
2023,7,Horta-Guinardó,37,el Carmel,7076,1387,732,655
2023,7,Horta-Guinardó,37,el Carmel,7077,1322,680,642
2023,7,Horta-Guinardó,37,el Carmel,7078,1403,715,688
2023,7,Horta-Guinardó,37,el Carmel,7079,1524,819,705
2023,7,Horta-Guinardó,37,el Carmel,7080,1807,965,842
2023,7,Horta-Guinardó,38,la Teixonera,7081,1915,995,920
2023,7,Horta-Guinardó,38,la Teixonera,7082,1238,658,580
2023,7,Horta-Guinardó,38,la Teixonera,7083,1380,724,656
2023,7,Horta-Guinardó,38,la Teixonera,7084,1386,708,678
2023,7,Horta-Guinardó,38,la Teixonera,7085,1283,657,626
2023,7,Horta-Guinardó,38,la Teixonera,7086,1496,774,722
2023,7,Horta-Guinardó,38,la Teixonera,7087,1652,878,774
2023,7,Horta-Guinardó,38,la Teixonera,7088,1737,912,825
2023,7,Horta-Guinardó,39,Sant Genís dels Agudells,7089,1417,774,643
2023,7,Horta-Guinardó,39,Sant Genís dels Agudells,7090,1480,765,715
2023,7,Horta-Guinardó,39,Sant Genís dels Agudells,7091,1240,676,564
2023,7,Horta-Guinardó,39,Sant Genís dels Agudells,7092,1501,822,679
2023,7,Horta-Guinardó,39,Sant Genís dels Agudells,7093,1747,884,863
2023,7,Horta-Guinardó,40,Montbau,7094,1269,700,569
2023,7,Horta-Guinardó,40,Montbau,7095,1562,814,748
2023,7,Horta-Guinardó,40,Montbau,7096,1461,807,654
2023,7,Horta-Guinardó,40,Montbau,7097,882,504,378
2023,7,Horta-Guinardó,41,la Vall d'Hebron,7098,2155,1143,1012
2023,7,Horta-Guinardó,41,la Vall d'Hebron,7099,1025,526,499
2023,7,Horta-Guinardó,41,la Vall d'Hebron,7100,1192,635,557
2023,7,Horta-Guinardó,41,la Vall d'Hebron,7101,1502,811,691
2023,7,Horta-Guinardó,42,la Clota,7102,699,333,366
2023,7,Horta-Guinardó,43,Horta,7103,1538,824,714
2023,7,Horta-Guinardó,43,Horta,7104,1573,818,755
2023,7,Horta-Guinardó,43,Horta,7105,1034,557,477
2023,7,Horta-Guinardó,43,Horta,7106,1202,643,559
2023,7,Horta-Guinardó,43,Horta,7107,1176,621,555
2023,7,Horta-Guinardó,43,Horta,7108,1256,667,589
2023,7,Horta-Guinardó,43,Horta,7109,1678,897,781
2023,7,Horta-Guinardó,43,Horta,7110,1003,574,429
2023,7,Horta-Guinardó,43,Horta,7111,919,527,392
2023,7,Horta-Guinardó,43,Horta,7112,1339,704,635
2023,7,Horta-Guinardó,43,Horta,7113,1216,636,580
2023,7,Horta-Guinardó,43,Horta,7114,1236,657,579
2023,7,Horta-Guinardó,43,Horta,7115,1076,588,488
2023,7,Horta-Guinardó,43,Horta,7116,1520,833,687
2023,7,Horta-Guinardó,43,Horta,7117,3941,1895,2046
2023,7,Horta-Guinardó,43,Horta,7118,1252,682,570
2023,7,Horta-Guinardó,43,Horta,7119,1302,698,604
2023,7,Horta-Guinardó,43,Horta,7120,1223,674,549
2023,7,Horta-Guinardó,43,Horta,7121,1192,648,544
2023,7,Horta-Guinardó,43,Horta,7122,1304,717,587
2023,7,Horta-Guinardó,43,Horta,7123,1415,752,663
2023,8,Nou Barris,44,Vilapicina i la Torre Llobeta,8001,1282,691,591
2023,8,Nou Barris,44,Vilapicina i la Torre Llobeta,8002,1254,671,583
2023,8,Nou Barris,44,Vilapicina i la Torre Llobeta,8003,1228,655,573
2023,8,Nou Barris,44,Vilapicina i la Torre Llobeta,8004,1494,823,671
2023,8,Nou Barris,44,Vilapicina i la Torre Llobeta,8005,1131,597,534
2023,8,Nou Barris,44,Vilapicina i la Torre Llobeta,8006,1680,916,764
2023,8,Nou Barris,44,Vilapicina i la Torre Llobeta,8007,1159,626,533
2023,8,Nou Barris,44,Vilapicina i la Torre Llobeta,8008,1607,866,741
2023,8,Nou Barris,44,Vilapicina i la Torre Llobeta,8009,1806,947,859
2023,8,Nou Barris,44,Vilapicina i la Torre Llobeta,8010,1101,589,512
2023,8,Nou Barris,44,Vilapicina i la Torre Llobeta,8011,1165,629,536
2023,8,Nou Barris,44,Vilapicina i la Torre Llobeta,8012,1272,697,575
2023,8,Nou Barris,44,Vilapicina i la Torre Llobeta,8013,1188,667,521
2023,8,Nou Barris,44,Vilapicina i la Torre Llobeta,8014,1287,696,591
2023,8,Nou Barris,44,Vilapicina i la Torre Llobeta,8015,1410,797,613
2023,8,Nou Barris,44,Vilapicina i la Torre Llobeta,8016,1152,643,509
2023,8,Nou Barris,44,Vilapicina i la Torre Llobeta,8017,1362,714,648
2023,8,Nou Barris,44,Vilapicina i la Torre Llobeta,8018,1506,814,692
2023,8,Nou Barris,44,Vilapicina i la Torre Llobeta,8019,1835,969,866
2023,8,Nou Barris,45,Porta,8020,1368,706,662
2023,8,Nou Barris,45,Porta,8021,1443,773,670
2023,8,Nou Barris,45,Porta,8022,1211,647,564
2023,8,Nou Barris,45,Porta,8023,1384,723,661
2023,8,Nou Barris,45,Porta,8024,1352,748,604
2023,8,Nou Barris,45,Porta,8025,1267,712,555
2023,8,Nou Barris,45,Porta,8026,1378,752,626
2023,8,Nou Barris,45,Porta,8027,1440,735,705
2023,8,Nou Barris,45,Porta,8028,1079,587,492
2023,8,Nou Barris,45,Porta,8029,1501,810,691
2023,8,Nou Barris,45,Porta,8030,1471,771,700
2023,8,Nou Barris,45,Porta,8031,1310,700,610
2023,8,Nou Barris,45,Porta,8032,1260,681,579
2023,8,Nou Barris,45,Porta,8033,1494,780,714
2023,8,Nou Barris,45,Porta,8034,1233,697,536
2023,8,Nou Barris,45,Porta,8035,5647,2668,2979
2023,8,Nou Barris,45,Porta,8036,1548,852,696
2023,8,Nou Barris,45,Porta,8037,1592,874,718
2023,8,Nou Barris,46,el Turó de la Peira,8038,1634,875,759
2023,8,Nou Barris,46,el Turó de la Peira,8039,1538,806,732
2023,8,Nou Barris,46,el Turó de la Peira,8040,1973,1035,938
2023,8,Nou Barris,46,el Turó de la Peira,8041,2512,1288,1224
2023,8,Nou Barris,46,el Turó de la Peira,8042,1242,692,550
2023,8,Nou Barris,46,el Turó de la Peira,8043,1099,620,479
2023,8,Nou Barris,46,el Turó de la Peira,8044,1361,734,627
2023,8,Nou Barris,46,el Turó de la Peira,8045,1797,931,866
2023,8,Nou Barris,46,el Turó de la Peira,8046,1484,815,669
2023,8,Nou Barris,46,el Turó de la Peira,8047,1655,887,768
2023,8,Nou Barris,47,Can Peguera,8048,973,513,460
2023,8,Nou Barris,47,Can Peguera,8049,1197,632,565
2023,8,Nou Barris,48,la Guineueta,8050,1354,728,626
2023,8,Nou Barris,48,la Guineueta,8051,1347,693,654
2023,8,Nou Barris,48,la Guineueta,8052,881,485,396
2023,8,Nou Barris,48,la Guineueta,8053,1108,604,504
2023,8,Nou Barris,48,la Guineueta,8054,1650,896,754
2023,8,Nou Barris,48,la Guineueta,8055,1790,941,849
2023,8,Nou Barris,48,la Guineueta,8056,1534,788,746
2023,8,Nou Barris,48,la Guineueta,8057,1314,702,612
2023,8,Nou Barris,48,la Guineueta,8058,1663,894,769
2023,8,Nou Barris,48,la Guineueta,8059,1028,532,496
2023,8,Nou Barris,48,la Guineueta,8215,1596,940,656
2023,8,Nou Barris,49,Canyelles,8060,1184,637,547
2023,8,Nou Barris,49,Canyelles,8061,1617,852,765
2023,8,Nou Barris,49,Canyelles,8062,1124,592,532
2023,8,Nou Barris,49,Canyelles,8063,1061,557,504
2023,8,Nou Barris,49,Canyelles,8064,1800,950,850
2023,8,Nou Barris,50,les Roquetes,8065,1765,863,902
2023,8,Nou Barris,50,les Roquetes,8066,1606,832,774
2023,8,Nou Barris,50,les Roquetes,8067,1822,941,881
2023,8,Nou Barris,50,les Roquetes,8068,1856,979,877
2023,8,Nou Barris,50,les Roquetes,8069,1588,836,752
2023,8,Nou Barris,50,les Roquetes,8070,1480,775,705
2023,8,Nou Barris,50,les Roquetes,8071,1730,887,843
2023,8,Nou Barris,50,les Roquetes,8072,1206,657,549
2023,8,Nou Barris,50,les Roquetes,8073,1888,991,897
2023,8,Nou Barris,50,les Roquetes,8074,1582,806,776
2023,8,Nou Barris,51,Verdun,8075,1911,1055,856
2023,8,Nou Barris,51,Verdun,8076,1583,882,701
2023,8,Nou Barris,51,Verdun,8077,1411,740,671
2023,8,Nou Barris,51,Verdun,8078,1596,857,739
2023,8,Nou Barris,51,Verdun,8079,1442,769,673
2023,8,Nou Barris,51,Verdun,8080,1537,791,746
2023,8,Nou Barris,51,Verdun,8081,1682,892,790
2023,8,Nou Barris,51,Verdun,8082,1612,879,733
2023,8,Nou Barris,52,la Prosperitat,8083,1295,682,613
2023,8,Nou Barris,52,la Prosperitat,8084,1114,618,496
2023,8,Nou Barris,52,la Prosperitat,8085,1540,789,751
2023,8,Nou Barris,52,la Prosperitat,8086,1687,913,774
2023,8,Nou Barris,52,la Prosperitat,8087,1205,637,568
2023,8,Nou Barris,52,la Prosperitat,8088,1288,683,605
2023,8,Nou Barris,52,la Prosperitat,8089,1208,650,558
2023,8,Nou Barris,52,la Prosperitat,8090,1208,632,576
2023,8,Nou Barris,52,la Prosperitat,8091,1200,625,575
2023,8,Nou Barris,52,la Prosperitat,8092,996,524,472
2023,8,Nou Barris,52,la Prosperitat,8093,1284,673,611
2023,8,Nou Barris,52,la Prosperitat,8094,1422,744,678
2023,8,Nou Barris,52,la Prosperitat,8095,1103,570,533
2023,8,Nou Barris,52,la Prosperitat,8096,1543,818,725
2023,8,Nou Barris,52,la Prosperitat,8097,1287,702,585
2023,8,Nou Barris,52,la Prosperitat,8098,1268,665,603
2023,8,Nou Barris,52,la Prosperitat,8099,1449,747,702
2023,8,Nou Barris,52,la Prosperitat,8100,1306,728,578
2023,8,Nou Barris,52,la Prosperitat,8101,1708,923,785
2023,8,Nou Barris,52,la Prosperitat,8102,1553,862,691
2023,8,Nou Barris,53,la Trinitat Nova,8103,1681,870,811
2023,8,Nou Barris,53,la Trinitat Nova,8104,1292,684,608
2023,8,Nou Barris,53,la Trinitat Nova,8105,1428,752,676
2023,8,Nou Barris,53,la Trinitat Nova,8106,1294,680,614
2023,8,Nou Barris,53,la Trinitat Nova,8107,1929,999,930
2023,8,Nou Barris,54,Torre Baró,8108,1986,1009,977
2023,8,Nou Barris,54,Torre Baró,8109,953,481,472
2023,8,Nou Barris,55,Ciutat Meridiana,8110,1971,995,976
2023,8,Nou Barris,55,Ciutat Meridiana,8111,1662,858,804
2023,8,Nou Barris,55,Ciutat Meridiana,8112,1715,875,840
2023,8,Nou Barris,55,Ciutat Meridiana,8113,1829,954,875
2023,8,Nou Barris,55,Ciutat Meridiana,8114,1971,1002,969
2023,8,Nou Barris,55,Ciutat Meridiana,8115,1709,857,852
2023,8,Nou Barris,56,Vallbona,8116,1421,713,708
2023,9,Sant Andreu,57,la Trinitat Vella,9001,2693,1284,1409
2023,9,Sant Andreu,57,la Trinitat Vella,9002,2184,1088,1096
2023,9,Sant Andreu,57,la Trinitat Vella,9003,2160,1055,1105
2023,9,Sant Andreu,57,la Trinitat Vella,9004,1617,812,805
2023,9,Sant Andreu,57,la Trinitat Vella,9005,1632,829,803
2023,9,Sant Andreu,58,Baró de Viver,9006,1266,645,621
2023,9,Sant Andreu,58,Baró de Viver,9007,1316,675,641
2023,9,Sant Andreu,59,el Bon Pastor,9008,1837,919,918
2023,9,Sant Andreu,59,el Bon Pastor,9009,1420,760,660
2023,9,Sant Andreu,59,el Bon Pastor,9010,1784,930,854
2023,9,Sant Andreu,59,el Bon Pastor,9011,1627,829,798
2023,9,Sant Andreu,59,el Bon Pastor,9013,2117,1105,1012
2023,9,Sant Andreu,59,el Bon Pastor,9014,3746,1708,2038
2023,9,Sant Andreu,59,el Bon Pastor,9015,1903,965,938
2023,9,Sant Andreu,60,Sant Andreu,9016,1262,663,599
2023,9,Sant Andreu,60,Sant Andreu,9017,1503,791,712
2023,9,Sant Andreu,60,Sant Andreu,9018,1443,757,686
2023,9,Sant Andreu,60,Sant Andreu,9019,2663,1380,1283
2023,9,Sant Andreu,60,Sant Andreu,9020,1121,612,509
2023,9,Sant Andreu,60,Sant Andreu,9021,1392,739,653
2023,9,Sant Andreu,60,Sant Andreu,9022,1266,660,606
2023,9,Sant Andreu,60,Sant Andreu,9023,1198,605,593
2023,9,Sant Andreu,60,Sant Andreu,9024,1177,660,517
2023,9,Sant Andreu,60,Sant Andreu,9025,1269,675,594
2023,9,Sant Andreu,60,Sant Andreu,9026,1468,771,697
2023,9,Sant Andreu,60,Sant Andreu,9027,1286,672,614
2023,9,Sant Andreu,60,Sant Andreu,9028,1533,792,741
2023,9,Sant Andreu,60,Sant Andreu,9029,1078,574,504
2023,9,Sant Andreu,60,Sant Andreu,9030,1452,777,675
2023,9,Sant Andreu,60,Sant Andreu,9031,1184,608,576
2023,9,Sant Andreu,60,Sant Andreu,9032,2174,1147,1027
2023,9,Sant Andreu,60,Sant Andreu,9033,3252,1672,1580
2023,9,Sant Andreu,60,Sant Andreu,9034,1446,777,669
2023,9,Sant Andreu,60,Sant Andreu,9035,1530,811,719
2023,9,Sant Andreu,60,Sant Andreu,9036,1349,721,628
2023,9,Sant Andreu,60,Sant Andreu,9037,1744,829,915
2023,9,Sant Andreu,60,Sant Andreu,9038,1743,940,803
2023,9,Sant Andreu,60,Sant Andreu,9039,1531,808,723
2023,9,Sant Andreu,60,Sant Andreu,9040,1624,883,741
2023,9,Sant Andreu,60,Sant Andreu,9041,1414,764,650
2023,9,Sant Andreu,60,Sant Andreu,9042,1258,697,561
2023,9,Sant Andreu,60,Sant Andreu,9043,1366,723,643
2023,9,Sant Andreu,60,Sant Andreu,9044,1527,781,746
2023,9,Sant Andreu,60,Sant Andreu,9045,1432,768,664
2023,9,Sant Andreu,60,Sant Andreu,9046,1296,696,600
2023,9,Sant Andreu,60,Sant Andreu,9047,1577,828,749
2023,9,Sant Andreu,60,Sant Andreu,9048,1345,716,629
2023,9,Sant Andreu,60,Sant Andreu,9049,1280,692,588
2023,9,Sant Andreu,60,Sant Andreu,9050,1522,809,713
2023,9,Sant Andreu,60,Sant Andreu,9051,1259,649,610
2023,9,Sant Andreu,60,Sant Andreu,9052,1224,650,574
2023,9,Sant Andreu,60,Sant Andreu,9053,1636,884,752
2023,9,Sant Andreu,60,Sant Andreu,9054,1078,575,503
2023,9,Sant Andreu,61,la Sagrera,9055,1806,969,837
2023,9,Sant Andreu,61,la Sagrera,9056,1140,610,530
2023,9,Sant Andreu,61,la Sagrera,9057,1694,888,806
2023,9,Sant Andreu,61,la Sagrera,9058,1523,789,734
2023,9,Sant Andreu,61,la Sagrera,9059,1435,748,687
2023,9,Sant Andreu,61,la Sagrera,9060,1356,729,627
2023,9,Sant Andreu,61,la Sagrera,9061,1676,881,795
2023,9,Sant Andreu,61,la Sagrera,9062,1543,803,740
2023,9,Sant Andreu,61,la Sagrera,9063,1126,595,531
2023,9,Sant Andreu,61,la Sagrera,9064,1146,610,536
2023,9,Sant Andreu,61,la Sagrera,9065,2099,1139,960
2023,9,Sant Andreu,61,la Sagrera,9066,1433,740,693
2023,9,Sant Andreu,61,la Sagrera,9067,1530,826,704
2023,9,Sant Andreu,61,la Sagrera,9068,1524,787,737
2023,9,Sant Andreu,61,la Sagrera,9069,941,525,416
2023,9,Sant Andreu,61,la Sagrera,9070,1790,955,835
2023,9,Sant Andreu,61,la Sagrera,9071,1892,1030,862
2023,9,Sant Andreu,61,la Sagrera,9072,1499,821,678
2023,9,Sant Andreu,61,la Sagrera,9073,1495,788,707
2023,9,Sant Andreu,61,la Sagrera,9156,1260,664,596
2023,9,Sant Andreu,62,el Congrés i els Indians,9074,1714,907,807
2023,9,Sant Andreu,62,el Congrés i els Indians,9075,1577,817,760
2023,9,Sant Andreu,62,el Congrés i els Indians,9076,1459,787,672
2023,9,Sant Andreu,62,el Congrés i els Indians,9077,1620,881,739
2023,9,Sant Andreu,62,el Congrés i els Indians,9078,1463,787,676
2023,9,Sant Andreu,62,el Congrés i els Indians,9079,1667,894,773
2023,9,Sant Andreu,62,el Congrés i els Indians,9080,1334,690,644
2023,9,Sant Andreu,62,el Congrés i els Indians,9081,1726,926,800
2023,9,Sant Andreu,62,el Congrés i els Indians,9082,2063,1089,974
2023,9,Sant Andreu,63,Navas,9083,1628,869,759
2023,9,Sant Andreu,63,Navas,9084,1717,905,812
2023,9,Sant Andreu,63,Navas,9085,1788,953,835
2023,9,Sant Andreu,63,Navas,9086,1494,797,697
2023,9,Sant Andreu,63,Navas,9087,1296,671,625
2023,9,Sant Andreu,63,Navas,9088,1903,1038,865
2023,9,Sant Andreu,63,Navas,9089,1499,829,670
2023,9,Sant Andreu,63,Navas,9090,1505,799,706
2023,9,Sant Andreu,63,Navas,9091,1836,988,848
2023,9,Sant Andreu,63,Navas,9092,1925,1002,923
2023,9,Sant Andreu,63,Navas,9093,1299,681,618
2023,9,Sant Andreu,63,Navas,9094,2005,1052,953
2023,9,Sant Andreu,63,Navas,9095,2169,1138,1031
2023,10,Sant Martí,64,Camp de l'Arpa del Clot,10001,1626,834,792
2023,10,Sant Martí,64,Camp de l'Arpa del Clot,10002,1827,935,892
2023,10,Sant Martí,64,Camp de l'Arpa del Clot,10003,1601,852,749
2023,10,Sant Martí,64,Camp de l'Arpa del Clot,10004,1580,864,716
2023,10,Sant Martí,64,Camp de l'Arpa del Clot,10005,1608,879,729
2023,10,Sant Martí,64,Camp de l'Arpa del Clot,10006,1859,1012,847
2023,10,Sant Martí,64,Camp de l'Arpa del Clot,10007,1295,662,633
2023,10,Sant Martí,64,Camp de l'Arpa del Clot,10008,1699,918,781
2023,10,Sant Martí,64,Camp de l'Arpa del Clot,10009,1649,863,786
2023,10,Sant Martí,64,Camp de l'Arpa del Clot,10010,1725,935,790
2023,10,Sant Martí,64,Camp de l'Arpa del Clot,10011,1175,633,542
2023,10,Sant Martí,64,Camp de l'Arpa del Clot,10012,1756,927,829
2023,10,Sant Martí,64,Camp de l'Arpa del Clot,10013,1344,723,621
2023,10,Sant Martí,64,Camp de l'Arpa del Clot,10014,1459,776,683
2023,10,Sant Martí,64,Camp de l'Arpa del Clot,10015,1921,1011,910
2023,10,Sant Martí,64,Camp de l'Arpa del Clot,10016,1193,613,580
2023,10,Sant Martí,64,Camp de l'Arpa del Clot,10017,1678,908,770
2023,10,Sant Martí,64,Camp de l'Arpa del Clot,10018,1473,783,690
2023,10,Sant Martí,64,Camp de l'Arpa del Clot,10019,1554,833,721
2023,10,Sant Martí,64,Camp de l'Arpa del Clot,10020,1457,759,698
2023,10,Sant Martí,64,Camp de l'Arpa del Clot,10021,1300,687,613
2023,10,Sant Martí,64,Camp de l'Arpa del Clot,10022,1335,713,622
2023,10,Sant Martí,64,Camp de l'Arpa del Clot,10023,1426,776,650
2023,10,Sant Martí,64,Camp de l'Arpa del Clot,10024,1507,792,715
2023,10,Sant Martí,64,Camp de l'Arpa del Clot,10025,1296,729,567
2023,10,Sant Martí,65,el Clot,10026,1616,842,774
2023,10,Sant Martí,65,el Clot,10027,1529,817,712
2023,10,Sant Martí,65,el Clot,10028,1747,900,847
2023,10,Sant Martí,65,el Clot,10029,1418,726,692
2023,10,Sant Martí,65,el Clot,10030,1738,933,805
2023,10,Sant Martí,65,el Clot,10031,1496,777,719
2023,10,Sant Martí,65,el Clot,10032,1366,711,655
2023,10,Sant Martí,65,el Clot,10033,875,475,400
2023,10,Sant Martí,65,el Clot,10034,1655,869,786
2023,10,Sant Martí,65,el Clot,10035,1928,981,947
2023,10,Sant Martí,65,el Clot,10036,1430,713,717
2023,10,Sant Martí,65,el Clot,10037,1030,548,482
2023,10,Sant Martí,65,el Clot,10038,1658,871,787
2023,10,Sant Martí,65,el Clot,10039,1822,946,876
2023,10,Sant Martí,65,el Clot,10040,1820,939,881
2023,10,Sant Martí,65,el Clot,10041,1600,832,768
2023,10,Sant Martí,65,el Clot,10234,1742,950,792
2023,10,Sant Martí,66,el Parc i la Llacuna del Poblenou,10042,3423,1775,1648
2023,10,Sant Martí,66,el Parc i la Llacuna del Poblenou,10043,2785,1414,1371
2023,10,Sant Martí,66,el Parc i la Llacuna del Poblenou,10044,1574,823,751
2023,10,Sant Martí,66,el Parc i la Llacuna del Poblenou,10045,1269,670,599
2023,10,Sant Martí,66,el Parc i la Llacuna del Poblenou,10046,1228,669,559
2023,10,Sant Martí,66,el Parc i la Llacuna del Poblenou,10047,1695,873,822
2023,10,Sant Martí,66,el Parc i la Llacuna del Poblenou,10048,1634,819,815
2023,10,Sant Martí,66,el Parc i la Llacuna del Poblenou,10049,1261,630,631
2023,10,Sant Martí,66,el Parc i la Llacuna del Poblenou,10050,1544,824,720
2023,10,Sant Martí,67,la Vila Olímpica del Poblenou,10051,1664,835,829
2023,10,Sant Martí,67,la Vila Olímpica del Poblenou,10052,2383,1195,1188
2023,10,Sant Martí,67,la Vila Olímpica del Poblenou,10053,1706,870,836
2023,10,Sant Martí,67,la Vila Olímpica del Poblenou,10054,980,512,468
2023,10,Sant Martí,67,la Vila Olímpica del Poblenou,10055,2605,1307,1298
2023,10,Sant Martí,68,el Poblenou,10056,1821,919,902
2023,10,Sant Martí,68,el Poblenou,10057,1413,710,703
2023,10,Sant Martí,68,el Poblenou,10058,1122,570,552
2023,10,Sant Martí,68,el Poblenou,10059,1798,957,841
2023,10,Sant Martí,68,el Poblenou,10060,1696,850,846
2023,10,Sant Martí,68,el Poblenou,10061,1765,925,840
2023,10,Sant Martí,68,el Poblenou,10062,1516,798,718
2023,10,Sant Martí,68,el Poblenou,10063,1222,636,586
2023,10,Sant Martí,68,el Poblenou,10064,1636,865,771
2023,10,Sant Martí,68,el Poblenou,10065,1579,813,766
2023,10,Sant Martí,68,el Poblenou,10066,2087,1074,1013
2023,10,Sant Martí,68,el Poblenou,10067,1922,1002,920
2023,10,Sant Martí,68,el Poblenou,10068,1613,827,786
2023,10,Sant Martí,68,el Poblenou,10069,2778,1458,1320
2023,10,Sant Martí,68,el Poblenou,10070,1630,880,750
2023,10,Sant Martí,68,el Poblenou,10071,1776,900,876
2023,10,Sant Martí,68,el Poblenou,10072,2059,1050,1009
2023,10,Sant Martí,68,el Poblenou,10073,1454,764,690
2023,10,Sant Martí,68,el Poblenou,10074,1745,885,860
2023,10,Sant Martí,68,el Poblenou,10075,1519,780,739
2023,10,Sant Martí,69,Diagonal Mar i el Front Marítim del Poblenou,10076,2278,1171,1107
2023,10,Sant Martí,69,Diagonal Mar i el Front Marítim del Poblenou,10077,1806,893,913
2023,10,Sant Martí,69,Diagonal Mar i el Front Marítim del Poblenou,10078,2454,1238,1216
2023,10,Sant Martí,69,Diagonal Mar i el Front Marítim del Poblenou,10079,1708,890,818
2023,10,Sant Martí,69,Diagonal Mar i el Front Marítim del Poblenou,10080,2335,1191,1144
2023,10,Sant Martí,69,Diagonal Mar i el Front Marítim del Poblenou,10235,1304,687,617
2023,10,Sant Martí,69,Diagonal Mar i el Front Marítim del Poblenou,10236,1568,844,724
2023,10,Sant Martí,70,el Besòs i el Maresme,10081,2183,1093,1090
2023,10,Sant Martí,70,el Besòs i el Maresme,10082,1968,942,1026
2023,10,Sant Martí,70,el Besòs i el Maresme,10083,2193,1014,1179
2023,10,Sant Martí,70,el Besòs i el Maresme,10084,1685,839,846
2023,10,Sant Martí,70,el Besòs i el Maresme,10085,2089,995,1094
2023,10,Sant Martí,70,el Besòs i el Maresme,10086,1973,979,994
2023,10,Sant Martí,70,el Besòs i el Maresme,10087,1867,946,921
2023,10,Sant Martí,70,el Besòs i el Maresme,10088,1652,849,803
2023,10,Sant Martí,70,el Besòs i el Maresme,10089,6120,2291,3829
2023,10,Sant Martí,70,el Besòs i el Maresme,10090,1503,776,727
2023,10,Sant Martí,70,el Besòs i el Maresme,10091,1975,979,996
2023,10,Sant Martí,70,el Besòs i el Maresme,10092,1449,772,677
2023,10,Sant Martí,70,el Besòs i el Maresme,10093,1235,636,599
2023,10,Sant Martí,71,Provençals del Poblenou,10094,3192,1587,1605
2023,10,Sant Martí,71,Provençals del Poblenou,10095,1311,669,642
2023,10,Sant Martí,71,Provençals del Poblenou,10096,1684,902,782
2023,10,Sant Martí,71,Provençals del Poblenou,10097,1571,838,733
2023,10,Sant Martí,71,Provençals del Poblenou,10098,1739,920,819
2023,10,Sant Martí,71,Provençals del Poblenou,10099,1099,587,512
2023,10,Sant Martí,71,Provençals del Poblenou,10100,1695,904,791
2023,10,Sant Martí,71,Provençals del Poblenou,10101,1742,863,879
2023,10,Sant Martí,71,Provençals del Poblenou,10102,2639,1385,1254
2023,10,Sant Martí,71,Provençals del Poblenou,10103,2145,1119,1026
2023,10,Sant Martí,71,Provençals del Poblenou,10104,1553,821,732
2023,10,Sant Martí,71,Provençals del Poblenou,10237,903,503,400
2023,10,Sant Martí,72,Sant Martí de Provençals,10105,2142,1148,994
2023,10,Sant Martí,72,Sant Martí de Provençals,10106,999,543,456
2023,10,Sant Martí,72,Sant Martí de Provençals,10107,1495,790,705
2023,10,Sant Martí,72,Sant Martí de Provençals,10108,1318,712,606
2023,10,Sant Martí,72,Sant Martí de Provençals,10109,1635,865,770
2023,10,Sant Martí,72,Sant Martí de Provençals,10110,1857,1023,834
2023,10,Sant Martí,72,Sant Martí de Provençals,10111,1277,680,597
2023,10,Sant Martí,72,Sant Martí de Provençals,10112,1516,783,733
2023,10,Sant Martí,72,Sant Martí de Provençals,10113,1193,611,582
2023,10,Sant Martí,72,Sant Martí de Provençals,10114,1573,809,764
2023,10,Sant Martí,72,Sant Martí de Provençals,10115,1405,759,646
2023,10,Sant Martí,72,Sant Martí de Provençals,10116,1785,969,816
2023,10,Sant Martí,72,Sant Martí de Provençals,10117,1249,657,592
2023,10,Sant Martí,72,Sant Martí de Provençals,10118,996,522,474
2023,10,Sant Martí,72,Sant Martí de Provençals,10119,1151,608,543
2023,10,Sant Martí,72,Sant Martí de Provençals,10120,1487,811,676
2023,10,Sant Martí,72,Sant Martí de Provençals,10121,1607,847,760
2023,10,Sant Martí,72,Sant Martí de Provençals,10122,1484,788,696
2023,10,Sant Martí,73,la Verneda i la Pau,10123,1326,679,647
2023,10,Sant Martí,73,la Verneda i la Pau,10124,1055,555,500
2023,10,Sant Martí,73,la Verneda i la Pau,10125,1097,569,528
2023,10,Sant Martí,73,la Verneda i la Pau,10126,1008,534,474
2023,10,Sant Martí,73,la Verneda i la Pau,10127,1018,518,500
2023,10,Sant Martí,73,la Verneda i la Pau,10128,1516,824,692
2023,10,Sant Martí,73,la Verneda i la Pau,10129,1121,579,542
2023,10,Sant Martí,73,la Verneda i la Pau,10130,1219,635,584
2023,10,Sant Martí,73,la Verneda i la Pau,10131,1090,580,510
2023,10,Sant Martí,73,la Verneda i la Pau,10132,1272,673,599
2023,10,Sant Martí,73,la Verneda i la Pau,10133,1761,940,821
2023,10,Sant Martí,73,la Verneda i la Pau,10134,1564,865,699
2023,10,Sant Martí,73,la Verneda i la Pau,10135,1250,649,601
2023,10,Sant Martí,73,la Verneda i la Pau,10136,1379,732,647
2023,10,Sant Martí,73,la Verneda i la Pau,10137,1578,843,735
2023,10,Sant Martí,73,la Verneda i la Pau,10138,2076,1085,991
2023,10,Sant Martí,73,la Verneda i la Pau,10139,1707,896,811
2023,10,Sant Martí,73,la Verneda i la Pau,10140,1646,846,800
2023,10,Sant Martí,73,la Verneda i la Pau,10141,1140,599,541
2023,10,Sant Martí,73,la Verneda i la Pau,10142,1625,845,780
2023,10,Sant Martí,73,la Verneda i la Pau,10143,1802,945,857
